#############
###*.*#*.*###
###.*.*.*.###
###*.*.*.*###
###.*.*.*.###
###*.*.*.*###
#####   #####
#####   #####
###### ######
#           #
# $ $ $ $ $ #
## $ $ $ $ ##
##$ $ $ $ $##
##   $@$   ##
##  #####  ##
#############
