#################
########  #######
########   ######
######## $$ #####
########$  $ ####
######    $   ###
###  # #####  ###
#    # #....$ ###
# #   $ ....# ###
#  $ # #.*..# ###
###  #### ### ###
###### @$  ##$###
######## $     ##
########  ##   ##
#################
