############
#..  ####@##
#..  ###   #
#..     $$ #
#..  # # $ #
#..### # $ #
#### $ #$  #
####  $# $ #
#### $  $  #
####  ##   #
############
