#################
#       #@ #   ##
# # # # # $  $$##
# #...# #$$$   ##
#  ...# # $  $$##
# ##.## # ##    #
# #...     $    #
# ## ###  #######
#    ############
#################
