###################
#           #######
# ### $$    #######
#   # $  $  #######
#  $####$##########
# $ ##        #####
#  $$ $        ...#
### ## $$#     ...#
### ##   #     ...#
###      #     ...#
#####@#############
###################
