#############
########   ##
## # @## $$ #
#    $      #
#  $  ###   #
### #####$###
# $  ### ..##
# $ $ $ ...##
#    ###...##
# $$ ###...##
#  ##########
#############
