#################
#####          ##
#####  # #$$ $  #
#####$ #$#  ## @#
##### ## # $ # ##
####   $ #$  # ##
####   # $   # ##
##### $ $   ## ##
####  #  ##  $ ##
####    ## $$# ##
######$$   #   ##
#....#  #########
#.#... ##########
#....   #########
#....   #########
#################
