################
#...###  #######
#...###  $  ####
#....## $  $####
##....##   $  ##
###... ## $ $ ##
# ##    #  $  ##
#  ## # ### ####
# $ # #$  $    #
#  $ @ $    $  #
#   # $ $$ $ ###
#  ######  #####
# ##############
################
