##################
########     #####
##     # $$ #####
##$$ #   #########
## ###......##   #
##   $......## # #
## ###......     #
##   #### ### #$##
#  #$   #  $  # ##
#  $ $$$  # $## ##
#   $ $ ###$$ # ##
#####     $   # ##
####### ###   # ##
#######     #   ##
##############  ##
##################
