##################
##########  ######
##  $      $ #####
#   ## ##   ##...#
# #$$ $ $$#$##...#
# #   @   #   ...#
#  $# ###$$   ...#
# $  $$  $ ##....#
###$       #######
###  #############
##################
