###################
#......   #########
#......   #  ##   #
#..### $    $     #
#... $ $ #   ##   #
#...#$#####    #  #
###    #   #$  #$ #
###  $$ $ $  $##  #
###  $   #$#$ ##$ #
##### ## #    ##  #
####  $ $ ## ######
####    $  $  #####
#####   # #   #####
#########@#########
###################
