#################
#########     @##
######### $#$ ###
######### $  $###
##########$ $ ###
######### $ # ###
#....  ## $  $  #
##...    $  $   #
#....  ##########
#################
