#################
###########  ...#
###########  ...#
#######      . .#
#######  ##  ...#
######## ##  ...#
######## ########
###### $$$ ######
######  $ $ #####
##   #$ $   #   #
#@ $  $    $  $ #
###### $$ $ #####
######      #####
#################
