###################
###@##         ...#
#    #         ...#
# $  #         ...#
# $$ #         ...#
## $ ###$##########
## ###  $ #########
##   $  $ #########
#  $ #  $ #########
# $  #    #########
#  $ #    #########
#    #    #########
###################
