###################
####   ##  ########
###     #  #    ###
#  $ #$ #  #  ... #
# # $#$## # #.#. #
#  # #$  #    . . #
# $    $ # # #.#. #
#   ##  ##$ $ . . #
# $ #   #  #$#.#. #
## $  $   $  $... #
##$ ######    ##  #
##  ###############
###################
