###################
###############   #
######        #   #
######  $ $    $$ #
###### ##### ## $ #
######$$   #$## $ #
###### ### # ##$  #
###### ### $ $    #
#....        ##   #
#....        ######
#....        ######
###########@#######
###################
