###################
#########  #  #####
#####   #   $    ##
##### #$$ ## ##  ##
##      # #  ## ###
#  ### $#$  $  $  #
#...    # ##  #   #
#...#    @ # ### ##
#...#  ###  $  $  #
###########   #   #
###################
