###################
#..........  .#####
#..........$$.#  ##
###########$ #   ##
#      $  $     $ #
## ####   #  $ #  #
#      #   ##  # ##
#  $#  # ##  ### ##
# $ #$###    ### ##
###  $ #  #  ### ##
###    $ ## #  # ##
## $  #  $  $ $   #
##  $  $#$$$  #   #
##  #  $      #####
## @##  #  #  #####
###################
