#################
#              ##
# # ######     ##
# #  $ $ $ $#  ##
# #   $@$   ## ##
# #  $ $ $###...#
# #   $ $  ##...#
# ###$$$ $ ##...#
#     # ## ##...#
#####   ## ##...#
#########     ###
#########     ###
#################
