#################
####   #  #######
####  $   #######
#### #$   #######
##  $  ##$   ####
##  # @ $ # $####
##  #      $ ####
### ####$##     #
## $#.....# #   #
##  $..**. $# ###
##  #.....#   ###
#   ### #########
# $$  #  ########
#  #     ########
######   ########
#################
