##################
###  #############
###  ##  #   #####
##  $# $@$   #####
##$  $  # $ $#  ##
##  $## #$ $     #
#  #  # #   $$$  #
# $    $  $## ####
# $ $ #$#  #  ####
##  ###  ###$ ####
##  #....     ####
#####......#######
####....##########
####...###########
####...###########
##################
