################
#####   ########
##  $    ###   #
## $@$ $    $  #
## #$######## ##
## #  $  #     #
## # $ $ # #   #
## #  $# # #####
#  ##    #     #
#    $ # ###   #
##### ##  #....#
#    $     ....#
#         #....#
################
