#################
#########   #####
######### #$##  #
#########     $ #
######### ###   #
#....  ## $  $###
#....    $ $$ ###
#....  ##$  $ @##
#########  $  ###
######### $ $  ##
########### ## ##
###########    ##
#################
