###################
##   ##############
## # ##############
##      $@#########
## $ ##$ ###   ####
## #### $    $ ####
## ##### #  #$ ####
##  #### ##$      #
#  $#  $  # ## ## #
#         # #...# #
######  ###  ...  #
########### #...# #
########### ### # #
###########       #
###################
