###################
########   #     ##
########     $ $ ##
#   ##### $## # ###
# $ ##   # ## $  ##
# $  @$$ # ##$$$ ##
## ###   # ##    ##
## #   ### #####$##
## #     $  #....##
#  ### ## $ #....##
# $   $ #   #..$. #
#  ## $ #  ##.... #
#####   ######...##
###################
