#################
#     ###   ##  #
# ### ###   $   #
# # $ ###   $   #
#   $$      ##$ #
#    ####   ##  #
#@############ ##
###..    #####$ #
###..    ####   #
###..       $$  #
###..    #### $ #
###..    ####   #
#################
