###################
############   ####
###########     ###
##########  $$  ###
######### $$  $ ###
######## $    $ ###
########   $$ #####
#  ######## ##    #
#.            $$$@#
#.# ####### ##   ##
#.# #######. #$ $##
#........... #    #
##############  $ #
###############  ##
###################
