####################
#      #   #########
# $  $   #  ########
####  #####      ###
##..  #     #### ###
##.####  ####    ###
##....    #  $ #####
## ...#   # $$$#  ##
###.#### ##  $$   #
#     ##### $ #    #
# #.# $      $###$ #
# #.########  #  $ #
# #..        ##  $ #
# # ####### $ # #  #
#   #######       ##
####################
