###############
##  #  ########
##  #  #...####
#  $#  #...  ##
# $ #$$ ...  ##
#  $#  #... .##
#   # $########
##$       $ $ #
##  #  $$ #   #
#######  ##$$@#
#######      ##
###############
