##############
#        #####
# ###### #  ##
# # $ $ $  $ #
#       #$   #
###$  $$#  ###
###  ## # $###
####$#   $ @##
####  $ $ ####
#### #   $  ##
#### ##   # ##
####  ##### ##
###         ##
###.......####
###.......####
##############
