##############
##....   #####
##.#.#  $ ####
##....# # @###
# ....#  #  ##
#     #$ ##$ #
## ###  $    #
##$  $ $ $#  #
## #  $ $ ## #
##  ###  ##  #
##    ## ## ##
##  $ #  $  ##
####$ $   ####
####  ########
##############
