###################
#####  #  #########
##### $#$ #  ######
#.. #  #  #   #####
#.. # $#$ #  $#####
#.  #     #$  #  ##
#..   $#  # $    ##
#..@#  #$ #$  #  ##
#.. # $#     $#  ##
#.. #  #$$#$  #  ##
#.. # $#  #  $#$  #
#.. #  #  #   #   #
##. ####  #####   #
###################
