###################
##############....#
##   ##     ##....#
#  $$##  $ @##....#
#      $$ $#  ....#
#  $ ## $$ # # ...#
#  $ ## $  #  ....#
## ##### ### ##.###
##   $  $ ##   .  #
# $###  # ##### ###
#   $   #       ###
#  $ #$ $ $###  ###
# $$$# $   ########
#    #  $$ ########
######   ##########
###################
