##################
######      ######
###    ## $ $   #
### ## ##$#$ $ $##
### ......#  $$ ##
#   ......#  #   #
# # ......#$  $  #
# #$...... $$# $ #
#   ### ###$  $ ##
###  $  $  $  $ ##
###  $  $  $  $ ##
########   #######
##################
