####################
#....#       #  #  #
#....# # $  $      #
#.... ##  $# # $#$ #
#...#   $   $#  $  #
#..####  # $   $$  #
#      #### #### ###
#        #   #     #
# ##   #   $ # $ $ #
# ##    $ ## $  $  #
#     #     #   # #
####################
