#################
#####    ########
##    ## ########
## $     ########
### #### ########
#  $   $ ##  ...#
#   $$ $$    ...#
#    $  $##  ...#
#### ## ##  ...#
####  $  ########
##   $$  ########
##    #  ########
#################
