###################
########         ##
########    $ $  ##
######## $ ##### ##
#    ##### $  ##$##
#       $ $      ##
#          ## ## ##
#    ##@##### ## ##
#    ######## ## ##
#....######## $   #
#....########     #
###################
