###################
############......#
############......#
####  #########...#
#### $   $    #...#
####  # # # # #   #
##### # # #@# #   #
#   # ### ### ## ##
#    $ # $ $ $ # ##
# $$$  $   #     ##
#   # ###$###$## ##
### #  $   #     ##
### $  # $ $ $ ####
##  # ### ### #####
## $          #####
##  ###############
###################
