##############
#   ##########
#    #########
# $  ####  ###
#  $$ $   $###
###@ #$    ###
##  ##  $ $ ##
## $  ## ## .#
##  #$##$  #.#
####   $..##.#
###    #.*...#
### $$ #.....#
###  #########
###  #########
##############
