###################
###   @############
##### $   #########
#   ##    #########
# $ #  ##    ######
# $ #  ##### ######
## $  $    # ######
## $ $ ### # ######
## #  $  # # ######
## # #$#   # ######
## ###   # # ######
#  $  #### # #....#
#    $    $   ..#.#
####$  $# $   ....#
#       #  ## ....#
###################
