################
###  ###########
###    $   $ $ #
### $# $ #  $  #
###  $ $  #    #
### $# #  #### #
#@#$ $ $  ##   #
#    $ #$#   # #
#   $    $ $ $ #
#####  #########
###      #######
###      #######
###......#######
###......#######
###......#######
################
