###########
####### @##
#     $  ##
#   $## $##
##$#...# ##
## $...  ##
## #. .# ##
##   # #$ #
##$  $    #
##  #######
###########
