###################
############  ....#
############  ....#
#    #  $ $   ....#
# $$$#$  $ #  ....#
#  $     $ #  ....#
# $$ #$ $ $########
#  $ #     ########
## ################
#    #    #########
#     $   #########
#  $$#$$  @########
#    #    #########
###################
