#############
#######  ####
###     $####
## $  ## ####
#@$ $ # $  ##
#### ##   $##
##....#$ $ ##
##....#   $##
##....  $$ ##
##... # $   #
#######$ $  #
#######   ###
#######$ ####
#######  ####
#############
