###################
###########  ######
###### @###$ ######
####      $  ######
###  $ $$## #######
##  #$##     ######
## # $ $$ # #######
##   $ #  # $ #####
####    #  $$ #   #
#### ## $         #
#.    ###  ########
#.. ..#############
#...#.#############
#.....#############
###################
