###################
######  .  #   ####
###### #.    @ ####
###### ##..# ######
##  # ..###     ###
# $ #...   $ #  $ #
#    .. ##  ## ## #
####$##$# $ #   # #
#### #    #$ $$ # #
###  $ # #  # $## #
###               #
###  ###########  #
###################
