##############
##       #####
## $ $$ $#####
### #  $ #####
#.#   $$ #####
#.###   $ ####
#.#. $ ## ####
#...  $## $  #
#...$   $    #
#..###$### #@#
#..###     ###
##############
