###################
#############   ###
#   ####  $ $ $ ###
# $   ## ## ##  ###
#   $ $     $  $ ##
### $  ## ##     ##
### ##### #####$$ #
###$##### @##     #
## $  ###$### $  ##
## $  #   ###  ####
## $$ $ #   $$ ####
##     #   ##  ####
########.. .#######
#####.........#####
#####.........#####
###################
