####################
# #     #          #
#       $  ## ### ##
#####  ##   $  $   #
##..##  # # $ # #  #
#....  $     ##$# ##
#....  $#####   #$##
##..# #  #   #  $  #
###.# #  $   $  # #
##  $  $ #   #  ####
##       ###########
####################
