################
####..  #   ####
####..      ####
####..  #  #####
#########  #  ##
###            #
###  #  ##  #  #
#### ##  #### ##
#  $  ##### #  #
# # $  $  # $  #
# $  $   #   ##
#### ## ########
####    ########
################
