###################
#######..    #   ##
######..* $    $ ##
#####..*.# # # $###
####..*.# # # $  ##
####...#  #    # ##
#  ## #          ##
# @$ $ ###  #   ###
# $   $   # #   ###
###$$   # # # # ###
###   $   # # #####
### $# #####      #
###$   #####    # #
###  ########     #
###  ########    ##
###################
