####################
#    #  # #  #  #  #
# # # ## $   $   ##
#### #    #  # $   #
#    # ## #$ ## ## #
#      $   $   $   #
#..###$$## $##$ ## #
#..#.#  # $   $ #  #
#....# $$   ##$ ####
#....#  #####      #
#...###        ##  #
####################
