###################
##...   #    #   ##
##.....  $## # #$ #
#......#  $  #    #
#......#  #  # #  #
######### $  $ $  #
###     #$##$ ##$##
###   $    # $    #
##  ## ### #  ##$ #
## $ $$     $  $  #
## $    $##$ ######
########  @ #######
###################
