####################
##...   ## #    #  #
#....         $ ## #
#....# # #$###$    #
#...#    #       # #
##.#  #$ #     $## #
#  #  # $ $ ###  $ #
#     $  $ #  # ## #
## # ## #$$# $#  # #
#  #   $ $ #      ##
#    #     #  #   #
####################
