#################
##########   ####
###### $  $  ####
##### $  $ $ ##.#
#       $$  ##..#
#  ###### ###.. #
## #  #    #... #
# $   #    #... #
#@ #$ ## ####...#
####  $ $$  ##..#
#####  $ $  $...#
##### $$  $ #  .#
#####   $ $  ####
##########   ####
#################
