####################
#    ##   #    #   #
#  $  $     ## $   #
## #####  .###### ##
## ##  ##....#### ##
## ##$ ###..##     #
#      #... .# $ $ #
# $ ## ## . ### ####
# # $    #.#### ####
# $ $ #   .#### ####
# #  ## # ##  #  ###
#######  $##$   $ ##
########      $ #@##
########  ## #######
####################
