<?xml version="1.0" encoding="utf-8"?>
<SokobanLevels xmlns:xsi="http://www.w3.org/2001/XMLSchema-instance" xsi:schemaLocation="SokobanLev.xsd">
  <Title>1,000,002 candlelights</Title>
  <Description>

  </Description>
  <LevelCollection Copyright="A1master" MaxWidth="37" MaxHeight="49">
    <Level Id="2 boxes in a cheesy world (mini version)" Width="32" Height="32">
      <L>################################</L>
      <L>#@                             #</L>
      <L># $ #    #  #    #        #    #</L>
      <L># #$  #    #   #   # # #    #  #</L>
      <L>#   #   #    #  # #     # #    #</L>
      <L>#     #  ##   #     #  #    #  #</L>
      <L>#  #   #    #    #    #  #     #</L>
      <L>#    #    #   #   # #   # #    #</L>
      <L># #    # #      # #         #  #</L>
      <L>#   #       # #     #  #   #   #</L>
      <L># #   #  # #    #  #     #     #</L>
      <L>#   #   #    #   #  #   #   #  #</L>
      <L>#    #    #  # #     #     #   #</L>
      <L>#  #  #     #    #     # #     #</L>
      <L>#    #  # #   #    #  #   # #  #</L>
      <L># #    #   #    #   #          #</L>
      <L>#   #    #  # #  #    # #  # # #</L>
      <L>#     # #       #  # #    #    #</L>
      <L>#  # #    #  #    #      #  #  #</L>
      <L>#       #   #  #   #   #       #</L>
      <L># #  # #  #      #   #     #   #</L>
      <L>#  #    #  #  #   # #     #  # #</L>
      <L>#     #      #  #     ## #     #</L>
      <L>#  #   # # #       #      # #  #</L>
      <L>#    #       # # #   #  #      #</L>
      <L># #   # # # #             #    #</L>
      <L>#  # #         # # #  # #  # # #</L>
      <L>#      # # # #       #   #     #</L>
      <L>#  #           # # #  #    # . #</L>
      <L>#    #  #   # #          #   . #</L>
      <L>#                              #</L>
      <L>################################</L>
    </Level>
    <Level Id="Head of snake" Width="17" Height="12">
      <L>  ###### ######</L>
      <L> #    .###.    #</L>
      <L> # ***  #  *** #</L>
      <L> # * .$ # $+ * #</L>
      <L>## ***  #  *** ##</L>
      <L># $   # . #   $ #</L>
      <L>#     ##$##     #</L>
      <L>#######   #######</L>
      <L> #             #</L>
      <L>  ##         ##</L>
      <L>    ###   ###</L>
      <L>      #####</L>
    </Level>
    <Level Id="respirator (solved)" Width="13" Height="12">
      <L>#############</L>
      <L>###   #   ###</L>
      <L>##. $ . $ .##</L>
      <L># $# $ $ #$ #</L>
      <L>#   ##.##   #</L>
      <L>#.*.$. .$.*.#</L>
      <L># * # @ # * #</L>
      <L>#   ##.##   #</L>
      <L># $# $ $ #$ #</L>
      <L>##. $ . $ .##</L>
      <L>###   #   ###</L>
      <L>#############</L>
    </Level>
    <Level Id="Rubin (0-pushes)" Width="18" Height="18">
      <L>       ####</L>
      <L>  ######  #</L>
      <L>  #       #######</L>
      <L>  # #### *      #</L>
      <L>  # #   # ##### #</L>
      <L>  # # * # #   # #</L>
      <L>  # #    *  * # #</L>
      <L>### ## ## #   # ##</L>
      <L>#  *  * @ # ##   #</L>
      <L>#   ## #   *  *  #</L>
      <L>## #   # ## ## ###</L>
      <L> # # *  *    # #</L>
      <L> # #   # # * # #</L>
      <L> # ##### #   # #</L>
      <L> #      * #### #</L>
      <L> #######       #</L>
      <L>       #  ######</L>
      <L>       ####</L>
    </Level>
    <Level Id="snowdrop" Width="17" Height="15" Copyright="Zbigniew Kornas, A1master">
      <L>#################</L>
      <L>#...         ...#</L>
      <L># .###########. #</L>
      <L># .#    $     . #</L>
      <L>#  # $ $ $ $ #  #</L>
      <L>#  #  $ $ $  #  #</L>
      <L>#  # $ $$$ $ #  #</L>
      <L>#  #$ $ + $ $#  #</L>
      <L>#  # $ $$$ $ #  #</L>
      <L>#  #  $ $ $  #  #</L>
      <L>#  # $ $ $ $ #  #</L>
      <L>#       $    #  #</L>
      <L>#..###########..#</L>
      <L>#...............#</L>
      <L>#################</L>
    </Level>
    <Level Id="Teleport me TWICE" Width="29" Height="15" Copyright="A1master, Archanfel, A1master">
      <L>#############################</L>
      <L>#             #             #</L>
      <L># *********** # *********** #</L>
      <L># *         * # *         * #</L>
      <L># * ******* * # * ******* * #</L>
      <L># * *     * * # * *     * * #</L>
      <L># * * *** * *   * * *** * * #</L>
      <L># * * *@* * * * * * * * * * #</L>
      <L># * * *** * *   * * *** * * #</L>
      <L># * *     * * # * *     * * #</L>
      <L># * ******* * # * ******* * #</L>
      <L># *         * # *         * #</L>
      <L># *********** # *********** #</L>
      <L>#             #             #</L>
      <L>#############################</L>
    </Level>
    <Level Id="thinking rabbit tribute-A1" Width="21" Height="11" Copyright="Thinking Rabbit, Inc, A1master">
      <L>    #####   #####</L>
      <L>    #   #   #   #</L>
      <L>    #$  #   #  $#</L>
      <L>  ###  $#####$  ###</L>
      <L>  #  $  $ # $  $  #</L>
      <L>### # ### * ###.# ###</L>
      <L>#   # ###.@.##*.#   #</L>
      <L># $  $  .$$$.  *  $ #</L>
      <L>##### ##.....##.#####</L>
      <L>    #   .   . $.#</L>
      <L>    #############</L>
    </Level>
    <Level Id="ulitka" Width="16" Height="10">
      <L>     ##### #####</L>
      <L>     #   # #   #</L>
      <L>     # $.###.$ #</L>
      <L>########.*.*.###</L>
      <L>#      $.*.*.#</L>
      <L># $ $  #.*.*.#</L>
      <L># $$$$ #     ##</L>
      <L>#      ##$  $##</L>
      <L>#########@   ##</L>
      <L>        #######</L>
    </Level>
    <Level Id="FoRResT House (thinking rabbit tribute)" Width="21" Height="11" Copyright="Thinking Rabbit, Inc, A1master">
      <L>    #####   #####</L>
      <L>    #   # # #   #</L>
      <L>    #$  #   #  $#</L>
      <L>  ###  $#####$  ###</L>
      <L>  #  $  $ # $  $  #</L>
      <L>### # ### * ### # ###</L>
      <L>#   # ###.@.### #   #</L>
      <L># $  $  .***.  $  $ #</L>
      <L>##### ##..*..## #####</L>
      <L>    #   ..*..   #</L>
      <L>   ###############</L>
    </Level>
    <Level Id="500+" Width="18" Height="21" Copyright="skippy, A1master">
      <L>##################</L>
      <L>#                #</L>
      <L># .... .... .... #</L>
      <L># .    .  . .  . #</L>
      <L># .... .  . .  . #</L>
      <L>#    . .  . .  . #</L>
      <L># .... .... .... #</L>
      <L>#                #</L>
      <L># ###  #### #### #</L>
      <L># #    #  # #  # #</L>
      <L># #### #  # #  # #</L>
      <L>#    # #  # #  # #</L>
      <L>#  ### #### #### #</L>
      <L>#                #</L>
      <L># $$$$ $$$$ $$$$ #</L>
      <L># $    $  $ $  $ #</L>
      <L># $$$$ $@ $ $  $ #</L>
      <L>#    $ $  $ $  $ #</L>
      <L># $$$$ $$$$ $$$$ #</L>
      <L>#                #</L>
      <L>##################</L>
    </Level>
    <Level Id="Device-based (Level 4+)" Width="21" Height="9" Copyright="Martí Homs Caussa, A1master">
      <L>    #############</L>
      <L>    #@   .      #</L>
      <L>##### # #$###$# #####</L>
      <L>#  .$   #. .  #  *  #</L>
      <L># # ##### # # ### # #</L>
      <L># #       # #     # #</L>
      <L># #########$####### #</L>
      <L>#                   #</L>
      <L>#####################</L>
    </Level>
    <Level Id="Waterfall" Width="17" Height="14">
      <L>  #############</L>
      <L>  #     @     #</L>
      <L>### ## ### ## ###</L>
      <L># $ $ $ $ $ $ $ #</L>
      <L># $ $ $ $ $ $ $ #</L>
      <L># $ $ $ $ $ $ $ #</L>
      <L># $ $ $ $ $ $ $ #</L>
      <L># $ $ $ $ $ $ $ #</L>
      <L># .#.#.#.#.#.#. #</L>
      <L>##. . . . . . .##</L>
      <L># .#.#.#.#.#.#. #</L>
      <L>##. . . . . . .##</L>
      <L># .#.#.#.#.#.#. #</L>
      <L>#################</L>
    </Level>
    <Level Id="gravity" Width="17" Height="6">
      <L>  #############</L>
      <L>  #     @     #</L>
      <L>### #### #### ###</L>
      <L># $ $ $ $ $ $ $ #</L>
      <L># . . . . . . . #</L>
      <L>#################</L>
    </Level>
    <Level Id="gravity_unsolved-22241" Width="17" Height="6">
      <L>  #############</L>
      <L>  #     @     #</L>
      <L>### #### #### ###</L>
      <L># $ $ $ $ $ $ $ #</L>
      <L># . ... $ ... . #</L>
      <L>#################</L>
    </Level>
    <Level Id="plus (around)" Width="20" Height="13">
      <L> #######  ####  ####</L>
      <L> #     ####  ####  #</L>
      <L> # # *          $. #</L>
      <L>## ##$#####* ####$ #</L>
      <L>#   #.#   # ##  # ##</L>
      <L>#  $.+.$  #     # #</L>
      <L>#####.## ## ##* # #</L>
      <L>  #  $ #  *  # ## #</L>
      <L>  # #    #   #    #</L>
      <L>  # # *######### ##</L>
      <L>  # ##         $. #</L>
      <L>  #    ########   #</L>
      <L>  ######      #####</L>
    </Level>
    <Level Id="Make me smile-1" Width="9" Height="17">
      <L> #######</L>
      <L>##  @  ##</L>
      <L>#  $$$  #</L>
      <L># $* *$ #</L>
      <L># $   $ #</L>
      <L># $ $ $ #</L>
      <L># $* *$ #</L>
      <L>#   *   #</L>
      <L>## $$$ ##</L>
      <L>### # ###</L>
      <L>#   #   #</L>
      <L>#...#...#</L>
      <L># . # . #</L>
      <L># . # . #</L>
      <L>#...$...#</L>
      <L>#   #   #</L>
      <L>#########</L>
    </Level>
    <Level Id="Make me smile-2" Width="9" Height="17">
      <L> #######</L>
      <L>##     ##</L>
      <L>#  $$$  #</L>
      <L># $# #$ #</L>
      <L>#     $ #</L>
      <L>#   $$  #</L>
      <L># #$ # ##</L>
      <L># $@#   #</L>
      <L># $$$$$ #</L>
      <L>### # ###</L>
      <L>#   #   #</L>
      <L>#...#...#</L>
      <L># . # . #</L>
      <L># . # . #</L>
      <L>#...$...#</L>
      <L>#   #   #</L>
      <L>#########</L>
    </Level>
    <Level Id="The Exit is the Entrance" Width="15" Height="7">
      <L>###############</L>
      <L># @ $ *.  #   #</L>
      <L>#     #  $ $$ #</L>
      <L>#######.*.....#</L>
      <L>#   # $ $$#$ ##</L>
      <L>#   $ ..  #  #</L>
      <L>##############</L>
    </Level>
    <Level Id="go clockwise_(mini version of Suitcase 06)" Width="16" Height="11" Copyright="Tian Lang, A1master">
      <L>### ######### ##</L>
      <L># # #  ##   # ##</L>
      <L>### #    $  #</L>
      <L>#   # $### #####</L>
      <L># #### ## $#   #</L>
      <L># #  $  #   $  #</L>
      <L>  # # @ #  ## ##</L>
      <L>### ######### ##</L>
      <L># $ $ $ $ $ $  #</L>
      <L>#  ........... #</L>
      <L>################</L>
    </Level>
    <Level Id="A1most square (cell phone accumulator)" Width="20" Height="16" Copyright="Archanfel, anian, A1master">
      <L>####################</L>
      <L>#     ####    ######</L>
      <L># $#$$  ## ## #    #</L>
      <L>#    $  ##       $ #</L>
      <L># $$  ##### # #$ $ #</L>
      <L># @$$ ..**..*   $# #</L>
      <L># $#  *..**.*#     #</L>
      <L>#   ##****.**#### ##</L>
      <L>######... ..*#   $ #</L>
      <L>#     *.*.*..# $   #</L>
      <L># # ##*.*.**.# # # #</L>
      <L># $   ..*..**#$ $# #</L>
      <L>########### $ $ $  #</L>
      <L>###########    $$$ #</L>
      <L>##*##*##*######    #</L>
      <L>##*##*##*###########</L>
    </Level>
    <Level Id="Elka_(Merry Christmas)" Width="13" Height="29">
      <L>      *</L>
      <L>   *#####*</L>
      <L>   #  #  #</L>
      <L>   #  $  #</L>
      <L>   # $#$ #</L>
      <L>   ##.#.##</L>
      <L>   #  #  #</L>
      <L>   #  #  #</L>
      <L>   #..$..#</L>
      <L>   #$$#$$#</L>
      <L>   #  #  #</L>
      <L>  *## # ##*</L>
      <L>  #   #   #</L>
      <L>  #   #   #</L>
      <L>  #...$...#</L>
      <L>  #$$$#$$$#</L>
      <L>  #   #   #</L>
      <L>  ### # ###</L>
      <L> *#   #   #*</L>
      <L> #....$....#</L>
      <L> #$$$$#$$$$#</L>
      <L> #    #    #</L>
      <L> #### # ####</L>
      <L>*#    #    #*</L>
      <L>#.....$.....#</L>
      <L>#$$$$$#$$$$$#</L>
      <L>#     #     #</L>
      <L>####..+..####</L>
      <L>   #######</L>
    </Level>
    <Level Id="flower_2013" Width="15" Height="14">
      <L>###############</L>
      <L>#####  ###  ###</L>
      <L>####   #    ###</L>
      <L>##  **    ** ##</L>
      <L>##  .*  # *.  #</L>
      <L>###$  ####  $ #</L>
      <L>###  ##@##  ###</L>
      <L>####  # #  ####</L>
      <L>###  $# $  ####</L>
      <L>#  *.    .* ###</L>
      <L>#  **  # **  ##</L>
      <L>##   ####    ##</L>
      <L>##  #####  ####</L>
      <L>###### ########</L>
    </Level>
    <Level Id="flower_2015" Width="15" Height="14">
      <L>###############</L>
      <L>#####  ###  ###</L>
      <L>####  $# $  ###</L>
      <L>##  *.    .* ##</L>
      <L>##  .*  # *.  #</L>
      <L>###$  ####  $ #</L>
      <L>###  ##@##  ###</L>
      <L>####  # #  ####</L>
      <L>###  $# $  ####</L>
      <L>#  *.    .* ###</L>
      <L>#  .*  # *.  ##</L>
      <L>##$  ####  $ ##</L>
      <L>##  #####  ####</L>
      <L>###### ########</L>
    </Level>
    <Level Id="Untitled" Width="37" Height="49">
      <L>             ####   ####</L>
      <L>             #  #   #  #</L>
      <L>           ### $#   #$ ###</L>
      <L>           #    # # #    #</L>
      <L>        #### ## ##### ## ####</L>
      <L>        # $ $  $$ # $$  $ $ #</L>
      <L>        #    ## # # # ##    #</L>
      <L>        #  $ ## # # # ## $  #</L>
      <L>       ### #$##...#...##$# ###</L>
      <L>       #   #  .*..#..*.  #   #</L>
      <L>       # ####* .*.@.*. *#### #</L>
      <L>       #   #  .*..#..*.  #   #</L>
      <L>       ### #$##...#...##$# ###</L>
      <L>        #  $ ## # # # ## $  #</L>
      <L>        #    ## # # # ##    #</L>
      <L>        # $ $  $$ # $$  $ $ #</L>
      <L>        #### ## ##### ## ####</L>
      <L>           #    # # #    #</L>
      <L>           ### $#   #$ ###</L>
      <L>             #  # # #  #</L>
      <L>             #### # ####</L>
      <L>                  #</L>
      <L>                  #</L>
      <L>                  #</L>
      <L>                  #</L>
      <L>                  #</L>
      <L>                  #</L>
      <L>#####             #              ####</L>
      <L>     #####        #           ###</L>
      <L>          ##      #         ##</L>
      <L>            ##    #       ##</L>
      <L>              #   #      #</L>
      <L>               #  #     #</L>
      <L>                # #    #</L>
      <L>                 ##   #</L>
      <L>                  #  #</L>
      <L>                  # #</L>
      <L>                  ##</L>
      <L>                  #</L>
      <L>                  #</L>
      <L>                  #</L>
      <L>                  #</L>
      <L>                  #</L>
      <L>                  #</L>
      <L>                  #</L>
      <L>                  #</L>
      <L>                  #</L>
      <L>                  #</L>
      <L>                 ###</L>
    </Level>
    <Level Id="Unsolved-18764" Width="11" Height="10">
      <L>      #####</L>
      <L>########  #</L>
      <L># $.  .$  #</L>
      <L>#  .*. #  #</L>
      <L># *  .$#$##</L>
      <L>##$# *$ * #</L>
      <L>#  #$*..  #</L>
      <L>#  $. @.$ #</L>
      <L>#  ########</L>
      <L>#####</L>
    </Level>
    <Level Id="3 reserved boxes" Width="15" Height="15" Copyright="Darse Billings, York Shen, A1master">
      <L>###############</L>
      <L>#   ##   # ## #</L>
      <L>#   #  $ ######</L>
      <L>##$ $ ## ######</L>
      <L>#  $  $ $     #</L>
      <L># $ $ ## ## $ #</L>
      <L>#  $ #.....#  #</L>
      <L>##   #.#...#$ #</L>
      <L># $ $ ..#...  #</L>
      <L>#  $ #... .#$##</L>
      <L># $ $#..*..# #</L>
      <L>#  $  ## ##  #</L>
      <L>##$$$  @$   ###</L>
      <L>#        #### #</L>
      <L>##########  ###</L>
    </Level>
    <Level Id="1991" Width="17" Height="17">
      <L>#################</L>
      <L>#   #  ##########</L>
      <L># @    ##########</L>
      <L>#   # $#  ####  #</L>
      <L>### # $      #  #</L>
      <L> #  ##### #  #  #</L>
      <L> #  ##    # $$.##</L>
      <L> #  ## ##    #.##</L>
      <L> #  ##  $ $$ #.##</L>
      <L> #  ####$  ###.##</L>
      <L> #  #### # $ #.##</L>
      <L> #  #### # $ #.##</L>
      <L> #  ####     #.##</L>
      <L> #  ##########.##</L>
      <L> #           $*.#</L>
      <L> #  #######   ..#</L>
      <L> ################</L>
    </Level>
    <Level Id="unsolved_17741" Width="17" Height="14">
      <L>### ######### ###</L>
      <L># ###   #   ### #</L>
      <L>###   . * .   ###</L>
      <L> #  *#$#*#$#*  #</L>
      <L> #    *   *    #</L>
      <L> #  #*# @*#*#  #</L>
      <L> #  # *  .$ #  #</L>
      <L> #  #   *   #  #</L>
      <L> #  #*# #*#*#  #</L>
      <L> #    *   *    #</L>
      <L> #  *#$#*#$#*  #</L>
      <L>###   . * .   ###</L>
      <L># ###   #   ### #</L>
      <L>### ######### ###</L>
    </Level>
  </LevelCollection>
</SokobanLevels>
