<?xml version="1.0" encoding="utf-8"?>
<SokobanLevels xmlns:xsi="http://www.w3.org/2001/XMLSchema-instance" xsi:schemaLocation="SokobanLev.xsd">
  <Title>Alejandro</Title>
  <Description>
Remodels of maps made by my grandson Alejandro. Enjoy
  </Description>
  <Email>serenata@setarnet.aw</Email>
  <LevelCollection Copyright="Eric F Tchong" MaxWidth="35" MaxHeight="25">
    <Level Id="ale first" Width="35" Height="18">
      <L>         ################</L>
      <L>   #######              ##########</L>
      <L>   #.....#  ..........  # . . . .#</L>
      <L>   #.   .#  .   ..   .  # . . . .#</L>
      <L>   #.   .#  .   ..   .  # . . . .##</L>
      <L>   #.   .#  .        .  #.. . . ..#</L>
      <L>   #.   .#  .        .  #.  . .  .#</L>
      <L>####     #              #.... ....#</L>
      <L>#        #### # # # #####         #</L>
      <L># $#$#$#$ $ $ $ $ $ $ $ $ $#$#$#$##</L>
      <L>#                                 #</L>
      <L># $$$$$$$$$$$$$$$$$$$$$$$$$$$$$$$ #</L>
      <L>#                                 #</L>
      <L># $#$#$#$#$#$#$#$#$#$#$#$#$#$#$#$ #</L>
      <L>#          #                      #</L>
      <L>##############$   $################</L>
      <L>             #  @  #</L>
      <L>             #######</L>
    </Level>
    <Level Id="alegame" Width="25" Height="14">
      <L>    ###########</L>
      <L> ####         #</L>
      <L>##  $$#$#*#$$ ######</L>
      <L># #   .            #</L>
      <L># $ # #  #  #.#  # #####</L>
      <L># # $    $       *     #</L>
      <L>#   # #  ##.#    #    $##</L>
      <L>#   # *           #.#   #</L>
      <L>##  $ ##    #.#         #</L>
      <L> #  #  $  #      #.#   ##</L>
      <L> ##    #  $   #+#      ##</L>
      <L>   ##     #        .....#</L>
      <L>    ##       ############</L>
      <L>     #########</L>
    </Level>
    <Level Id="ales box shot war of history" Width="23" Height="13">
      <L>         ######</L>
      <L>     ####      ####</L>
      <L>   ## .   $ #$$$   ##</L>
      <L>  ##  #  @  .    .# ##</L>
      <L> ## $ .  #$$$$  $    ##</L>
      <L> #      $#        $   #</L>
      <L>## .  .  # $. $     # #</L>
      <L>#  #  #  # ###### #.  #</L>
      <L>## .  .  #          ##</L>
      <L> ##   $     .   $   #</L>
      <L>  ###     $ # $    #</L>
      <L>     #####.......##</L>
      <L>          #######</L>
    </Level>
    <Level Id="ales goal part 1" Width="16" Height="13">
      <L> ##############</L>
      <L> #            #</L>
      <L> # $ $  $    .#</L>
      <L># $######$ #  #</L>
      <L>#  $  $    # *#</L>
      <L>#   + # $  ####</L>
      <L>##  $ # .   .##</L>
      <L> ##   # # # .##</L>
      <L> ## #   .    .##</L>
      <L>  #    $   $   #</L>
      <L>  ### ..#.#### #</L>
      <L>    ###.###  ###</L>
      <L>      ###</L>
    </Level>
    <Level Id="ales goal part 2" Width="17" Height="16">
      <L>####</L>
      <L>#  ###</L>
      <L>#     #####</L>
      <L># $$$  $  #</L>
      <L># $@$  # $####</L>
      <L># $$$$ $     ###</L>
      <L>#        $$$#  ##</L>
      <L>#  #$ #.#      #</L>
      <L>### $$ .. .$ ###</L>
      <L>  #    ..      ##</L>
      <L>  # .  .#   .   #</L>
      <L>  #  *  . .   $ #</L>
      <L>  #         ##..#</L>
      <L>  #.....#########</L>
      <L>  #..####</L>
      <L>  ####</L>
    </Level>
    <Level Id="ales goal part 3" Width="24" Height="18">
      <L>                ########</L>
      <L>                #......#</L>
      <L>                #......#</L>
      <L>                #......#</L>
      <L>######          #......#</L>
      <L>#    #          #......#</L>
      <L># $$$####       #  $ ###</L>
      <L>#       #     ###  # #</L>
      <L># $$#$$$#######    # #</L>
      <L>#   #   $ $ $ $  @ # #</L>
      <L># $ .              # #</L>
      <L>##$ $   # ### #$#  # #</L>
      <L> #  $  $#$  .      # #</L>
      <L> #$ $  $ $  ##.$ $##$#</L>
      <L> #  $  $    $    $ $ #</L>
      <L> #$ $                #</L>
      <L> #    ########## .   #</L>
      <L> ######        #######</L>
    </Level>
    <Level Id="ale mini thinker" Width="16" Height="10">
      <L>    ###</L>
      <L>    #.########</L>
      <L>    #....    #</L>
      <L> #### $$# $$ #</L>
      <L>##  $   #$ $##</L>
      <L>#@$  . *#  ..##</L>
      <L>## $ $  #. *..##</L>
      <L> ####$$ $ **..##</L>
      <L>    #      ####</L>
      <L>    ########</L>
    </Level>
    <Level Id="ale's elephant" Width="30" Height="18">
      <L>                          ###</L>
      <L>       #######################</L>
      <L>     ###                 ### #</L>
      <L>    ##  $$# #  $$$$$       $ #</L>
      <L>####    $ . #. # # . $  $  $ #</L>
      <L>#  # $##$    $     . $     $ #</L>
      <L>####    $$ $#$$$$#######$. $ #</L>
      <L> ###           # #........   #</L>
      <L> #              ..........## #</L>
      <L> #....# ##...   ..       #####</L>
      <L> #...## $ ##.          #######</L>
      <L> ##### $$ ################*###</L>
      <L>    #      #            ####</L>
      <L>    # $ $$$##           #*##</L>
      <L>    ##      #           ####</L>
      <L>     ## $$$ #</L>
      <L>      ##  @##</L>
      <L>        ####</L>
    </Level>
    <Level Id="ale play beehive" Width="23" Height="18">
      <L>   ####################</L>
      <L>   #   # #  #  #  #   #</L>
      <L>#### $ # # $# $# $#$  #</L>
      <L># @  $ $ $  #  #  # $ #</L>
      <L># $         $$ #  $   #</L>
      <L>#   #$ $ $     . $ $  #</L>
      <L>##  #  $##$$$$     $$ #</L>
      <L> #  #$  $    $$$$     #</L>
      <L> #              . $$$ #</L>
      <L> #.  ### * $  *.      #</L>
      <L> #..   $ *   .  * . $ #</L>
      <L> #.#.    *  *    .    #</L>
      <L> #.##.   . .    $ .$$ #</L>
      <L> #.# #.  . ........   #</L>
      <L> #.#  #. . .      . . #</L>
      <L> #.#   #.. .     $.$* #</L>
      <L> #.#    #* .      . . #</L>
      <L> ######################</L>
    </Level>
    <Level Id="goes around" Width="30" Height="18">
      <L>###</L>
      <L>#####       ######</L>
      <L>###*#      ##    ########</L>
      <L>###*########            #</L>
      <L>#### $ $ $   $ $$   $$$$#####</L>
      <L>#           ####  $ #    $  #</L>
      <L>#  $ $ $ $  ###### #*# $ $  ##</L>
      <L>##  $ $ $   ###### ###   $  ##</L>
      <L> #####  @              $ $  #</L>
      <L>     ########  .# .$##   #  #</L>
      <L>            #   #   # .$    #</L>
      <L>            # * #   #     # #</L>
      <L>         ####   .  .$    #  #</L>
      <L>   ####### $          .     ##</L>
      <L>   #  $ $ $  $ . $ .     #  ##</L>
      <L>   ##       ...........# ...#</L>
      <L>    ####...#..#..#..##. .####</L>
      <L>       ###################</L>
    </Level>
    <Level Id="camel head" Width="32" Height="18">
      <L>  ###########</L>
      <L>###          #######</L>
      <L># $$     $$        ########</L>
      <L>#  $ $ ##  $  ## $ $ $ $  ###</L>
      <L>#  $   ### $##### $         ####</L>
      <L>#  $  ##*#  ####      $  $    .#</L>
      <L>##$$  #*##  ###  $          ...#</L>
      <L> #     ## $       ............##</L>
      <L> #$       $ $ .....######....##</L>
      <L> #  $ .....   ..###      #####</L>
      <L> #$   $   $ $ .#</L>
      <L> #  @ $ . $   ##</L>
      <L> ##$  $   $   #</L>
      <L>  # $    .. $ #</L>
      <L>  #  $   ..   #</L>
      <L>  ##  $       #</L>
      <L>   ###       ##</L>
      <L>     #########</L>
    </Level>
    <Level Id="golden minecraft sword 01" Width="21" Height="25">
      <L>    #############</L>
      <L>    #   ##.##   #</L>
      <L>  ### $  ...  $ ###</L>
      <L>###   $  ...  $   ###</L>
      <L>#   $$$  ...  $$$   #</L>
      <L>#  $$    ...    $$  #</L>
      <L># $$     ...     $$ #</L>
      <L># $      ...      $ #</L>
      <L># $$     ...     $$ #</L>
      <L>#  $     ...     $  #</L>
      <L>## $$$$  ...  $$$$ ##</L>
      <L> #    $  ...  $    #</L>
      <L> #### $  ...  $ ####</L>
      <L> ##   $  ...  $   ##</L>
      <L> #  $$$  ...  $$$  #</L>
      <L> # $$    ...    $$ #</L>
      <L> # $     ...     $ #</L>
      <L> # $$$$. ... .$$$$ #</L>
      <L> #    $ ..... $    #</L>
      <L> #### ###...### ####</L>
      <L>    ######.######</L>
      <L>         #.#</L>
      <L>         #.#</L>
      <L>         #@#</L>
      <L>         ###</L>
    </Level>
    <Level Id="golden minecraft sword 02" Width="35" Height="24">
      <L>###################################</L>
      <L>#                                 #</L>
      <L># $$$$$$$$$$$$$$$$$$$$$$$$$$$$$$$ #</L>
      <L>#                                 #</L>
      <L># $$$$$$$$$$$$$$$$$$$$$$$$$$$$$$$ #</L>
      <L>#                                 #</L>
      <L>#    $$$$$$$$$$$$$$$$$$$$$$$$$    #</L>
      <L>#               . .. .            #</L>
      <L>###############. .  . .############</L>
      <L>             #. . .. . .#</L>
      <L>            #. . .  . . .#</L>
      <L>           #. . .    . . .#</L>
      <L>          #. . .      . . .#</L>
      <L>         #. . .        . . .#</L>
      <L>        #. . .          . . .#</L>
      <L>   ##  #. . .     #      . . .# ##</L>
      <L>   #.##. . .              . . .##.#</L>
      <L>   # .. . .      # #       . . .. #</L>
      <L>   #  .. .      #   #       . ..  #</L>
      <L>   # . ..       ##@##        ..   #</L>
      <L>   #.   .       #***#        . .  #</L>
      <L> ##.     .      #* *#       .   .##</L>
      <L> #.             #***#            .#</L>
      <L> ##################################</L>
    </Level>
  </LevelCollection>
</SokobanLevels>
