<?xml version="1.0" encoding="utf-8"?>
<SokobanLevels xmlns:xsi="http://www.w3.org/2001/XMLSchema-instance" xsi:schemaLocation="SokobanLev.xsd">
  <Title>Attrition</Title>
  <Description>
30 levels that I made by hand, including a variety of 30 different
levels.
  </Description>
  <Email>razorflame@yahoo.com</Email>
  <LevelCollection Copyright="Razorflame" MaxWidth="21" MaxHeight="16">
    <Level Id="1" Width="6" Height="5">
      <L>######</L>
      <L>#**..#</L>
      <L># $$*#</L>
      <L>#@   #</L>
      <L>######</L>
    </Level>
    <Level Id="2" Width="19" Height="16">
      <L>###################</L>
      <L>#............. $  #</L>
      <L>#............  $@ #</L>
      <L>#..#############$ #</L>
      <L>#..#           #  #</L>
      <L>#..# $ $$$ $$$ #$ #</L>
      <L>#..# $$$ $ $ $ #  #</L>
      <L>#..#   $ $ $ $ #$ #</L>
      <L>#..# $$$ $ $ $ #  #</L>
      <L>#..#   $ $ $ $ #$ #</L>
      <L>#..# $$$ $$$ $ #  #</L>
      <L>#..# $         #$ #</L>
      <L>#..#  ##########  #</L>
      <L>#..# $$ $ $ $ $ $ #</L>
      <L>#..#              #</L>
      <L>###################</L>
    </Level>
    <Level Id="3" Width="17" Height="6">
      <L>#################</L>
      <L>#..  $  @  $  ..#</L>
      <L>#*.   $$ $$   #*#</L>
      <L>#*#  $ $ $ $  .*#</L>
      <L>#..           ..#</L>
      <L>#################</L>
    </Level>
    <Level Id="4" Width="17" Height="6">
      <L>#################</L>
      <L>#..  $  @  $  ..#</L>
      <L>#*.   $$ $$   #*#</L>
      <L>#*#  $ $ $ $  .*#</L>
      <L>#..    * *    ..#</L>
      <L>#################</L>
    </Level>
    <Level Id="5" Width="17" Height="6">
      <L>#################</L>
      <L>#..  $  @  $  ..#</L>
      <L>#*.   $$ $$   .*#</L>
      <L>#*.$$* $ $ *$$.*#</L>
      <L>#..    * *    ..#</L>
      <L>#################</L>
    </Level>
    <Level Id="6" Width="17" Height="6">
      <L>#################</L>
      <L>#..  $  @  $  ..#</L>
      <L>#*.$* $$ $$ *$.*#</L>
      <L>#*.$ * $ $ * $.*#</L>
      <L>#..    * *    ..#</L>
      <L>#################</L>
    </Level>
    <Level Id="7" Width="17" Height="6">
      <L>#################</L>
      <L>#..  $  @  $  ..#</L>
      <L>#*..  $$ $$  .#*#</L>
      <L>#*#$*$ $ $ $*$.*#</L>
      <L>#..           ..#</L>
      <L>#################</L>
    </Level>
    <Level Id="8" Width="17" Height="6">
      <L>#################</L>
      <L>#..  $  *  $  ..#</L>
      <L>#*#   $   $   #*#</L>
      <L>#*#  $ $ $ $  #*#</L>
      <L>#..     @     ..#</L>
      <L>#################</L>
    </Level>
    <Level Id="9" Width="17" Height="6">
      <L>#################</L>
      <L>#..  *  *  *  ..#</L>
      <L>#*#   $   $   #*#</L>
      <L>#*# $$ $ $ $$ #*#</L>
      <L>#..     @     ..#</L>
      <L>#################</L>
    </Level>
    <Level Id="10" Width="17" Height="6">
      <L>#################</L>
      <L>#..  *  *  *  ..#</L>
      <L>#*#   $   $   #*#</L>
      <L>#*#$*$ $ $ $*$#*#</L>
      <L>#..     @     ..#</L>
      <L>#################</L>
    </Level>
    <Level Id="11" Width="21" Height="6">
      <L>#####################</L>
      <L>#..  $  @  $    ....#</L>
      <L>#*.$  $$ $$ $ $$....#</L>
      <L>#*.$$$ $ $ $$$$ .*..#</L>
      <L>#..    $ $      ....#</L>
      <L>#####################</L>
    </Level>
    <Level Id="12" Width="21" Height="6">
      <L>#####################</L>
      <L>#..  *  @  *  .. $..#</L>
      <L>#*.$  $$ $$  $.# $ *#</L>
      <L>#*.$$$ $ $.$$..#$$ *#</L>
      <L>#..    * *    .. $..#</L>
      <L>#####################</L>
    </Level>
    <Level Id="13" Width="21" Height="6">
      <L>#####################</L>
      <L>#.*  *  @  *  .   *.#</L>
      <L>#*.   $$ $$ $.*$  .*#</L>
      <L>#***** $.$.$$  #****#</L>
      <L>#.     * *        *.#</L>
      <L>#####################</L>
    </Level>
    <Level Id="14" Width="21" Height="6">
      <L>#####################</L>
      <L>#.*. *  @  *  .   *.#</L>
      <L>#*.   $$ $$ $.*$...*#</L>
      <L>#**$$$.$ $.$$ .*$$**#</L>
      <L>#..    * *        *.#</L>
      <L>#####################</L>
    </Level>
    <Level Id="15" Width="21" Height="6">
      <L>#####################</L>
      <L>#.*.   $@$       ..*#</L>
      <L>#*.. * $ $$.$$ $...*#</L>
      <L>#***$$.$ $.$$. $$***#</L>
      <L>#...   $ $       .*.#</L>
      <L>#####################</L>
    </Level>
    <Level Id="16" Width="11" Height="10">
      <L>###########</L>
      <L>#  .......#</L>
      <L># $......##</L>
      <L>#  ########</L>
      <L># $#     +#</L>
      <L>#  # $$$$$#</L>
      <L># $# $  $ #</L>
      <L>#  $ $ $$ #</L>
      <L>#         #</L>
      <L>###########</L>
    </Level>
    <Level Id="17" Width="11" Height="10">
      <L>###########</L>
      <L>#..$   $..#</L>
      <L>#..     ..#</L>
      <L>#  #$$$#$ #</L>
      <L>#  $   $  #</L>
      <L>#  $ @ $  #</L>
      <L># $#$$$#  #</L>
      <L>#..     ..#</L>
      <L>#..$   $..#</L>
      <L>###########</L>
    </Level>
    <Level Id="18" Width="11" Height="10">
      <L>###########</L>
      <L>#..     ..#</L>
      <L>#..$   $..#</L>
      <L>#.$#$$$#$ #</L>
      <L>#  $   $  #</L>
      <L>#  $ @ $  #</L>
      <L># $#$$$#$.#</L>
      <L>#..$   $..#</L>
      <L>#..     ..#</L>
      <L>###########</L>
    </Level>
    <Level Id="19" Width="11" Height="10">
      <L>###########</L>
      <L>#..     ..#</L>
      <L>#..$ $ $..#</L>
      <L>#  #$$$#$.#</L>
      <L>#  $   $  #</L>
      <L>#  $ @ $  #</L>
      <L>#.$#$$$#  #</L>
      <L>#..$ $ $..#</L>
      <L>#..     ..#</L>
      <L>###########</L>
    </Level>
    <Level Id="20" Width="11" Height="10">
      <L>###########</L>
      <L>#..  $  ..#</L>
      <L>#..$   $..#</L>
      <L>#.$#$$$#$.#</L>
      <L>#  $   $  #</L>
      <L>#  $ @ $  #</L>
      <L>#.$#$$$#$.#</L>
      <L>#..$   $..#</L>
      <L>#..  $  ..#</L>
      <L>###########</L>
    </Level>
    <Level Id="21" Width="11" Height="10">
      <L>###########</L>
      <L>#..$ $ $..#</L>
      <L>#..  $  ..#</L>
      <L>#  #$$$#  #</L>
      <L>#  $   $ .#</L>
      <L>#. $ @ $  #</L>
      <L>#  #$$$#  #</L>
      <L>#..  $  ..#</L>
      <L>#..$ $ $..#</L>
      <L>###########</L>
    </Level>
    <Level Id="22" Width="11" Height="10">
      <L>###########</L>
      <L>#..     ..#</L>
      <L>#..     ..#</L>
      <L>#$$#$$$# $#</L>
      <L>#  $   $  #</L>
      <L>#  $ @ $  #</L>
      <L>#$ #$$$#$$#</L>
      <L>#..     ..#</L>
      <L>#..     ..#</L>
      <L>###########</L>
    </Level>
    <Level Id="23" Width="11" Height="10">
      <L>###########</L>
      <L>#..*    ..#</L>
      <L>#..  $ $..#</L>
      <L># $#$$$#* #</L>
      <L>#  $   $  #</L>
      <L>#  $ @ $  #</L>
      <L># *#$$$#$ #</L>
      <L>#..$ $ *..#</L>
      <L>#..     ..#</L>
      <L>###########</L>
    </Level>
    <Level Id="24" Width="11" Height="10">
      <L>###########</L>
      <L>#..    *..#</L>
      <L>#..$ $  ..#</L>
      <L>#* #$$$#$ #</L>
      <L>#  $   $  #</L>
      <L>#  $ @ $  #</L>
      <L># $#$$$# *#</L>
      <L>#..  $ $..#</L>
      <L>#..*    ..#</L>
      <L>###########</L>
    </Level>
    <Level Id="25" Width="11" Height="10">
      <L>###########</L>
      <L>#..  $  ..#</L>
      <L>#..$   $..#</L>
      <L># *#$$$#* #</L>
      <L>#  $   $  #</L>
      <L>#  $ @ $  #</L>
      <L># *#$$$#* #</L>
      <L>#..$   $..#</L>
      <L>#..  $  ..#</L>
      <L>###########</L>
    </Level>
    <Level Id="26" Width="11" Height="10">
      <L>###########</L>
      <L>#..$   $..#</L>
      <L>#..  $  ..#</L>
      <L>#  .$$$.$ #</L>
      <L># $$   $  #</L>
      <L>#  $ @ $$ #</L>
      <L># $.$$$.  #</L>
      <L>#..  $  ..#</L>
      <L>#..$   $..#</L>
      <L>###########</L>
    </Level>
    <Level Id="27" Width="11" Height="10">
      <L>###########</L>
      <L>#..$   $..#</L>
      <L>#..     ..#</L>
      <L># $#$$$.$ #</L>
      <L>#  $   $  #</L>
      <L>#  $ @ $  #</L>
      <L># $.$$$#$ #</L>
      <L>#..     ..#</L>
      <L>#..$   $..#</L>
      <L>###########</L>
    </Level>
    <Level Id="28" Width="11" Height="10">
      <L>###########</L>
      <L>#..$   $..#</L>
      <L>#..     ..#</L>
      <L>#  .$$$.$ #</L>
      <L># $$   $  #</L>
      <L>#  $ @ $$ #</L>
      <L># $#$$$.$ #</L>
      <L>#..     ..#</L>
      <L>#..$   $..#</L>
      <L>###########</L>
    </Level>
    <Level Id="30" Width="11" Height="10">
      <L>###########</L>
      <L>#. $ $. . #</L>
      <L># . $  . .#</L>
      <L>#.$. $  . #</L>
      <L># .$. $  .#</L>
      <L>#.$. $ $  #</L>
      <L># . $ $ $ #</L>
      <L>#. $ $ $@ #</L>
      <L>#         #</L>
      <L>###########</L>
    </Level>
  </LevelCollection>
</SokobanLevels>
