<?xml version="1.0" encoding="utf-8"?>
<SokobanLevels xmlns:xsi="http://www.w3.org/2001/XMLSchema-instance" xsi:schemaLocation="SokobanLev.xsd">
  <Title>Attrition 2</Title>
  <Description>
These levels are getting harder for me to solve. In fact, I was unable
to solve most of the levels after Level 10, however, I did use a
solver to make sure that they were solvable.  This level collection is
the 2nd part of my Attrition level set.  Hope you enjoy them!  Please
leave me comments at my email address.  Thanks!
  </Description>
  <Email>razorflame@yahoo.com</Email>
  <LevelCollection Copyright="Razorflame" MaxWidth="14" MaxHeight="13">
    <Level Id="Level 1" Width="10" Height="10">
      <L>##########</L>
      <L>#@       #</L>
      <L># #$##$# #</L>
      <L># $      #</L>
      <L># # #$$###</L>
      <L># #  $...#</L>
      <L># $ $$. .#</L>
      <L># #$ $...#</L>
      <L>#    #...#</L>
      <L>##########</L>
    </Level>
    <Level Id="Level 2" Width="10" Height="10">
      <L>##########</L>
      <L>#@       #</L>
      <L># #$##$# #</L>
      <L># $      #</L>
      <L># # #$$###</L>
      <L># #  $...#</L>
      <L># $ $#. .#</L>
      <L># #$ $. .#</L>
      <L>#    #...#</L>
      <L>##########</L>
    </Level>
    <Level Id="Level 3" Width="10" Height="10">
      <L>##########</L>
      <L>#@       #</L>
      <L># #$##$# #</L>
      <L># $      #</L>
      <L># # ##$###</L>
      <L># #  $. .#</L>
      <L># $ $#. .#</L>
      <L># #$ $. .#</L>
      <L>#    #...#</L>
      <L>##########</L>
    </Level>
    <Level Id="Level 4" Width="10" Height="10">
      <L>##########</L>
      <L>#@       #</L>
      <L># #*##*# #</L>
      <L># *    * #</L>
      <L># #$#$ # #</L>
      <L>#  ..$ # #</L>
      <L># $..#   #</L>
      <L># ##$#* ##</L>
      <L>#    *  .#</L>
      <L>##########</L>
    </Level>
    <Level Id="Level 5" Width="14" Height="13">
      <L>##############</L>
      <L>#         # @#</L>
      <L>#  $ #       #</L>
      <L># #* ******* #</L>
      <L>#  * * # . . #</L>
      <L>#  * *       #</L>
      <L>#  * $*****  #</L>
      <L>#  * #    *  #</L>
      <L>#  *      * ##</L>
      <L>#  ********  #</L>
      <L>#  #      *  #</L>
      <L>#            #</L>
      <L>##############</L>
    </Level>
    <Level Id="Level 6" Width="14" Height="13">
      <L>##############</L>
      <L>#         # @#</L>
      <L>#  $ # $     #</L>
      <L># #* ******* #</L>
      <L>#  * * # .*. #</L>
      <L># .* *       #</L>
      <L>#  * $*****$ #</L>
      <L>#  * #.   *  #</L>
      <L>#  *    $ * ##</L>
      <L>#  ********  #</L>
      <L>#  # .    #  #</L>
      <L>#            #</L>
      <L>##############</L>
    </Level>
    <Level Id="Level 7" Width="11" Height="11">
      <L>###########</L>
      <L>#...     ##</L>
      <L>#.## $ $  #</L>
      <L>#   ##$#$ #</L>
      <L>#... $ $  #</L>
      <L>#..# $    #</L>
      <L>#.#  $$#$##</L>
      <L>##     #  #</L>
      <L># $$  #.  #</L>
      <L>#@   #..$ #</L>
      <L>###########</L>
    </Level>
    <Level Id="Level 8" Width="11" Height="11">
      <L>###########</L>
      <L>#..      ##</L>
      <L>#.## $ $  #</L>
      <L>#   ##$#$ #</L>
      <L>#... $ $  #</L>
      <L>#..# $    #</L>
      <L>#.#  #$#$##</L>
      <L>##     #  #</L>
      <L># $$  #.  #</L>
      <L>#@   #..$ #</L>
      <L>###########</L>
    </Level>
    <Level Id="Level 9" Width="11" Height="11">
      <L>###########</L>
      <L>#...     ##</L>
      <L>#.## $ $  #</L>
      <L># $ ##$#$ #</L>
      <L>#... $ $  #</L>
      <L>#..# $    #</L>
      <L>#.#  #$#$##</L>
      <L>##     #  #</L>
      <L># $$  #.  #</L>
      <L>#@   #..$ #</L>
      <L>###########</L>
    </Level>
    <Level Id="Level 10" Width="8" Height="8">
      <L> ######</L>
      <L>##    ##</L>
      <L># #.$  #</L>
      <L># .$.$ #</L>
      <L># $.$. #</L>
      <L>#@ $.# #</L>
      <L>##    ##</L>
      <L> ######</L>
    </Level>
    <Level Id="Level 11" Width="10" Height="10">
      <L>     #####</L>
      <L> ####    #</L>
      <L> ##   $. #</L>
      <L> # #.$.$ #</L>
      <L>## .$.$  #</L>
      <L># @$.$. #</L>
      <L># $.$.# #</L>
      <L># .$   ##</L>
      <L>#    ####</L>
      <L>######</L>
    </Level>
    <Level Id="Level 12" Width="10" Height="10">
      <L>##########</L>
      <L>##       #</L>
      <L>#@# $.$. #</L>
      <L>#  #.$.$ #</L>
      <L># $.$.$. #</L>
      <L># .$.$.$ #</L>
      <L># $.$.#  #</L>
      <L># .$.$ # #</L>
      <L>#       ##</L>
      <L>##########</L>
    </Level>
    <Level Id="Level 13" Width="10" Height="10">
      <L>   #######</L>
      <L>   #    ##</L>
      <L>   #$.$# #</L>
      <L>### .$.  #</L>
      <L>#@ .$.$  #</L>
      <L>#  $.$.  #</L>
      <L>#  .$. ###</L>
      <L># #$.$##</L>
      <L>##    #</L>
      <L>#######</L>
    </Level>
    <Level Id="Level 14" Width="9" Height="8">
      <L>  #######</L>
      <L>  #    @#</L>
      <L> #  **$ #</L>
      <L>#  **   #</L>
      <L>#   **  #</L>
      <L># .**  #</L>
      <L>#     #</L>
      <L>#######</L>
    </Level>
    <Level Id="Level 15" Width="13" Height="8">
      <L>    ########</L>
      <L>    #    @  #</L>
      <L>   #  ***$$ #</L>
      <L>###  **     #</L>
      <L>#     **  ###</L>
      <L># ..***  #</L>
      <L>#       #</L>
      <L>#########</L>
    </Level>
    <Level Id="Level 16" Width="13" Height="8">
      <L>    ########</L>
      <L>    #    @  #</L>
      <L>   #  **$$$ #</L>
      <L>###  **     #</L>
      <L>#     **  ###</L>
      <L># ...**  #</L>
      <L>#       #</L>
      <L>#########</L>
    </Level>
    <Level Id="Level 17" Width="9" Height="9">
      <L>    ####</L>
      <L>#####  #</L>
      <L># @ $  #</L>
      <L>#  *.* #</L>
      <L>##$.*.$##</L>
      <L> # *.*  #</L>
      <L> #  $   #</L>
      <L> #  #####</L>
      <L> ####</L>
    </Level>
    <Level Id="Level 18" Width="9" Height="9">
      <L> ##  ##</L>
      <L>#  ##  #</L>
      <L># * $  #</L>
      <L>#@  .$ #</L>
      <L> #*.*.*#</L>
      <L> # $.   #</L>
      <L> #  $ * #</L>
      <L> #  ##  #</L>
      <L> ###  ##</L>
    </Level>
    <Level Id="Level 19" Width="8" Height="10">
      <L> ##  ##</L>
      <L>#  ##  #</L>
      <L>#  *   #</L>
      <L>#@$. $ #</L>
      <L> # .* #</L>
      <L> # *. #</L>
      <L># $ .$ #</L>
      <L>#   *  #</L>
      <L>#  ##  #</L>
      <L> ##  ##</L>
    </Level>
    <Level Id="Level 20" Width="8" Height="10">
      <L> ##  ##</L>
      <L>#  ##  #</L>
      <L>#  $   #</L>
      <L>#@$. $ #</L>
      <L> #..* #</L>
      <L> # *..#</L>
      <L># $ .$ #</L>
      <L>#   $  #</L>
      <L>#  ##  #</L>
      <L> ##  ##</L>
    </Level>
    <Level Id="Level 21" Width="8" Height="10">
      <L> ##  ##</L>
      <L>#  ##  #</L>
      <L>#  $   #</L>
      <L>#@$..$ #</L>
      <L> #..$ #</L>
      <L> # $..#</L>
      <L># $..$ #</L>
      <L>#   $  #</L>
      <L>#  ##  #</L>
      <L> ##  ##</L>
    </Level>
    <Level Id="Level 22" Width="10" Height="10">
      <L> ###  ###</L>
      <L>#   ##   #</L>
      <L># * $  * #</L>
      <L># @$..$  #</L>
      <L># #..$ # #</L>
      <L># # $..# #</L>
      <L>#  $..$  #</L>
      <L># *  $ * #</L>
      <L>#   ##   #</L>
      <L> ###  ###</L>
    </Level>
    <Level Id="Level 23" Width="10" Height="10">
      <L> ###  ###</L>
      <L>#   ##   #</L>
      <L># $ $  * #</L>
      <L># @$..$  #</L>
      <L># #..$.# #</L>
      <L># #.$..# #</L>
      <L>#  $..$  #</L>
      <L># *  $ $ #</L>
      <L>#   ##   #</L>
      <L> ###  ###</L>
    </Level>
    <Level Id="Level 24" Width="10" Height="10">
      <L> ###  ###</L>
      <L>#   ##   #</L>
      <L># $ $ .$ #</L>
      <L># @$..$  #</L>
      <L># #..$.# #</L>
      <L># #.$..# #</L>
      <L>#  $..$  #</L>
      <L># $. $ $ #</L>
      <L>#   ##   #</L>
      <L> ###  ###</L>
    </Level>
    <Level Id="Level 25" Width="9" Height="9">
      <L>   ###</L>
      <L>  #  .#</L>
      <L> ## $ ##</L>
      <L>#. * *  #</L>
      <L># $@# $ #</L>
      <L>#  * * .#</L>
      <L> ## $ ##</L>
      <L>  #.  #</L>
      <L>   ###</L>
    </Level>
    <Level Id="Level 26" Width="9" Height="9">
      <L>   ###</L>
      <L>  #  .#</L>
      <L> #  $  #</L>
      <L>#. * *  #</L>
      <L>#*$@# $*#</L>
      <L>#  * * .#</L>
      <L> #  $  #</L>
      <L>  #.  #</L>
      <L>   ###</L>
    </Level>
    <Level Id="Level 27" Width="9" Height="9">
      <L>   ###</L>
      <L>  #. .#</L>
      <L> #  $  #</L>
      <L>#. $ * .#</L>
      <L>#$$@# $$#</L>
      <L>#. * $ .#</L>
      <L> #  $  #</L>
      <L>  #. .#</L>
      <L>   ###</L>
    </Level>
    <Level Id="Level 28" Width="9" Height="9">
      <L>   ###</L>
      <L>  #  .#</L>
      <L> # .$ .#</L>
      <L>#. $ $ .#</L>
      <L>#$$@# $$#</L>
      <L>#. $ $ .#</L>
      <L> #. $. #</L>
      <L>  #.  #</L>
      <L>   ###</L>
    </Level>
    <Level Id="Level 29" Width="11" Height="11">
      <L>    ###</L>
      <L>   #. .#</L>
      <L>  # * $.#</L>
      <L> # $.* *.#</L>
      <L>#.  $ $  .#</L>
      <L>#$$$@# $$$#</L>
      <L>#.  $ $  .#</L>
      <L> #.* *.$ #</L>
      <L>  #.$ * #</L>
      <L>   #. .#</L>
      <L>    ###</L>
    </Level>
    <Level Id="Level 30" Width="11" Height="11">
      <L>    ###</L>
      <L>   #. .#</L>
      <L>  # * $.#</L>
      <L> # $.$.*.#</L>
      <L>#.  $ $  .#</L>
      <L>#$$$@# $$$#</L>
      <L>#.  $ $  .#</L>
      <L> #.*.$.$ #</L>
      <L>  #.$ * #</L>
      <L>   #. .#</L>
      <L>    ###</L>
    </Level>
  </LevelCollection>
</SokobanLevels>
