<?xml version="1.0" encoding="utf-8"?>
<SokobanLevels xmlns:xsi="http://www.w3.org/2001/XMLSchema-instance" xsi:schemaLocation="SokobanLev.xsd">
  <Title>Smaller, thinner, easier, better</Title>
  <Description>
This compilation includes the tiniest, easy, thin levels, and
entertaining of resolving. Enjoy them!

Ed: Removed many duplicates.
  </Description>
  <Email>homz70@gmail.com</Email>
  <Url>http://sapiens.ya.com/sokobanhomz</Url>
  <LevelCollection Copyright="Martí Homs Caussa" MaxWidth="9" MaxHeight="8">
    <Level Id="1" Width="8" Height="6">
      <L>####</L>
      <L>#  #####</L>
      <L># .  $ #</L>
      <L># $  .@#</L>
      <L>###  ###</L>
      <L>  ####</L>
    </Level>
    <Level Id="2" Width="8" Height="6">
      <L>  ####</L>
      <L>  #  #</L>
      <L>###  ###</L>
      <L># $*.@ #</L>
      <L>#      #</L>
      <L>########</L>
    </Level>
    <Level Id="3" Width="7" Height="7">
      <L>  ####</L>
      <L>###  #</L>
      <L>#  *@#</L>
      <L>#  $.##</L>
      <L>###   #</L>
      <L>  #   #</L>
      <L>  #####</L>
    </Level>
    <Level Id="4" Width="8" Height="7">
      <L> #######</L>
      <L>## @   #</L>
      <L># $.   #</L>
      <L># .$####</L>
      <L>##  #</L>
      <L> #  #</L>
      <L> ####</L>
    </Level>
    <Level Id="5" Width="7" Height="7">
      <L>  ####</L>
      <L>  #  #</L>
      <L>###  #</L>
      <L>#   @##</L>
      <L># *$. #</L>
      <L>###   #</L>
      <L>  #####</L>
    </Level>
    <Level Id="6" Width="7" Height="8">
      <L>  ####</L>
      <L>  #  #</L>
      <L>  #  #</L>
      <L>### @##</L>
      <L># *$. #</L>
      <L>#     #</L>
      <L>##  ###</L>
      <L> ####</L>
    </Level>
    <Level Id="7" Width="8" Height="7">
      <L>  ######</L>
      <L>  #    #</L>
      <L>###    #</L>
      <L>#   @###</L>
      <L># *$.#</L>
      <L>###  #</L>
      <L>  ####</L>
    </Level>
    <Level Id="8" Width="7" Height="7">
      <L> ######</L>
      <L> #    #</L>
      <L>##$ . #</L>
      <L>#  @  #</L>
      <L># $#. #</L>
      <L>#  ####</L>
      <L>####</L>
    </Level>
    <Level Id="9" Width="6" Height="8">
      <L>####</L>
      <L>#  #</L>
      <L># @#</L>
      <L>#.$###</L>
      <L>#    #</L>
      <L>#.$# #</L>
      <L>##   #</L>
      <L> #####</L>
    </Level>
    <Level Id="10" Width="7" Height="7">
      <L>  ####</L>
      <L>###  #</L>
      <L>#  $@#</L>
      <L>#  $ ##</L>
      <L>###   #</L>
      <L>  # ..#</L>
      <L>  #####</L>
    </Level>
    <Level Id="11" Width="8" Height="6">
      <L>########</L>
      <L># .$@  #</L>
      <L>#  $ . #</L>
      <L>###  ###</L>
      <L>  #  #</L>
      <L>  ####</L>
    </Level>
    <Level Id="12" Width="8" Height="6">
      <L>  ####</L>
      <L>  #  #</L>
      <L>###  ###</L>
      <L># $$ @ #</L>
      <L>#    ..#</L>
      <L>########</L>
    </Level>
    <Level Id="13" Width="7" Height="7">
      <L>  #####</L>
      <L>###   #</L>
      <L>#  .@ #</L>
      <L># $$  #</L>
      <L>##. ###</L>
      <L> #  #</L>
      <L> ####</L>
    </Level>
    <Level Id="14" Width="8" Height="8">
      <L> ####</L>
      <L> #  #</L>
      <L> # .#</L>
      <L>##$@#</L>
      <L># $ ####</L>
      <L>#  .   #</L>
      <L>####   #</L>
      <L>   #####</L>
    </Level>
    <Level Id="15" Width="6" Height="8">
      <L> #####</L>
      <L> #   #</L>
      <L>##   #</L>
      <L># $$##</L>
      <L>#..@#</L>
      <L>#  ##</L>
      <L>#  #</L>
      <L>####</L>
    </Level>
    <Level Id="16" Width="8" Height="6">
      <L> #######</L>
      <L>## .   #</L>
      <L># $*$  #</L>
      <L>#  .@###</L>
      <L>#    #</L>
      <L>######</L>
    </Level>
    <Level Id="17" Width="8" Height="7">
      <L>  ####</L>
      <L>  #  ###</L>
      <L>###.$. #</L>
      <L>#  $.$ #</L>
      <L>#   @###</L>
      <L>#    #</L>
      <L>######</L>
    </Level>
    <Level Id="18" Width="7" Height="8">
      <L>  ####</L>
      <L>  #  #</L>
      <L>  #  #</L>
      <L>###$.#</L>
      <L># @.$##</L>
      <L># #$. #</L>
      <L>#     #</L>
      <L>#######</L>
    </Level>
    <Level Id="19" Width="7" Height="8">
      <L>  ####</L>
      <L>  #  #</L>
      <L>###  #</L>
      <L>#  * #</L>
      <L>#@.*$##</L>
      <L>## *  #</L>
      <L> #    #</L>
      <L> ######</L>
    </Level>
    <Level Id="20" Width="8" Height="8">
      <L> ####</L>
      <L> #  #</L>
      <L> #  #</L>
      <L> #  ####</L>
      <L>###$$  #</L>
      <L>#   .*@#</L>
      <L>#   .###</L>
      <L>######</L>
    </Level>
    <Level Id="21" Width="7" Height="8">
      <L> ####</L>
      <L> #  ###</L>
      <L> # ...#</L>
      <L>##$   #</L>
      <L># $ ###</L>
      <L># $ #</L>
      <L>#  @#</L>
      <L>#####</L>
    </Level>
    <Level Id="22" Width="8" Height="6">
      <L> #######</L>
      <L>##  .  #</L>
      <L># *$$  #</L>
      <L># #@ ###</L>
      <L># .  #</L>
      <L>######</L>
    </Level>
    <Level Id="24" Width="8" Height="8">
      <L>#####</L>
      <L>#   #</L>
      <L>#   ####</L>
      <L>##$$ $ #</L>
      <L> #+. . #</L>
      <L> #  ####</L>
      <L> #  #</L>
      <L> ####</L>
    </Level>
    <Level Id="25" Width="8" Height="6">
      <L>########</L>
      <L>#  #   #</L>
      <L>#      #</L>
      <L>#$$$####</L>
      <L>#+. .#</L>
      <L>######</L>
    </Level>
    <Level Id="26" Width="7" Height="7">
      <L>#######</L>
      <L>#   ..#</L>
      <L># $ @.#</L>
      <L>##$$  #</L>
      <L> #  ###</L>
      <L> #  #</L>
      <L> ####</L>
    </Level>
    <Level Id="27" Width="8" Height="7">
      <L>  ####</L>
      <L>  #  #</L>
      <L>###  ###</L>
      <L># $ *$ #</L>
      <L># .@ . #</L>
      <L>##   ###</L>
      <L> #####</L>
    </Level>
    <Level Id="28" Width="8" Height="8">
      <L>####</L>
      <L>#  #</L>
      <L>#  #####</L>
      <L># $$ $ #</L>
      <L>#@.. . #</L>
      <L>##  ####</L>
      <L> #  #</L>
      <L> ####</L>
    </Level>
    <Level Id="29" Width="9" Height="6">
      <L>#######</L>
      <L>#   .@###</L>
      <L>#  ***  #</L>
      <L>#   $   #</L>
      <L>######  #</L>
      <L>     ####</L>
    </Level>
  </LevelCollection>
</SokobanLevels>
