<?xml version="1.0" encoding="utf-8"?>
<SokobanLevels xmlns:xsi="http://www.w3.org/2001/XMLSchema-instance" xsi:schemaLocation="SokobanLev.xsd">
  <Title>Blazz</Title>
  <Description>
Hope you will enjoy playing my levels.
  </Description>
  <Email>blaz.nikolic@gmail.com</Email>
  <LevelCollection Copyright="Blaz Nikolic" MaxWidth="16" MaxHeight="14">
    <Level Id="1" Width="9" Height="8">
      <L>#####</L>
      <L># @ #</L>
      <L>#   #####</L>
      <L># $  $  #</L>
      <L>###$$## #</L>
      <L> #  ..  #</L>
      <L> #  ..###</L>
      <L> ######</L>
    </Level>
    <Level Id="2" Width="16" Height="9">
      <L>  ############</L>
      <L>  #     #    ###</L>
      <L>### # # #..... #</L>
      <L># $$$$$ @    # #</L>
      <L># # # # ###  # #</L>
      <L># #     ###### #</L>
      <L># #######      #</L>
      <L>#         ######</L>
      <L>###########</L>
    </Level>
    <Level Id="3" Width="11" Height="9">
      <L>   #####</L>
      <L>  ##   ###</L>
      <L>### $#   #</L>
      <L>#    . $ #</L>
      <L># #.#*#.###</L>
      <L># #  *  $@#</L>
      <L>#   ## ## #</L>
      <L>######    #</L>
      <L>     ######</L>
    </Level>
    <Level Id="4" Width="9" Height="9">
      <L>   #####</L>
      <L> ### @ ##</L>
      <L> #   #  #</L>
      <L> # #.$. #</L>
      <L>## #$*$ #</L>
      <L>#   .$. #</L>
      <L># # #####</L>
      <L>#   #</L>
      <L>#####</L>
    </Level>
    <Level Id="5" Width="8" Height="8">
      <L>########</L>
      <L>#      #</L>
      <L># #$.#@#</L>
      <L># $. . #</L>
      <L>##$#.$##</L>
      <L> # #  #</L>
      <L> #   ##</L>
      <L> #####</L>
    </Level>
    <Level Id="6" Width="10" Height="11">
      <L>    ####</L>
      <L>   ##  #</L>
      <L>   #   #</L>
      <L> ###   #</L>
      <L>##  $#$##</L>
      <L>#  #@$  #</L>
      <L># # $ $ #</L>
      <L>#...#$# ##</L>
      <L>#   .*.. #</L>
      <L>##  ##   #</L>
      <L> #########</L>
    </Level>
    <Level Id="7" Width="11" Height="11">
      <L>   #####</L>
      <L>   # . #</L>
      <L>   #$.$#</L>
      <L>#### . ####</L>
      <L># $ $ $ $ #</L>
      <L>#... @ ...#</L>
      <L># $ $ $ $ #</L>
      <L>#### . ####</L>
      <L>   #$.$#</L>
      <L>   # . #</L>
      <L>   #####</L>
    </Level>
    <Level Id="8" Width="9" Height="8">
      <L>#########</L>
      <L>#   ## @#</L>
      <L>#    $  #</L>
      <L>##$  ##$#</L>
      <L>## #$. .#</L>
      <L># $  .#.#</L>
      <L>#   #.  #</L>
      <L>#########</L>
    </Level>
    <Level Id="9" Width="10" Height="8">
      <L> #######</L>
      <L> #  #@ ###</L>
      <L>## $#$ $ #</L>
      <L>#.  #  $ #</L>
      <L>#..* $   #</L>
      <L>#..# $ $ #</L>
      <L>#. . #####</L>
      <L>######</L>
    </Level>
    <Level Id="10" Width="10" Height="11">
      <L>########</L>
      <L>#      #</L>
      <L># #$##$#</L>
      <L># #..  #</L>
      <L># #..# #</L>
      <L>#  ..# ###</L>
      <L>####$#   #</L>
      <L># $ $ $  #</L>
      <L>#   @ ####</L>
      <L>#  ####</L>
      <L>####</L>
    </Level>
    <Level Id="11" Width="11" Height="7">
      <L>###########</L>
      <L># .  #    #</L>
      <L># *$$#$.  #</L>
      <L>#@.   $. ##</L>
      <L># *$$#$. #</L>
      <L># .  # . #</L>
      <L>##########</L>
    </Level>
    <Level Id="12" Width="13" Height="9">
      <L>     #####</L>
      <L> #####   #</L>
      <L> # $     #</L>
      <L> # #$##$#####</L>
      <L>##@  .. ..  #</L>
      <L>#  ######$$ #</L>
      <L># $$ $ $ $  #</L>
      <L>#  # .. ....#</L>
      <L>#############</L>
    </Level>
    <Level Id="13" Width="11" Height="14">
      <L>  #######</L>
      <L>  #     ###</L>
      <L>### # #   #</L>
      <L>#@$$$$$   #</L>
      <L>#     ## ##</L>
      <L>######## ##</L>
      <L>#         #</L>
      <L># $$ $    #</L>
      <L>###  ######</L>
      <L># $ $ $ #</L>
      <L>#.....# #</L>
      <L>#.#*#*# #</L>
      <L>#.....  #</L>
      <L>#########</L>
    </Level>
    <Level Id="14" Width="12" Height="13">
      <L>    ####</L>
      <L>    #  ####</L>
      <L>##### $   #</L>
      <L>#   #  ##$##</L>
      <L># @ ..*##  #</L>
      <L>## #.#.##$ #</L>
      <L> # #.#.##  #</L>
      <L> # $... #$ #</L>
      <L> # $ $  #  #</L>
      <L> # ######$ #</L>
      <L> # $       #</L>
      <L> #   #######</L>
      <L> #####</L>
    </Level>
    <Level Id="15" Width="14" Height="11">
      <L>         #####</L>
      <L> #########   #</L>
      <L> #   ..... # #</L>
      <L> # ##.#$##$  #</L>
      <L>##$##.*...  ##</L>
      <L># $ $ #  # ##</L>
      <L>#   @ $  # ##</L>
      <L>##$###$###  #</L>
      <L>#     $   $ #</L>
      <L>#   ######  #</L>
      <L>#####    ####</L>
    </Level>
    <Level Id="16" Width="15" Height="11">
      <L>       #####</L>
      <L> #######   #</L>
      <L> #       # #</L>
      <L>##@###$$$$ #</L>
      <L>#   ## $ $##</L>
      <L># # $  #...#</L>
      <L>#  $$$ #..#####</L>
      <L>##  #  #..... #</L>
      <L> #### ####### #</L>
      <L>    #         #</L>
      <L>    ###########</L>
    </Level>
    <Level Id="17" Width="14" Height="12">
      <L>     #########</L>
      <L>   ###  #    #</L>
      <L>   # $ $# $# #</L>
      <L>  ##   $   # #</L>
      <L>###. ### $ $ #</L>
      <L># ...$@#   # #</L>
      <L># #. #$###$  #</L>
      <L>#   #..    ###</L>
      <L>#    ..  ###</L>
      <L>##### # ##</L>
      <L>    #   #</L>
      <L>    #####</L>
    </Level>
    <Level Id="18" Width="14" Height="12">
      <L>      ######</L>
      <L>     ##    #</L>
      <L>######@ ##$###</L>
      <L>#   # .# $ $ #</L>
      <L># $  ...     #</L>
      <L>## ## .$ #$###</L>
      <L> # ##$.### #</L>
      <L> # ## . ## ##</L>
      <L> # ###.$##  #</L>
      <L> #$   .     #</L>
      <L> #  #########</L>
      <L> ####</L>
    </Level>
  </LevelCollection>
</SokobanLevels>
