<?xml version="1.0" encoding="utf-8"?>
<SokobanLevels xmlns:xsi="http://www.w3.org/2001/XMLSchema-instance" xsi:schemaLocation="SokobanLev.xsd">
  <Title>Bruno Druille</Title>
  <Description>
Level collection by Bruno Druille
  </Description>
  <Email>brunodruille@yahoo.fr</Email>
  <Url>http://druille.canalblog.com/albums/jeux/index.html</Url>
  <LevelCollection Copyright="Bruno Druille" MaxWidth="19" MaxHeight="16">
    <Level Id="Tableau 51" Width="19" Height="16">
      <L>####</L>
      <L>#  #</L>
      <L>#  ################</L>
      <L>#      $     $ ##.#</L>
      <L>#  ####$##  ## #..#</L>
      <L>##    # ##   # .. #</L>
      <L> # ## # #  #####. #</L>
      <L> # #    # $#  #...#</L>
      <L> # ######$ #   #..#</L>
      <L> # #@#  $  $   #.##</L>
      <L>##$# # $$ $ #   ..#</L>
      <L>#       $#  #   .##</L>
      <L>#  # #   #########</L>
      <L># $  $ $ #</L>
      <L># #   ####</L>
      <L>#######</L>
    </Level>
    <Level Id="Tableau 52" Width="19" Height="16">
      <L>###################</L>
      <L>#   ##        #   #</L>
      <L># $  $ # # $  $   #</L>
      <L>##  #### ##$####$##</L>
      <L>#   $      $ @#   #</L>
      <L># $ # #  # #  $   #</L>
      <L>### # ## # ## #####</L>
      <L>#   # #  # # $  $ #</L>
      <L>#$   $ # # #  ##  #</L>
      <L>#  #$  # # #$  #  #</L>
      <L># ##   $ # $   #$##</L>
      <L>#  #  ## # #$#  $.#</L>
      <L>#..# ### # $    ..#</L>
      <L>#.... ##$######.#.#</L>
      <L>#.....   #...... .#</L>
      <L>###################</L>
    </Level>
    <Level Id="Tableau 70" Width="16" Height="16">
      <L>  ###########</L>
      <L>  #         ####</L>
      <L>### $$$$#$$ $  #</L>
      <L>#     #      $ #</L>
      <L># $ $$#..$$$$  #</L>
      <L>#####....#   ###</L>
      <L>    #......###</L>
      <L>    #..##..#</L>
      <L>    #......##</L>
      <L>  ###$#.*.$ #</L>
      <L>  #  $ ..#$ ##</L>
      <L>  #  #  #    ##</L>
      <L>  # $$ #   $  #</L>
      <L>  ## $#@$ #$$ #</L>
      <L>   #         ##</L>
      <L>   ###########</L>
    </Level>
    <Level Id="Tableau 71" Width="16" Height="16">
      <L>############</L>
      <L>#     #..  #</L>
      <L>#     ...# #####</L>
      <L>#### ##...     #</L>
      <L>#     ..#####  #</L>
      <L># $  # ....## ##</L>
      <L>#  # ## ##  # #</L>
      <L># $#$  $@#$$# #</L>
      <L># $  ##$$# $  #</L>
      <L>###   #    #  #</L>
      <L>  # $$# ##    #</L>
      <L>  # #    ######</L>
      <L>  #    #  #</L>
      <L>  #  #$$  #</L>
      <L>  #       #</L>
      <L>  #########</L>
    </Level>
    <Level Id="Tableau 72" Width="19" Height="16">
      <L>###################</L>
      <L>#        ##       #</L>
      <L># $$$$$$$ #   $$  #</L>
      <L>#    $     # #   ##</L>
      <L># #  $ $# $   ##  #</L>
      <L># ## $    $#$ ##  #</L>
      <L># ###   # $   ##  #</L>
      <L># ### $## $# #....#</L>
      <L># ##   #  $  ..#..#</L>
      <L># #  $$$$$$ #.#...#</L>
      <L>#   $$    ##......#</L>
      <L>##$$$    ###...#..#</L>
      <L>#@$     ####..#...#</L>
      <L># $$$$$#####......#</L>
      <L># $         .*...##</L>
      <L>##################</L>
    </Level>
    <Level Id="Tableau 73" Width="17" Height="16">
      <L>      ###</L>
      <L>   ###...##</L>
      <L>  # .......##</L>
      <L>  # .$$$$$$$@##</L>
      <L> # $.$.....$   #</L>
      <L>#  $.$.$$$.$##  #</L>
      <L># .$.$.$.$.$.   #</L>
      <L>#  $.$...$.$#   #</L>
      <L> # $.$$$$$.$   #</L>
      <L>  #$.......$  #</L>
      <L>  # $$$$$$$ ##</L>
      <L>   #  #.#  #</L>
      <L>   #      #</L>
      <L>    #    #</L>
      <L>     #  #</L>
      <L>      ##</L>
    </Level>
    <Level Id="Tableau 74" Width="19" Height="11">
      <L>###########</L>
      <L>#       . ######</L>
      <L># $$$$$ #   #  ###</L>
      <L># $   $ . #.    .#</L>
      <L># $   $#. $ # ...##</L>
      <L># $$$$$ .# .......#</L>
      <L># $@  $#. $ # ...##</L>
      <L># $$$$$ . #.    .#</L>
      <L>#     $ #     ####</L>
      <L>#######  .#####</L>
      <L>      #####</L>
    </Level>
    <Level Id="Tableau 75" Width="19" Height="16">
      <L>############ ######</L>
      <L>#       #  ###... #</L>
      <L>#     ..**.#    $.#</L>
      <L>#.#######..#  ## .#</L>
      <L>#   #   # ###$## .#</L>
      <L># #   $$       $$##</L>
      <L># # $# ##$## ###  #</L>
      <L># $$ # ... #   $ @#</L>
      <L>##$ $# *#. # $  ###</L>
      <L># $  # * .## ###  #</L>
      <L># $ $ # #      $$ #</L>
      <L>#    $$ #  # #$# .#</L>
      <L>#  $#  #####   ...#</L>
      <L>##   $$$ $   # ...#</L>
      <L> #       #   # ...#</L>
      <L> ##################</L>
    </Level>
    <Level Id="Tableau 76" Width="19" Height="16">
      <L>     ##############</L>
      <L>    ##     #      #</L>
      <L>  ###      $ #### #</L>
      <L> ##   #$##  $@### #</L>
      <L>##  ## $..#  $  # #</L>
      <L>#  #  . .  #  $ # #</L>
      <L># #   #.#   ## ## #</L>
      <L># $ $#...#$ #     #</L>
      <L># $ ...#..$.#    ##</L>
      <L># $#.#.. #...$ # ##</L>
      <L>#  #  # #  #  # $ #</L>
      <L># $ # $ $ #  ##   #</L>
      <L>##   #   #  ###$$ #</L>
      <L> ###  ###  ### $  #</L>
      <L>   ##      ###    #</L>
      <L>    ###############</L>
    </Level>
    <Level Id="Tableau 77" Width="19" Height="16">
      <L>       #####</L>
      <L>      #     #</L>
      <L>     # $$$ $ #</L>
      <L>    # $   $ $ #</L>
      <L>   # $...$$  $ #</L>
      <L>  #  $.#.....   #</L>
      <L> #  $ ..#..#.$$$ #</L>
      <L>#   $ $...#.*  $ @#</L>
      <L>#  $  $..#...$$$ #</L>
      <L> #  $ $.#..#..  #</L>
      <L>  # $ $.....#. #</L>
      <L>   # $$$ $$...#</L>
      <L>    #  $$  $ #</L>
      <L>     #   $  #</L>
      <L>      #    #</L>
      <L>       ####</L>
    </Level>
    <Level Id="Tableau 78" Width="19" Height="11">
      <L>         #</L>
      <L>        #@#</L>
      <L>       #...#</L>
      <L>      # *** #</L>
      <L>     #.*...*.#</L>
      <L>    ##*.*.*.*##</L>
      <L>   # $ $.#.$ $ #</L>
      <L>  # $   . .   $ #</L>
      <L> # $ $$$ $ $$$ $ #</L>
      <L>#                 #</L>
      <L>###################</L>
    </Level>
    <Level Id="Tableau 79" Width="8" Height="9">
      <L>########</L>
      <L>#. $   #</L>
      <L>#$.$ $ #</L>
      <L>#.*.*$ #</L>
      <L>#@*..$ #</L>
      <L>#.*.*$ #</L>
      <L>#$.$   #</L>
      <L>#. $   #</L>
      <L>########</L>
    </Level>
    <Level Id="Tableau 80" Width="19" Height="16">
      <L> ##    #######</L>
      <L># @## #       #</L>
      <L># $  #   $$$$$ #</L>
      <L># $  #$   #   $ #</L>
      <L> #$##  #$ #    $ #</L>
      <L> #      $$#$$   $ #</L>
      <L> # #  ###   $$ ## #</L>
      <L>#   ##   #   $$   #</L>
      <L>#   $  # #  # $$$ #</L>
      <L> ###     #  #   . #</L>
      <L>#...# # #.## ###.#</L>
      <L>#...   #... *.....#</L>
      <L>#..##$ *..*.####$#</L>
      <L>#*.. $$#..$#  .  .#</L>
      <L>#  #   #..$   .$ .#</L>
      <L> ## ### ##########</L>
    </Level>
    <Level Id="Tableau 81" Width="19" Height="16">
      <L> #################</L>
      <L>##      .        #</L>
      <L>#   ####$####### #</L>
      <L># $#     @     # #</L>
      <L>#  #   ..*..   # ##</L>
      <L>## #####*#$####.  #</L>
      <L> #  $....*......# #</L>
      <L>## $$ ##.#### # $ #</L>
      <L># $$  #..     #$$ #</L>
      <L>#   $###### #   $ #</L>
      <L>###   $      $ ####</L>
      <L>  #  $$$  ### ##</L>
      <L>  ##   ####    #</L>
      <L>   #####  # $  #</L>
      <L>          ###  #</L>
      <L>            ####</L>
    </Level>
    <Level Id="Tableau 82" Width="16" Height="15">
      <L>    #####    ###</L>
      <L> ###     ####  #</L>
      <L> #             #</L>
      <L>#      ######  #</L>
      <L>#  $$##     #.#</L>
      <L>#$$$ #   #$$..#</L>
      <L>#....#  $$ # .#</L>
      <L>#...##  $  #$.#</L>
      <L>#$# $ #  #. $.#</L>
      <L># #  $ #$@# $.#</L>
      <L>#  #   $  # $*#</L>
      <L> # ## #  #....#</L>
      <L> #    # #  ####</L>
      <L> ######   #</L>
      <L>      ####</L>
    </Level>
    <Level Id="Tableau 83" Width="19" Height="16">
      <L>###################</L>
      <L>#        #        #</L>
      <L>#  $ $ ## #$$ $$$ #</L>
      <L># $$$$  .#..#$  $ #</L>
      <L>#    ##.#...  # $ #</L>
      <L># $$#  ..#..$$#   #</L>
      <L># $ # $...#$#     #</L>
      <L># #   $..#..# #$  #</L>
      <L>### #$#$#...$ $ ###</L>
      <L>#     $..#.. #$   #</L>
      <L># # $#$...#.#   # #</L>
      <L>#  #   ..#.  $ #  #</L>
      <L>## #### # # #### ##</L>
      <L># $    . # $    . #</L>
      <L>#   #  # @ #  #   #</L>
      <L>###################</L>
    </Level>
    <Level Id="Tableau 84" Width="19" Height="16">
      <L>###################</L>
      <L>#   #  # #@#  #   #</L>
      <L># . $  . $ .  $   #</L>
      <L>## ###   #   ### ##</L>
      <L>#  #  ### ###  #  #</L>
      <L># #  $$ $ $ $$  # #</L>
      <L>#   $$ $   $ $$ $ #</L>
      <L> #*....$...$.....#</L>
      <L> # ..#.$ # $.#.. #</L>
      <L>  #$...$ # $...$#</L>
      <L>  # $$$$$$$$$$$ #</L>
      <L>   # $.......$ #</L>
      <L>   #  $..#..$  #</L>
      <L>    ##   $   ##</L>
      <L>      ##. .##</L>
      <L>        ###</L>
    </Level>
    <Level Id="Tableau 85" Width="19" Height="16">
      <L>     ##############</L>
      <L>    ## #       #  #</L>
      <L>#####  # #####  * #</L>
      <L>#   # $  #... ##  #</L>
      <L>#    $ ###*....# ##</L>
      <L>## ### #   $#. #  #</L>
      <L> #  ## ## $ ..#   #</L>
      <L>##  ##  #$$ #*# *##</L>
      <L>#  ## *.#.*   #  ##</L>
      <L>#   *. ** .$$  #  #</L>
      <L>#  #  * #*.$   #  #</L>
      <L>######.## $$$  # ##</L>
      <L>##@$  $ #     ##  #</L>
      <L># $   $ ######    #</L>
      <L>#   #          #  #</L>
      <L>###################</L>
    </Level>
    <Level Id="Tableau 86" Width="19" Height="16">
      <L> #################</L>
      <L> #  # ...#  #    ##</L>
      <L>##### .$.#   $ $  #</L>
      <L>#   ##...# #### $ #</L>
      <L>#   ...#.# $   $$ #</L>
      <L>#   ...#..  #$  # #</L>
      <L>### ####.# ## $ $ #</L>
      <L> #      .$  #   # #</L>
      <L>#   #   #   #$$#  #</L>
      <L>#   #########    ##</L>
      <L>#    #      # $  #</L>
      <L>#  # # #   ##$$$ #</L>
      <L>#         ##@  $ #</L>
      <L> #  #    ##### $  #</L>
      <L>  #     ##    #   #</L>
      <L>   ######      ####</L>
    </Level>
    <Level Id="Tableau 87" Width="19" Height="16">
      <L>###################</L>
      <L>#      #          #</L>
      <L># ##   # #  $ $$$ #</L>
      <L># $ $# # .  #     #</L>
      <L># $    $ ######## #</L>
      <L>#  ##.##*#  #  .$ #</L>
      <L>##$    *@*  ......#</L>
      <L>#  #   #*##$#######</L>
      <L># ######  #  .    #</L>
      <L>#    #    #$# # $ #</L>
      <L>#.$*$# #  #  .  $ #</L>
      <L># $..$ #.##.# # $ #</L>
      <L># .$.. #. #$$.  $ #</L>
      <L># #.$$ #.$#.# ### #</L>
      <L>#      #.        .#</L>
      <L>###################</L>
    </Level>
    <Level Id="Tableau 88" Width="19" Height="16">
      <L>#########   #######</L>
      <L>#.......#####   ..#</L>
      <L>#.  $$  $   $$  ..#</L>
      <L>#  ...#### ##  $.##</L>
      <L>##$####     #  #$#</L>
      <L> # #   $$$$ #  # #</L>
      <L> # $$  $@ $ #$## #</L>
      <L>## #  $###$    $ #</L>
      <L>#. #   ###  ###  #</L>
      <L>#. ##$$     $ #$ #</L>
      <L>#.$ # $   $   #  ##</L>
      <L>#.  #     #####$..#</L>
      <L>#.$ #####$#...# ..#</L>
      <L>#.$$      $ $$#$..#</L>
      <L>#...#######     ..#</L>
      <L>#####     #########</L>
    </Level>
    <Level Id="Tableau 89" Width="19" Height="16">
      <L>##################</L>
      <L>#           ##   ##</L>
      <L># $ $#$ $$  #    .#</L>
      <L># #$ $ ##  ##  #..#</L>
      <L># $ $$ #  ##   #..#</L>
      <L># #@ #   ##    #..#</L>
      <L># $ $$  ##    ##..#</L>
      <L># #$ $ ##    #  ..#</L>
      <L># $ $  #  #  #  . #</L>
      <L>#  $  #      # #..#</L>
      <L># $  #    ## # #..#</L>
      <L>#   #    ##  # #..#</L>
      <L># $#    #   ## ####</L>
      <L># $ $  ##. ...    #</L>
      <L>#     #     #     #</L>
      <L>###################</L>
    </Level>
    <Level Id="Tableau 90" Width="19" Height="16">
      <L>######   ##########</L>
      <L>#    #####        #</L>
      <L># ##$#  ## ####$$ #</L>
      <L>#       $   #    ##</L>
      <L># ## #  #   #  $###</L>
      <L># ## ##$######    #</L>
      <L># ## ##....$.##   #</L>
      <L># ##$##....$. # # #</L>
      <L># #   #....#$  $# #</L>
      <L># #   $....#  # # #</L>
      <L># ## #####$## # # #</L>
      <L># ## #####  # # # #</L>
      <L># ##     $@ $ # # #</L>
      <L># ##$#####  #$ $  #</L>
      <L>#    #   ####     #</L>
      <L>######      #######</L>
    </Level>
    <Level Id="Tableau 91" Width="19" Height="7">
      <L>###################</L>
      <L>#        #      # #</L>
      <L># $ $.**...**.$ $ #</L>
      <L># $$$.#.*@*.#.$$$ #</L>
      <L># $ $*.*...*.*$ $ #</L>
      <L># #      #        #</L>
      <L>###################</L>
    </Level>
    <Level Id="Tableau 92" Width="19" Height="16">
      <L>  #####  #########</L>
      <L> ##   ####       #</L>
      <L>##  $      $ $ *@#</L>
      <L>#  $############*##</L>
      <L># #     $ $    # .#</L>
      <L>#   # # $ ##   .*.#</L>
      <L>### #   #   #### .#</L>
      <L>#  $####  #    **.#</L>
      <L># #     $ ######  #</L>
      <L>#   ####  #     *.#</L>
      <L>###$#   #   #### .#</L>
      <L>#   # # $ ##  ..*.#</L>
      <L># #     $ $  ### .#</L>
      <L>#  $#########..**.#</L>
      <L>###            #  #</L>
      <L>  #################</L>
    </Level>
    <Level Id="Tableau 93" Width="19" Height="16">
      <L>################</L>
      <L>#  ..... #     #</L>
      <L>#  #$#  $# ### ####</L>
      <L>#         *.##$#  #</L>
      <L>##.#######  ..    #</L>
      <L>#        # .###   #</L>
      <L># # $  $$###### ###</L>
      <L># $ $  $    #  *  #</L>
      <L># $ $  $ $$ #. .# #</L>
      <L>## ###### $ ##.## #</L>
      <L># $###. #   @#.## #</L>
      <L>#   ..  ###### $  #</L>
      <L>###$##.*       ####</L>
      <L>  # ### #####   #</L>
      <L>  #     #   #   #</L>
      <L>  #######   #####</L>
    </Level>
    <Level Id="Tableau 95" Width="19" Height="16">
      <L>##################</L>
      <L>#          #     #</L>
      <L>#  $ $ $ $ $   $ #</L>
      <L>#  ## $ #$ ##### #</L>
      <L>#    $ #  #....# #</L>
      <L>#.# $ #  # .*  # #</L>
      <L>#  $ #  #..##$ # #</L>
      <L># $ #  # $*#   # #</L>
      <L>#$ #  #... $.$ # #</L>
      <L>#@#  #. ## $#  # #</L>
      <L>##  #...#. ..#$# #</L>
      <L>#. #..*    #.  # #</L>
      <L>#.#..#.#.#.#.#.# #</L>
      <L>#  $$$$$$$$$$$$$. #</L>
      <L>#                 #</L>
      <L>###################</L>
    </Level>
  </LevelCollection>
</SokobanLevels>
