<?xml version="1.0" encoding="utf-8"?>
<SokobanLevels xmlns:xsi="http://www.w3.org/2001/XMLSchema-instance" xsi:schemaLocation="SokobanLev.xsd">
  <Title>Cadushi</Title>
  <Description>
After some years a new set from Aruba. Cadushi means cactus.
Level 15 removed.
  </Description>
  <Email>serenata@setarnet.aw</Email>
  <LevelCollection Copyright="Eric F Tchong" MaxWidth="41" MaxHeight="31">
    <Level Id="cadushi 01" Width="20" Height="19" Copyright="A1master, Buddy Casamis, Kobus Theron, Bent Seegert, Tom Sirgedas, Alex Chernov, Lezhankin Petr, Eric F Tchong">
      <L> #############</L>
      <L> #    ##     #######</L>
      <L> # ## ## $## .     #</L>
      <L> # $ $#   ## # # $ #</L>
      <L>##      # ## # $  ##</L>
      <L># $ $      $  ### #</L>
      <L># $ #   #       $ #</L>
      <L># ### #$$ ## #### #</L>
      <L>#  $    # ## #### #</L>
      <L>#  # # $#$  $  $  #</L>
      <L>#...    # ##  ## ##</L>
      <L>#. .#      # ### ##</L>
      <L>#. ..+. ##     $  ##</L>
      <L>#   # #.####  #    #</L>
      <L>#. .# #.#  #### ## #</L>
      <L>#.#.#.###     # $  #</L>
      <L>##..  #       #$  ##</L>
      <L> ######       #   #</L>
      <L>              #####</L>
    </Level>
    <Level Id="cadushi 02" Width="15" Height="15" Copyright="Laura Wheeler, Eric F Tchong">
      <L>####### #######</L>
      <L>#     ###     #</L>
      <L># # $  $  $ # #</L>
      <L>#  # $   $ #  #</L>
      <L># $ #.#*#.# $ #</L>
      <L>#  $.#...#.$  #</L>
      <L>##  #. * .#  ##</L>
      <L> #$ ..***.$.$#</L>
      <L>## @#.$.$.#  ##</L>
      <L>#  $.#...#.$  #</L>
      <L># $ #.#.#.# $ #</L>
      <L>#  # $ $ $ #  #</L>
      <L># # $  $  $ # #</L>
      <L>#     ###     #</L>
      <L>####### #######</L>
    </Level>
    <Level Id="cadushi 03" Width="18" Height="14" Copyright="Laura Wheeler, Eric F Tchong">
      <L>  ###</L>
      <L>  #.#</L>
      <L> ## ####</L>
      <L> #  $@ #   ###</L>
      <L>## $.$ #####.##</L>
      <L>#.  $ $. .#.$.##</L>
      <L>###  $.$ $.$ $.##</L>
      <L>  ###.#.$.$ $ $.##</L>
      <L>    ####.$ $.$ $.#</L>
      <L>       ##.$ $ $.##</L>
      <L>        ##.$ $.##</L>
      <L>         ##.$.##</L>
      <L>          ##.##</L>
      <L>           ###</L>
    </Level>
    <Level Id="cadushi 04" Width="20" Height="17" Copyright="Laura Wheeler, Eric F Tchong">
      <L>  ########</L>
      <L> ##. + . ###</L>
      <L> #. .$#$* .##</L>
      <L> # * * * .#.##</L>
      <L> # $  . .$# .##</L>
      <L> ##$ $$* .$*$.##</L>
      <L>## $.   .$* *#.##</L>
      <L># $   $. * * # .##</L>
      <L>#   *$$$  . .$*$.##</L>
      <L>##$    $ .$.$* . .##</L>
      <L> # $$ $ * * . .$* .#</L>
      <L> #  $ $  * *$.$. *.#</L>
      <L> ##    $  . .$.$.###</L>
      <L>  #$$ $ $# #$. . #</L>
      <L>  #    $ $. .$.###</L>
      <L>  ####     .####</L>
      <L>     ########</L>
    </Level>
    <Level Id="cadushi 05" Width="17" Height="17" Copyright="Laura Wheeler, Eric F Tchong">
      <L>    #########</L>
      <L>   ##. $.  .##</L>
      <L>  ## $ $*  $ ##</L>
      <L> ##.$ * #$. $.##</L>
      <L>##  *  $# $$*  ##</L>
      <L>#.$# # $.$ . * .#</L>
      <L>#  *  . . # * $$#</L>
      <L>#  $         $$ #</L>
      <L>#.$.*#.#...##*..#</L>
      <L>#       #   $   #</L>
      <L># $.$$. # .  *  #</L>
      <L>##   *  * $*   .#</L>
      <L> # $*   * $ .$###</L>
      <L> ##. $* . . $.#</L>
      <L>  ###.$$  $  ##</L>
      <L>    #.  .@ ###</L>
      <L>    ########</L>
    </Level>
    <Level Id="cadushi 06" Width="18" Height="17" Copyright="Laura Wheeler, Eric F Tchong">
      <L>       ###</L>
      <L>      ##.#</L>
      <L>     ##..##</L>
      <L>    ##..*.##</L>
      <L>    #...+..#</L>
      <L>    #.. $..#</L>
      <L>    #..  ..#</L>
      <L>    ##.  .##</L>
      <L>     ##$ ##</L>
      <L>     #    #   ####</L>
      <L>     # $ $#   #  #</L>
      <L>###### $  #####$ #</L>
      <L>#     $ $  $ $   #</L>
      <L># $ $   $$     ###</L>
      <L>## $$$ $ $$$$ ##</L>
      <L> ###        ###</L>
      <L>   ##########</L>
    </Level>
    <Level Id="cadushi 07" Width="26" Height="15" Copyright="Laura Wheeler, Eric F Tchong">
      <L>#########################</L>
      <L>#   #           #    #  #</L>
      <L># $$#$$$$$$$$$$ # $$ # $#</L>
      <L>#   #  $  $  $  # $  #  ##</L>
      <L># $$# $  $  $.  ###  ##  #</L>
      <L>#         $              #</L>
      <L>###########   ############</L>
      <L>          # $ #</L>
      <L>###########   #####  #####</L>
      <L>#                 #  #...#</L>
      <L># $$$###  #$  ### #  #...#</L>
      <L>#    # $  #    ...####...#</L>
      <L># $$$# $$ #.. @*.........#</L>
      <L>#    #    #...##.........#</L>
      <L>##########################</L>
    </Level>
    <Level Id="cadushi 08" Width="29" Height="15" Copyright="Laura Wheeler, Eric F Tchong">
      <L>             #######</L>
      <L>             #     ##</L>
      <L>             # $$$$ ##</L>
      <L>             # $   $ ##</L>
      <L>####### ###### $    $ ######</L>
      <L>#     ###  ##  $$$$$ $   $ #</L>
      <L># $$$   $$  $$         $   #</L>
      <L># $ *##  $ $  $ $ $  $    $#</L>
      <L># $..##.    $    $ $.**.*  ##</L>
      <L># **....* $ $$ $ $ .*.....$ #</L>
      <L># *..#... $ $   $  **.#**.  #</L>
      <L>##.+*.*.###########....*..###</L>
      <L> ###**..#         ##..*..##</L>
      <L>   #...##          ##...##</L>
      <L>   #####            #####</L>
    </Level>
    <Level Id="cadushi 09" Width="31" Height="22" Copyright="Buddy Casamis, Bent Seegert, Tom Sirgedas, Alex Chernov, Lezhankin Petr, Zivojin Trifunovic, Eric F Tchong">
      <L>                 #### ####</L>
      <L>  ####     #### ##  ###  #</L>
      <L>###  #######  # #        ##</L>
      <L>#    @        ###   ###   #</L>
      <L>#   ########       ## #   #</L>
      <L>##  #      #       #  # # #</L>
      <L> #  #      # ##########   ####</L>
      <L> #$ #      #. ##. . . #  ##..##</L>
      <L> #  # #######.##. . . . . ....#</L>
      <L> #  # #   $   ####.####  ##   #</L>
      <L> #  # # #$$$  #  # ###    .####</L>
      <L> # $# #   $  ##  #     #####</L>
      <L> #  # ##   #  #### #####</L>
      <L> # $#  ##           #</L>
      <L> #  #   ###### $$$$ ##</L>
      <L> # $#        ###  $  #</L>
      <L> #  #          #  $  #</L>
      <L> # $###        # #$  #</L>
      <L> #  $ #        #    ##</L>
      <L> #    #        ######</L>
      <L> ##  ##</L>
      <L>  ####</L>
    </Level>
    <Level Id="cadushi 10" Width="30" Height="10" Copyright="Zivojin Trifunovic, Eric F Tchong">
      <L>####</L>
      <L>#  #              #######</L>
      <L># $################  #  ##</L>
      <L># $     #    #    # $$$  #</L>
      <L># $# ##*$.$. .$.$.$.$. +$#####</L>
      <L>#  $. * . #$# . * . # # . . .#</L>
      <L>#   $   $   ##$.###. . . #####</L>
      <L># $###########  # ########</L>
      <L>#  #         ####</L>
      <L>####</L>
    </Level>
    <Level Id="cadushi 11" Width="41" Height="26">
      <L>                                #####</L>
      <L>                            #####   #####</L>
      <L>                            #      $    #</L>
      <L>                            # $ $ $ $ $ #</L>
      <L>                            ## $ $ $ $  #</L>
      <L>                             ## $ $ $ $ #</L>
      <L>                              #$ $ $   ##</L>
      <L>                              # $ $  ###</L>
      <L>                      #########$ $  ##</L>
      <L>                      # $.# $   $  ##</L>
      <L>                      # $$         #</L>
      <L>                      #  ##       ##</L>
      <L>                      #           #</L>
      <L>                      #####      #####</L>
      <L>                         #   .    ...##</L>
      <L>        ########         #    #   ....#</L>
      <L>        #      ###########     #  ###.##</L>
      <L>        #$##$$   .$.$.$ ### #     .....#</L>
      <L>####    # ## ### $ $ $ $ ## .  #......##</L>
      <L>#  ######  # $ #  $ $ $ $ $ #..#..#.#.#</L>
      <L># $ .$  #.   $ # $ $ $ $ $  #..#......#</L>
      <L># $ $ #  # $  .#  $ $ $ $   #..#..#. .#</L>
      <L># $  $ #   #..#  $ $ $  @$   ........##</L>
      <L>#.* $ $######.# $ $ $      .##########</L>
      <L>#......#    #.#             #</L>
      <L>########    #################</L>
    </Level>
    <Level Id="cadushi 12" Width="26" Height="31">
      <L>#########################</L>
      <L>#.....#..#..#           ##</L>
      <L>#.$.$.#.*#..#$  $ $ $ $  #</L>
      <L>#......*.....$ $ $ $ $ $ #</L>
      <L>#.$.$.#*.#..#$  $ $ $ $  #</L>
      <L>#......*.#*.#  $ $ $ $ $ #</L>
      <L>###.#.#.*#..# $ $ $ $ ## #</L>
      <L>#..$$$ $ #*** #$ $ $ ### #</L>
      <L>#.*.  $  .$ # $ $ $ ## # #</L>
      <L>###.###  #     $ ####  # #</L>
      <L>#......$  # $ $ $ ##   # #</L>
      <L>#*.*.*.$$$$  $ $ $ ##  # #</L>
      <L>#.*.*..#    $ $ $ $ ## # #</L>
      <L>#..#..#. $ $ $ $ $ $ ### #</L>
      <L>#.*.*.# $ $ $ $ $ $ $    #</L>
      <L>#..*.##  $ $ $ $ $ $  ## #</L>
      <L>#.*..##   $ $ $ $ $      #</L>
      <L>#...###  $ $ $ $ $ $ #####</L>
      <L>#.### #   $ $ $ $ $$ #</L>
      <L>###   #    $ $ $     #</L>
      <L>      #     $ $    ###</L>
      <L> #### #           ##</L>
      <L> #  ###           #</L>
      <L> #   @            #</L>
      <L> # ####          ##</L>
      <L> #.#  ##..##.##  ######</L>
      <L> ###   ##......       #</L>
      <L>        ##... .# $ #  #</L>
      <L>         #....##  ##$##</L>
      <L>         #######     #</L>
      <L>               #######</L>
    </Level>
    <Level Id="cadushi 13" Width="27" Height="25" Copyright="York Shen, Findus, Eric F Tchong, François Marques">
      <L>########           ########</L>
      <L>#      #           #      #</L>
      <L># .$$#*#           #*#$$# #</L>
      <L># $. # #           # # .  #</L>
      <L># .$$#.#           #.#$ # #</L>
      <L># $*   #           #   .$ #</L>
      <L># #  # #           # #$ # #</L>
      <L># $.$# #           # # .$ #</L>
      <L># .  # #   #####   # # $. #</L>
      <L># $* # #  ##   ##  # # *$ #</L>
      <L>###  # ####  $@ #### #  ###</L>
      <L>  #.##   #  ***  #   ##*#</L>
      <L>  #...**.. $*..$ *.*....#</L>
      <L> ##*##$  # $..*  # $ ##.#</L>
      <L>##.$ # * ## $$  ## # #  ###</L>
      <L># $. #$.  ##   ##  # # *$ #</L>
      <L># .$ # .$. ##*## .$. #  . #</L>
      <L># $. # ##$ $ .  $ ## #$.$ #</L>
      <L># .$$# ##..# . .*.##$#  # #</L>
      <L># $. $ ###   .$   ##  $*$ #</L>
      <L># .$$#.# ###########.#  # #</L>
      <L># $. # #           # # .  #</L>
      <L># .$$#*#           #*#$$# #</L>
      <L>#      #           #      #</L>
      <L>########           ########</L>
    </Level>
    <Level Id="cadushi 14" Width="31" Height="20" Copyright="Buddy Casamis, Bent Seegert, Tom Sirgedas, Alex Chernov, Lezhankin Petr, Eric F Tchong">
      <L>   ###############</L>
      <L>####             ##</L>
      <L>#    $*#########  #  ##########</L>
      <L>#  ***         ## ####        #</L>
      <L># **     #####  #@     ###### #</L>
      <L># *  **###   ## # $#####    # #</L>
      <L># # *  ###*#  # # .#        # #</L>
      <L># # *  *   ## # # ##        # #</L>
      <L># #  * *  * # # # #         # #</L>
      <L># # #* * *  # # # #         # #</L>
      <L># # #      ** # # #    ###### #</L>
      <L># # #  #****  # # #  ###..$ # #</L>
      <L># # #***      # # ####   $  * #</L>
      <L># #  *     #### # ##    $*.## #</L>
      <L># ##  *##  #    *   ..*  *    #</L>
      <L># ###  .#### #### # $##*##$## #</L>
      <L>#   ##*      *    #           #</L>
      <L>###   **###### ################</L>
      <L>  ###          #</L>
      <L>    ############</L>
    </Level>
    <Level Id="cadushi 16" Width="18" Height="16" Copyright="A1master, Buddy Casamis, Bent Seegert, Tom Sirgedas, Alex Chernov, Lezhankin Petr, Eric F Tchong">
      <L>   #####</L>
      <L>  ##   ######</L>
      <L>  #  #   #  #</L>
      <L>  #$## $    #</L>
      <L> ##  ###$#$ #</L>
      <L> #.* #  @  ##</L>
      <L> #.. # #$###</L>
      <L>##..   . ##</L>
      <L>#  ## ##  ########</L>
      <L># .## ##    $.   #</L>
      <L>#     ## #    $$ #</L>
      <L>##### ## ######  #</L>
      <L>    #     #   ####</L>
      <L>    #   # #</L>
      <L>    ###   #</L>
      <L>      #####</L>
    </Level>
    <Level Id="cadushi 17" Width="41" Height="19" Copyright="Vipul Patel, Buddy Casamis, David Dahlem, Bent Seegert, Tom Sirgedas, Alex Chernov, Lezhankin Petr, Eric F Tchong">
      <L>##### ##### ##### ##### #####     #######</L>
      <L>#   ###   ###   ###   ###   #######.#...#</L>
      <L># $     $     $.    $     $     $   ....#</L>
      <L>#   ###  ## #  ############## #  ## #   #</L>
      <L>## #####$## ##$############## ## ## #####</L>
      <L> #   $                              ...#</L>
      <L>## ## ##$## ##$## ##$## ######## ## ####</L>
      <L>#  ## #   # ##  # ##  # #     #  ## ####</L>
      <L># $## # $   ##$   ##$   #     #     ...#</L>
      <L>#  ## ##### ##  # ##  # #     ##### ####</L>
      <L>##### ##### ##### ##### ########### ##</L>
      <L>    #                               .#</L>
      <L>    ############################### ##</L>
      <L>                               #### ##</L>
      <L>                               #   $.#</L>
      <L>                               # #####</L>
      <L>                             ### #</L>
      <L>                             #@  #</L>
      <L>                             #####</L>
    </Level>
    <Level Id="cadushi 18" Width="19" Height="16">
      <L>     ####</L>
      <L>    ##  ### #######</L>
      <L>    #  *  # #  *  #</L>
      <L>    # .$* ### # # #</L>
      <L>##### * * ##  * # #</L>
      <L>#   * .$* * * * # #</L>
      <L># .*$# # ## ## *# #</L>
      <L>#    #   ##  #  $ #</L>
      <L># ** #$. ##  #* . #</L>
      <L># * * * . **  * # #</L>
      <L># **  *.*$# # # # #</L>
      <L># * # * . *  **   #</L>
      <L># **  * *$*   #####</L>
      <L>#  ## $  #    #</L>
      <L>#####@  ###   #</L>
      <L>    ##### #####</L>
    </Level>
    <Level Id="cadushi 19" Width="19" Height="15" Copyright="Marcus Palstra, GrigoRusha, York Shen, Buddy Casamis, Eric F Tchong">
      <L>      ######  ####</L>
      <L>#######    ####  #</L>
      <L>#  $  $.# $ . .* #</L>
      <L># # $.. ##* $  . #</L>
      <L>#  $#.#$##. ####$#</L>
      <L>###    .##. ##   #</L>
      <L>  #$ *#$##.  . #*#</L>
      <L>  #   # ## $ #$  #</L>
      <L>  #$.# * *.#   #$#</L>
      <L>  #    #...#*#   #</L>
      <L>###   ###*# $+ #$##</L>
      <L>#   #  .... . $#  #</L>
      <L># #$$ $ $ $ $     #</L>
      <L>#   ###############</L>
      <L>#####</L>
    </Level>
    <Level Id="cadushi 20" Width="19" Height="13" Copyright="A1master, Buddy Casamis, Bent Seegert, Tom Sirgedas, Alex Chernov, Lezhankin Petr, Premysl Zika, Eric F Tchong">
      <L>############  ####</L>
      <L>#   ##@    ####  #</L>
      <L>#      $ $ $ $ . #</L>
      <L>## #$$ ### . ##$ #</L>
      <L> # # $#####*##  ##</L>
      <L> #    ##  *.*..$#</L>
      <L>## ##*##. *.*#  #</L>
      <L>#  #.*.$ * $.## ##</L>
      <L>#  #.....      . #</L>
      <L># .#########*###$##</L>
      <L># $   $ $ $  $ .$ #</L>
      <L>#  ##       #     #</L>
      <L>###################</L>
    </Level>
    <Level Id="cadushi 21" Width="19" Height="13" Copyright="A1master, Vipul Patel, Buddy Casamis, David Dahlem, Frantisek Pokorny, Draku, Bent Seegert, Tom Sirgedas, Alex Chernov, Serg Belyaev, Lezhankin Petr, Wes Sampson, Werner Ettinger, Eric F Tchong">
      <L>############  ####</L>
      <L>#   ##     ####  #</L>
      <L># .$   $ $ .     #</L>
      <L>## ############$ #</L>
      <L> # ####    #### ##</L>
      <L> #    #    #.## #</L>
      <L>## ##$##   #.## #</L>
      <L># $#  .##### ## ##</L>
      <L>#  #.       .  * #</L>
      <L>#@$######### ### ##</L>
      <L># .   * * *  $ .$ #</L>
      <L>#  ##       #     #</L>
      <L>###################</L>
    </Level>
    <Level Id="cadushi 22" Width="27" Height="27">
      <L>      ###############</L>
      <L>     ##        #    #</L>
      <L>  ####  .## ## . ## #####</L>
      <L>  #     ###  #   $      #</L>
      <L>### ### #### ## ###.### #</L>
      <L>#    *   $   #   $  ##  #</L>
      <L># ##### #### #.$###*## ##</L>
      <L>#  . *   *   #   $  ##  #</L>
      <L>#### ### #* ## $.##.##$.#</L>
      <L>   # # @ #  ## $ # . $  #</L>
      <L>   # # ###* ##** # *## *#</L>
      <L>   # *   *   $     . $  #</L>
      <L>   #*## ##* .#*.###*$#* #</L>
      <L>   # ##  #   $   $ . #  #</L>
      <L>   #.### #*.*#.*##$.$#*$#</L>
      <L>   ####  $   $ . $ .    #</L>
      <L>      # ##.$.#$.##.**#* ###</L>
      <L>      #  * $ #   . . $  $ #</L>
      <L>      #.##* *# *##$.*# ## #</L>
      <L>      ###.$$$.   $ . $.#  #</L>
      <L>        ##. *#$* #$* #.  ##</L>
      <L>         # $ $ . * . $  ##</L>
      <L>         #*. # *##*. ####</L>
      <L>         # $$. $    ##</L>
      <L>         #  ###. ####</L>
      <L>         ##     ##</L>
      <L>          #######</L>
    </Level>
    <Level Id="cadushi 23" Width="27" Height="18" Copyright="A1master, Buddy Casamis, Bent Seegert, Tom Sirgedas, Alex Chernov, Lezhankin Petr, Eric F Tchong">
      <L>           #######</L>
      <L>           #     #</L>
      <L>           # ###@#</L>
      <L>           # # # #######</L>
      <L>          ## ###   #   ####</L>
      <L>          #..##  $   $    #</L>
      <L>   ########.$   #$###$##$ #</L>
      <L>####.......  # ## ##   #  #</L>
      <L>#    ######.##    $  $ #$ #</L>
      <L># ####    ####$#  ## ### ##</L>
      <L># #       #### ## ## ### #</L>
      <L># #########          ##  #</L>
      <L>#        ## # ###  #### ##</L>
      <L>######## ## # # ####  #  #</L>
      <L>       # ##$#*########## #</L>
      <L>       #   * $.          #</L>
      <L>       ###      ##########</L>
      <L>         ########</L>
    </Level>
    <Level Id="cadushi 24" Width="9" Height="15" Copyright="Frantisek Pokorny, Eric F Tchong">
      <L>   ####</L>
      <L>####  #</L>
      <L>#  $ $#</L>
      <L># $...#</L>
      <L>#.+*  #</L>
      <L>#  *$ #</L>
      <L>#$ *  #</L>
      <L>#  ####</L>
      <L>##  ####</L>
      <L>###  . #</L>
      <L># *.$$$#</L>
      <L># $  * ##</L>
      <L># .* $. #</L>
      <L># $..   #</L>
      <L>#########</L>
    </Level>
    <Level Id="cadushi 25" Width="30" Height="31" Copyright="Buddy Casamis, Bent Seegert, Tom Sirgedas, Alex Chernov, Lezhankin Petr, Eric F Tchong">
      <L>######</L>
      <L>#    #</L>
      <L># #  #</L>
      <L># #  #</L>
      <L># #  #</L>
      <L># #  ######</L>
      <L># #     @ ##</L>
      <L># #$#$ ##  ##</L>
      <L># #         #</L>
      <L># #$#$$$#   ###</L>
      <L># #           ###</L>
      <L># # #$$$$$  #  .##</L>
      <L># #             .##</L>
      <L># # $$$$$$  #    .##</L>
      <L># #               .##</L>
      <L># # $$$$$$$ #####  .##</L>
      <L># #                 .#</L>
      <L># # $$$$$$$ #        ##</L>
      <L># #               . . #</L>
      <L># # $$$$$$  ##    #.  ###</L>
      <L># #  .      ##    . .   #</L>
      <L># #  #     .## . .### # ###</L>
      <L># #         ##  . # #     ##</L>
      <L># #  #      ## . .#####    #</L>
      <L># #         . .            ##</L>
      <L># # ######   .    ####     .#</L>
      <L># #         . .           .##</L>
      <L># # #####  .   . .#####.#. #</L>
      <L>#  $            .       .  ###</L>
      <L>#########  .   . .     .#.  .#</L>
      <L>        ######################</L>
    </Level>
    <Level Id="cadushi 26" Width="35" Height="31" Copyright="Buddy Casamis, Bent Seegert, Tom Sirgedas, Alex Chernov, Lezhankin Petr, Eric F Tchong">
      <L>######</L>
      <L>#    #</L>
      <L># #  #</L>
      <L># #  #</L>
      <L># #  #</L>
      <L># #  #############################</L>
      <L># #     @ ######                 #</L>
      <L># #$#$ ##  ##... $               #</L>
      <L># #         #... $$  $$$$$   $   #</L>
      <L># #$#$$$#   ###.  $$$    $$  $   #</L>
      <L># #           ###.       $   $   #</L>
      <L># # #$$$$$  #  .##..  $  $$  $$  #</L>
      <L># #             .##.  $   $$  $  #</L>
      <L># # $$$$$$  #    .#.  $$   $  $  #</L>
      <L># #               ..#.     $  $  #</L>
      <L># # $$$$$$$ #####  .###...  $ $$ #</L>
      <L># #                 .#####  $    #</L>
      <L># # $$$$$$$ #        #######$    #</L>
      <L># #               . . ####. $    #</L>
      <L># # $$$$$$  ##    #.  ####. $$   #</L>
      <L># #  .      ##    . .   ##.  $   #</L>
      <L># #  #     .## . .### # ###.. $  #</L>
      <L># #         ##  . # #     #.. $  #</L>
      <L># #  #      ## . .#####    #. $  #</L>
      <L># #         . .            ##....#</L>
      <L># # ######   .    ####     .#....##</L>
      <L># #         . .           .##.....#</L>
      <L># # #####  .   . .#####.#. #......#</L>
      <L>#  $            .       .  ########</L>
      <L>#########  .   . .     .#.  .#</L>
      <L>        ######################</L>
    </Level>
    <Level Id="cadushi 27" Width="32" Height="9" Copyright="A1master, Buddy Casamis, Bent Seegert, Tom Sirgedas, Alex Chernov, Lezhankin Petr, Eric F Tchong">
      <L>  ######### #### ############</L>
      <L>  #  #    # #  # #  #    #  ##</L>
      <L>###  #  # ###  ###  $*#$ *  .#</L>
      <L>#  $.* *  *  * *  * #  * .. ####</L>
      <L>#  $ $*   *  * *##  . $* * .##@#</L>
      <L>##.* * *  *  * *  * *..* #$$#  #</L>
      <L> ##  # ## ###  ###  #$$# #  . ##</L>
      <L>  #  #    # #  # #       ######</L>
      <L>  ######### #### #########</L>
    </Level>
    <Level Id="cadushi 28" Width="18" Height="21" Copyright="Zivojin Trifunovic, Gucevo, Eric F Tchong">
      <L>  ################</L>
      <L>  # @            #</L>
      <L>  # #$ ### # .$. #</L>
      <L>  #*   # # # .$. #</L>
      <L>  # #### # # $*$ #</L>
      <L>  # #    # # .$. #</L>
      <L>  #.#    # # $#$ #</L>
      <L>  ###    # #  $. #</L>
      <L>         # ##.####</L>
      <L>         # ######</L>
      <L>##########      #</L>
      <L>#          ####.##</L>
      <L># $.$$$$ ###  .  #</L>
      <L># $..... # # $$$.#</L>
      <L># $$$$$$ # #  .  #</L>
      <L># .....$.# #.$#$ #</L>
      <L># $$$$.$.# # .$. #</L>
      <L># .. $.$.# # $$$ #</L>
      <L>#  ..$$$ # # .$. #</L>
      <L>####...  # #  .  #</L>
      <L>   ####### #######</L>
    </Level>
    <Level Id="cadushi 29" Width="26" Height="19">
      <L>############    ########</L>
      <L>#       ...######..*...#</L>
      <L># $    #...*...........#</L>
      <L>#####$ #.*..****###..###</L>
      <L>    # ######$ * .## $#####</L>
      <L> #### ##   #  #* ##  #   #</L>
      <L> #.$  ## $    #.*.*      #</L>
      <L> ### ### $$##$##.$*$##$$ #</L>
      <L>#### ###   #  #   #  # $ #</L>
      <L>#.  $ ## $$#  #  .#  #   #</L>
      <L>##### ## $ #  # # #  #$$ #</L>
      <L>  ### ##   #### $ ####   #</L>
      <L>  #.# ## $$#  # # *  #$$ #</L>
      <L> ##$# ##   #  # $ #  #   #</L>
      <L> #@   ### $## #$$$#  #$ ##</L>
      <L> # $.## # $ ###   #$#    #</L>
      <L> #####  # $ ## .#.    $$ #</L>
      <L>        #     .* .* $ $  #</L>
      <L>        ##################</L>
    </Level>
    <Level Id="cadushi 30" Width="27" Height="19">
      <L>     #################</L>
      <L> #####   #   .   #   #####</L>
      <L> #     $. .$*$+ . .$$    #</L>
      <L> # $## #$# # .$*$# # #$$$#</L>
      <L> #  * . .$*$.$. .$. .$.  #</L>
      <L>## #$# ### # * ###$# # # ##</L>
      <L>#  $.#.# #.## .$...$. .$  #</L>
      <L># $# ########.######*# #$ #</L>
      <L># . .### $ $ .$  $ #. *$. #</L>
      <L>## # #. $  $...$  $ *# # ##</L>
      <L># .$*### $   .  $  #. * . #</L>
      <L># $# #.######*######.# #$ #</L>
      <L>#   * *#.#. .$.#.#. * $#  #</L>
      <L>## #$# # ### # # ### # # ##</L>
      <L> #  . * * * * * * * * *  #</L>
      <L> #$$ #$# #$# #$# #$# ##$ #</L>
      <L> #     $. .$. .$. .$     #</L>
      <L> #####   #   #   #   #####</L>
      <L>     #################</L>
    </Level>
    <Level Id="cadushi 31" Width="19" Height="19" Copyright="Marko Dzekic, Eric F Tchong">
      <L>  ####</L>
      <L>  #  #</L>
      <L>  #$ ####</L>
      <L>  #     #      ###</L>
      <L>###$ #$ ########.##</L>
      <L>#  $ #  ......... #</L>
      <L># .  # ####### #. #</L>
      <L># .. # # $ $ $  .##</L>
      <L>##$### #       $.#</L>
      <L>#    #.#  $$$$$#.#</L>
      <L>#   $# @  $     .#</L>
      <L>#  . ###     #####</L>
      <L>## $ # #  $* $ #</L>
      <L> #$$$# # $# .  #</L>
      <L> #.$.# #   .$$ #</L>
      <L> # . # #$     ##</L>
      <L> #...# #   $$ #</L>
      <L> ##.## ####   #</L>
      <L>  ###     #####</L>
    </Level>
    <Level Id="cadushi 32" Width="17" Height="15" Copyright="A1master, Buddy Casamis, Bent Seegert, Tom Sirgedas, Alex Chernov, Lezhankin Petr, Eric F Tchong">
      <L>#########   #####</L>
      <L>#       #####   #</L>
      <L># # *.+.     .# #</L>
      <L># ##$.  #####   #</L>
      <L>#  $ .####  # ###</L>
      <L>#  ##    ## # #</L>
      <L># $## # $.# # #</L>
      <L>#  ## # ##### #</L>
      <L>##### $$ .. # #</L>
      <L>    # #  ## # ##</L>
      <L>   ## #  #.  * #</L>
      <L>   # $##### ## ##</L>
      <L>   #    $ $  $  #</L>
      <L>   #  #   ###   #</L>
      <L>   ######## #####</L>
    </Level>
    <Level Id="cadushi 33" Width="25" Height="16" Copyright="Buddy Casamis, Bent Seegert, Tom Sirgedas, Alex Chernov, Lezhankin Petr, Eric F Tchong">
      <L>      ######</L>
      <L>#######    ######   #####</L>
      <L>#   ##  ##  . $ #####   #</L>
      <L>#   $. #### $ $      *# #</L>
      <L>## #.$  #  #$.. ##.## @ #</L>
      <L> # # ## #   $ ## **$. ###</L>
      <L> # # $  # $## $  *. # #</L>
      <L> # # ##### ## # #$. # #</L>
      <L> # # ##  # ##.# #.# # #</L>
      <L>## #  #  # ## $ . $ # #</L>
      <L># $##*####.## #.$*# # ##</L>
      <L>#    .##  .## #  ..  . #</L>
      <L>#  #*....* # $#####$##$##</L>
      <L># # $$*$$$ # .  *   $ . #</L>
      <L>#     .  $ #  #   ###   #</L>
      <L>################### #####</L>
    </Level>
    <Level Id="cadushi 34" Width="20" Height="8" Copyright="A1master, Buddy Casamis, Bent Seegert, Tom Sirgedas, Alex Chernov, Lezhankin Petr, Eric F Tchong">
      <L> ##### #### ########</L>
      <L>## . # #  ###  #   #</L>
      <L>#.$.$###$  +   # $ #</L>
      <L>#.*.... $  #$ $$ ###</L>
      <L># #.*####  #     ###</L>
      <L>#    #  #######$ $ #</L>
      <L>###  #        #    #</L>
      <L>  ####        ######</L>
    </Level>
    <Level Id="cadushi 35" Width="14" Height="12" Copyright="Milutin Negovanovic, Eric F Tchong">
      <L> #####   #####</L>
      <L>##   ##### @ #</L>
      <L># .$   .   $.#</L>
      <L># $.$$$.$$$. #</L>
      <L>##  . $.$ . ##</L>
      <L> ## $.$.$. ##</L>
      <L>  ##$....$$##</L>
      <L>   # .$# .$ ##</L>
      <L>   #.  #  .$ #</L>
      <L>   # $$#   . #</L>
      <L>   #   .   ###</L>
      <L>   #########</L>
    </Level>
  </LevelCollection>
</SokobanLevels>
