<?xml version="1.0" encoding="utf-8"?>
<SokobanLevels xmlns:xsi="http://www.w3.org/2001/XMLSchema-instance" xsi:schemaLocation="SokobanLev.xsd">
  <Title>Chrysalis Collection 3</Title>
  <Description>
The 3rd collection of 50 puzzles taken from my creations in the
members section of letslogic.com - roughly in order of publish date.
  </Description>
  <Email>david@chrysalis.co.za</Email>
  <Url>http://www.letslogic.com</Url>
  <LevelCollection Copyright="David Buchweitz" MaxWidth="28" MaxHeight="33">
    <Level Id="Near Symmetry" Width="13" Height="13">
      <L>#####  ######</L>
      <L>#   ####    #</L>
      <L># #  . .$## #</L>
      <L>#  # #$# #  #</L>
      <L># $  #     ##</L>
      <L>##.# # ###.#</L>
      <L> # $ #@# $ #</L>
      <L> #.##### #.##</L>
      <L>##     #  $ #</L>
      <L>#  # #$# #  #</L>
      <L># ##$. .  # #</L>
      <L>#    ####   #</L>
      <L>######  #####</L>
    </Level>
    <Level Id="The Ring" Width="10" Height="10">
      <L>##########</L>
      <L>#  #     #</L>
      <L># $# $ $ #</L>
      <L>#  #..####</L>
      <L># $.@ .  #</L>
      <L>#  .  .$ #</L>
      <L>####..#  #</L>
      <L># $ $ #$ #</L>
      <L>#     #  #</L>
      <L>##########</L>
    </Level>
    <Level Id="Foursome" Width="10" Height="10">
      <L>#########</L>
      <L>#       #</L>
      <L># $ $ $ #</L>
      <L># ##### #</L>
      <L># ....# ##</L>
      <L>###      #</L>
      <L>  #  #$# #</L>
      <L>  #  #   #</L>
      <L>  # @#####</L>
      <L>  ####</L>
    </Level>
    <Level Id="Foursome+1" Width="10" Height="10">
      <L>#########</L>
      <L>#       #</L>
      <L># $ $ $ #</L>
      <L># ##### #</L>
      <L>#.....# ##</L>
      <L>###   $  #</L>
      <L>  #  #$# #</L>
      <L>  #  #   #</L>
      <L>  # @#####</L>
      <L>  ####</L>
    </Level>
    <Level Id="Space Invaders" Width="10" Height="10">
      <L> #######</L>
      <L>##     #</L>
      <L>#  #$ $###</L>
      <L>#..@$$$  #</L>
      <L># .#  #..#</L>
      <L>#..#  #. #</L>
      <L>#  $$$ ..#</L>
      <L>###$ $#  #</L>
      <L>  #     ##</L>
      <L>  #######</L>
    </Level>
    <Level Id="Touching Sides" Width="11" Height="11">
      <L>##########</L>
      <L>#   #    #</L>
      <L>#     ## #</L>
      <L>## #   # #</L>
      <L> # # # # #</L>
      <L> #$#.@.#$#</L>
      <L> # # # # #</L>
      <L> # #   # ##</L>
      <L> # ##     #</L>
      <L> #    #   #</L>
      <L> ##########</L>
    </Level>
    <Level Id="Auto-Solver Curse" Width="11" Height="11">
      <L>    #####</L>
      <L> ####   #</L>
      <L> #....$ #</L>
      <L> #*#$.$ #</L>
      <L>##.$ .$ ###</L>
      <L># ....$ $.#</L>
      <L># $$$$$$$.#</L>
      <L># $ @ $...#</L>
      <L>##### $.###</L>
      <L>    # $.#</L>
      <L>    #####</L>
    </Level>
    <Level Id="Easier than it looks" Width="11" Height="11">
      <L>     #####</L>
      <L>   ###   #</L>
      <L>   #.$$. #</L>
      <L>#### # #.##</L>
      <L>#  $ # .  #</L>
      <L># #$ @ $# #</L>
      <L>#  . # $  #</L>
      <L>##.# # ####</L>
      <L> # .$$.#</L>
      <L> #   ###</L>
      <L> #####</L>
    </Level>
    <Level Id="Scarface" Width="10" Height="10">
      <L>  #######</L>
      <L>  #     #</L>
      <L>###$#$# #</L>
      <L>#   .   ##</L>
      <L># ##.#   #</L>
      <L># $ .# # #</L>
      <L># # .$@$ #</L>
      <L># $ .#####</L>
      <L>####.#</L>
      <L>   ###</L>
    </Level>
    <Level Id="Tunnels" Width="28" Height="28">
      <L>##### ##### #### ##### #####</L>
      <L>#   ###   # #..# #   ###   #</L>
      <L>#   $ $   # #..# #   $ $   #</L>
      <L>##  # #   # #..# #   # #  ##</L>
      <L> #$## ##$####..####$## ##$#</L>
      <L> #   @                    #</L>
      <L> #$## ##$####  ####$## ##$#</L>
      <L>##  # #   # # ## #   # #  ##</L>
      <L>#   $ $   # # #  #   $ $   #</L>
      <L>#   # #   # # #  #   # #   #</L>
      <L>##### ##### # #  ##### #####</L>
      <L>    # #     # #      # #</L>
      <L>##### ##    # ######## #####</L>
      <L>#....  ######          ....#</L>
      <L>#....          ######  ....#</L>
      <L>##### ######## #    ## #####</L>
      <L>    # #      # #     # #</L>
      <L>##### #####  # # ##### #####</L>
      <L>#   # #   #  # # #   # #   #</L>
      <L>#   $ $   #  # # #   $ $   #</L>
      <L>##  # #   # ## # #   # #  ##</L>
      <L> #$## ##$####  ####$## ##$#</L>
      <L> #                        #</L>
      <L> #$## ##$####..####$## ##$#</L>
      <L>##  # #   # #..# #   # #  ##</L>
      <L>#   $ $   # #..# #   $ $   #</L>
      <L>#   ###   # #..# #   ###   #</L>
      <L>##### ##### #### ##### #####</L>
    </Level>
    <Level Id="Spade" Width="11" Height="33">
      <L>###########</L>
      <L>#.#.#.#.#.#</L>
      <L>#...$.$...#</L>
      <L>#.# #.# #.#</L>
      <L># $ $ $ $ #</L>
      <L># # # # # #</L>
      <L># $ $ $ $ #</L>
      <L>##$     $##</L>
      <L># $ $ $ $ #</L>
      <L># ### ### #</L>
      <L>#         #</L>
      <L>####   ####</L>
      <L>   ## ##</L>
      <L>    # #</L>
      <L>    # #</L>
      <L>    # #</L>
      <L>    # #</L>
      <L>    # #</L>
      <L>    # #</L>
      <L>    # #</L>
      <L>    # #</L>
      <L>    # #</L>
      <L>    # #</L>
      <L>    # #</L>
      <L>    # #</L>
      <L>    # #</L>
      <L>    # #</L>
      <L>    # #</L>
      <L>    # #</L>
      <L>   ## ##</L>
      <L>   # * #</L>
      <L>   # + #</L>
      <L>   #####</L>
    </Level>
    <Level Id="Tricky Zig Zag" Width="10" Height="10">
      <L>#########</L>
      <L>#       #</L>
      <L># $ $@$ #</L>
      <L># ##### #</L>
      <L># . . . ##</L>
      <L>## . . . #</L>
      <L> # ##### #</L>
      <L> # $ $ $ #</L>
      <L> #       #</L>
      <L> #########</L>
    </Level>
    <Level Id="Peace" Width="13" Height="12">
      <L>      ####</L>
      <L>   ####  #</L>
      <L>   #  #  #</L>
      <L>   #  #  ###</L>
      <L>   #  ## #  #</L>
      <L>   ## #  $$ #</L>
      <L>####  $$ *  #</L>
      <L>#  $$ * #. ##</L>
      <L>#  * #. @.##</L>
      <L># #.  .####</L>
      <L>#  .####</L>
      <L>#####</L>
    </Level>
    <Level Id="Camera" Width="10" Height="16">
      <L>  ########</L>
      <L>###. $   #</L>
      <L># $.$### #</L>
      <L># #. $ # #</L>
      <L># #.$# # #</L>
      <L># .. $ # #</L>
      <L>###.$# # #</L>
      <L>  #. $ @ #</L>
      <L>  ########</L>
      <L>    #   #</L>
      <L>   ##   #</L>
      <L>   #    #</L>
      <L>  ##    #</L>
      <L>  #     #</L>
      <L> ##     #</L>
      <L> #      #</L>
    </Level>
    <Level Id="Center Pattern" Width="11" Height="11">
      <L>   ########</L>
      <L>  ##      #</L>
      <L>###  #### #</L>
      <L>#  $.$.$  #</L>
      <L># #.$.$.# #</L>
      <L>#  $.@.$  #</L>
      <L>###.$.$.# #</L>
      <L> # $.$.$# #</L>
      <L> # # ##   #</L>
      <L> #      ###</L>
      <L> ########</L>
    </Level>
    <Level Id="Something Else" Width="11" Height="11">
      <L>  #######</L>
      <L>###  #  ###</L>
      <L># .$.$.$. #</L>
      <L># $.   .$ #</L>
      <L># $ . . $ #</L>
      <L>##.#$@$#.##</L>
      <L># $ . . $ #</L>
      <L># . $ $ . #</L>
      <L># $.$#$.$##</L>
      <L>###  .   #</L>
      <L>  ########</L>
    </Level>
    <Level Id="Tee" Width="11" Height="14">
      <L>###########</L>
      <L>#    @    #</L>
      <L>#$$$$$$$$$#</L>
      <L>#.#.#.#.#.#</L>
      <L>#.........#</L>
      <L>## $   $ ##</L>
      <L> ### $ ###</L>
      <L>   # # #</L>
      <L>   # $ #</L>
      <L>   # # #</L>
      <L>   # $ #</L>
      <L>   # # #</L>
      <L>   #   #</L>
      <L>   #####</L>
    </Level>
    <Level Id="Easy Does It" Width="8" Height="10">
      <L>  ####</L>
      <L>  # @###</L>
      <L>###.$  #</L>
      <L># $ .# #</L>
      <L># . $# #</L>
      <L># #$ . #</L>
      <L># #. $ #</L>
      <L>#  $.###</L>
      <L>###  #</L>
      <L>  ####</L>
    </Level>
    <Level Id="Woof Woof" Width="16" Height="16">
      <L>     #####</L>
      <L>     #   # ####</L>
      <L>     # $ ###  #</L>
      <L>     ### #   $#</L>
      <L>       # # $  #</L>
      <L>       # ####.##</L>
      <L>      ## @ ....#</L>
      <L>      #....   ##</L>
      <L>#     ##.## #$#</L>
      <L>##     #    # #</L>
      <L> ## ####$ $ # #</L>
      <L>  ### $   ### #</L>
      <L>    #  ## # $ ##</L>
      <L>    ## $  $    #</L>
      <L>     #   ###   #</L>
      <L>     ##### #####</L>
    </Level>
    <Level Id="That Tetris piece again..." Width="12" Height="12">
      <L>    ####</L>
      <L>  ###  ###</L>
      <L> ##  . $ ##</L>
      <L>## $#. #  #</L>
      <L>#   #*##$ #</L>
      <L>#  $ ..#  ##</L>
      <L>##  #.. $  #</L>
      <L> # $##*@   #</L>
      <L> #  # .#$ ##</L>
      <L> ## $ .  ##</L>
      <L>  ###  ###</L>
      <L>    ####</L>
    </Level>
    <Level Id="Ess" Width="11" Height="11">
      <L>   ########</L>
      <L>####   #  #</L>
      <L>#    ..#$ #</L>
      <L># $##.    #</L>
      <L>#   #.$ $ #</L>
      <L>### #@# ###</L>
      <L># $ $.#   #</L>
      <L>#    .##$ #</L>
      <L># $#..    #</L>
      <L>#  #   ####</L>
      <L>########</L>
    </Level>
    <Level Id="Runaround" Width="11" Height="11">
      <L>  #########</L>
      <L>  #       #</L>
      <L>### ##### #</L>
      <L># $ $ $ # #</L>
      <L># #.#.#.# #</L>
      <L># #.#.#.# #</L>
      <L># $ $ $ # #</L>
      <L># #     @ #</L>
      <L># ####### #</L>
      <L>#         #</L>
      <L>###########</L>
    </Level>
    <Level Id="Corners" Width="11" Height="11">
      <L>###########</L>
      <L>#...$ $...#</L>
      <L>#..$ $ $..#</L>
      <L>#.$  #  $.#</L>
      <L>#$  $ $  $#</L>
      <L># $# @ #$ #</L>
      <L>#$  $ $  $#</L>
      <L>#.$  #  $.#</L>
      <L>#..$ $ $..#</L>
      <L>#...$ $...#</L>
      <L>###########</L>
    </Level>
    <Level Id="Center Six" Width="11" Height="15">
      <L> ######</L>
      <L> #    #</L>
      <L>##.## #####</L>
      <L># $   #   #</L>
      <L># .#      #</L>
      <L># $#*#*#$ #</L>
      <L># .#   #. #</L>
      <L># $#*@*#$ #</L>
      <L># .#   #. #</L>
      <L># $#*#*#$ #</L>
      <L>#      #. #</L>
      <L>#   #   $ #</L>
      <L>##### ##.##</L>
      <L>    #    #</L>
      <L>    ######</L>
    </Level>
    <Level Id="Stilts" Width="10" Height="9">
      <L>####</L>
      <L>#  #</L>
      <L>#  #######</L>
      <L>#....+...#</L>
      <L>#$$$$$$$$#</L>
      <L>#  #  #  #</L>
      <L>#  #  #  #</L>
      <L>#  #  #  #</L>
      <L>##########</L>
    </Level>
    <Level Id="Top Down" Width="9" Height="9">
      <L>########</L>
      <L>#      #</L>
      <L># $$ $ ##</L>
      <L># #  #. #</L>
      <L># $  $* #</L>
      <L># # @ .##</L>
      <L>#$$ #$*#</L>
      <L>#......#</L>
      <L>########</L>
    </Level>
    <Level Id="Traffic Jam" Width="10" Height="15">
      <L>####</L>
      <L>#  ###</L>
      <L>#. $ #####</L>
      <L># #   #  #</L>
      <L>#.#$#.#$ #</L>
      <L>#   #    #</L>
      <L>#.#$#.#$ #</L>
      <L># # @ #  #</L>
      <L>#.#$#.#$ #</L>
      <L>#   #    #</L>
      <L>#.#$#.#$ #</L>
      <L>###   #  #</L>
      <L>  #  . $ #</L>
      <L>  ##  ####</L>
      <L>   ####</L>
    </Level>
    <Level Id="Rubber Ducky" Width="9" Height="10">
      <L>  ####</L>
      <L>### .#</L>
      <L># $ $#</L>
      <L>#.  .####</L>
      <L>###.    #</L>
      <L>  #$ $$ #</L>
      <L>  # .#@ #</L>
      <L>  #######</L>
      <L>    #  #</L>
      <L>   ## ##</L>
    </Level>
    <Level Id="Another Sunday Drive" Width="12" Height="7">
      <L>############</L>
      <L>#     #    #</L>
      <L># ###    # #</L>
      <L>#...***$$$@#</L>
      <L>##    #  ###</L>
      <L> ####    #</L>
      <L>    ######</L>
    </Level>
    <Level Id="More Steps" Width="12" Height="11">
      <L>      ####</L>
      <L>    ###..#</L>
      <L>  ###..  ###</L>
      <L>###.. $    #</L>
      <L>#.. $ # # @#</L>
      <L># # # $ # ##</L>
      <L># # $ # # #</L>
      <L># $ $ # # #</L>
      <L>##### $ $ #</L>
      <L>    ####  #</L>
      <L>       ####</L>
    </Level>
    <Level Id="Seashell" Width="9" Height="9">
      <L>  ######</L>
      <L>### . .##</L>
      <L>#   $#$ #</L>
      <L># # .$. #</L>
      <L># @ $#$ #</L>
      <L>### .$. #</L>
      <L> #  $#$ #</L>
      <L> #  . . #</L>
      <L> ########</L>
    </Level>
    <Level Id="No idea" Width="11" Height="9">
      <L> ##########</L>
      <L> #   .    #</L>
      <L>##$$...$$ #</L>
      <L>#   #.##  #</L>
      <L># $$.@.$$ #</L>
      <L>#  ##.#   #</L>
      <L># $$...$$##</L>
      <L>#    .   #</L>
      <L>##########</L>
    </Level>
    <Level Id="Vines" Width="11" Height="11">
      <L>       ####</L>
      <L>########@ #</L>
      <L># $    .$ #</L>
      <L># $.###.$ #</L>
      <L># $.#*#.$ #</L>
      <L># $.#*#.$ #</L>
      <L># $.#*#.$ #</L>
      <L># $.#*#.$ #</L>
      <L># $.###.$ #</L>
      <L>#  .   .$ #</L>
      <L>###########</L>
    </Level>
    <Level Id="Northern Star" Width="10" Height="11">
      <L> ###</L>
      <L>##.#######</L>
      <L>#...     #</L>
      <L>##.## ## #</L>
      <L> # #  #  #</L>
      <L> # #  # ##</L>
      <L> # $$$$$@#</L>
      <L> # #     #</L>
      <L> # ### ###</L>
      <L> #     #</L>
      <L> #######</L>
    </Level>
    <Level Id="Center Line" Width="12" Height="14">
      <L>    ######</L>
      <L>    #    #</L>
      <L> ####.##$##</L>
      <L> #   .#   #</L>
      <L>##$##.  $ #</L>
      <L>#   #@#   #</L>
      <L># $  .##$##</L>
      <L>#   #.    #</L>
      <L>##$##.### #</L>
      <L> #        #</L>
      <L> # ###### ##</L>
      <L> #         #</L>
      <L> #######   #</L>
      <L>       #####</L>
    </Level>
    <Level Id="Prison Break" Width="10" Height="11">
      <L> #########</L>
      <L> #       #</L>
      <L>##$#####.#</L>
      <L>#  #   #.#</L>
      <L>#    @ #.#</L>
      <L>##$##$##.#</L>
      <L>#        #</L>
      <L>#  ##  # #</L>
      <L>##$#  ## #</L>
      <L> #       #</L>
      <L> #########</L>
    </Level>
    <Level Id="Full Duplex" Width="11" Height="11">
      <L> #########</L>
      <L> #       #</L>
      <L>##$### #$#</L>
      <L>#  .  .# #</L>
      <L>#  .$$.# #</L>
      <L>## ##@## ##</L>
      <L> # #.$$.  #</L>
      <L> # #.  .  #</L>
      <L> #$# ###$##</L>
      <L> #       #</L>
      <L> #########</L>
    </Level>
    <Level Id="Mess in the middle" Width="15" Height="15">
      <L>  ####### #####</L>
      <L>  #     # #   #</L>
      <L>###$#$# ### # #</L>
      <L># $     $   $ #</L>
      <L># # ###.### # #</L>
      <L># $ #...$ # $ #</L>
      <L># # #.#.# # # #</L>
      <L># $ ...@... $ #</L>
      <L># # # #.#.# # #</L>
      <L># $ # $...# $ #</L>
      <L># # ###.### # #</L>
      <L># $   $     $ #</L>
      <L># # ### #$#$###</L>
      <L>#   # #     #</L>
      <L>##### #######</L>
    </Level>
    <Level Id="Overunder" Width="11" Height="11">
      <L>##########</L>
      <L>#....#  @#</L>
      <L>#.$$$$$#$##</L>
      <L>#.$       #</L>
      <L>#.$  # #  #</L>
      <L>##$#   #$##</L>
      <L>#.$  $  $.#</L>
      <L>#.$  #  $.#</L>
      <L>#.$$$#$$$.#</L>
      <L>#.... ....#</L>
      <L>###########</L>
    </Level>
    <Level Id="Cyclone" Width="11" Height="11">
      <L>  #####</L>
      <L> ##   ####</L>
      <L> #..$$...##</L>
      <L> #.#$  #. #</L>
      <L>##. $ $$$ #</L>
      <L># $  @  $ #</L>
      <L># $$$ $ .##</L>
      <L># .#  $#.#</L>
      <L>##...$$..#</L>
      <L> ####   ##</L>
      <L>    #####</L>
    </Level>
    <Level Id="Alcatraz" Width="12" Height="11">
      <L>     #######</L>
      <L> #####.   .#</L>
      <L> # $ .$## ##</L>
      <L> #  .#. .  #</L>
      <L> ## #.$ #$ #</L>
      <L>  # $ #   ##</L>
      <L>### #  $# #</L>
      <L>#   ### # #</L>
      <L># #   @$  #</L>
      <L>#   ###   #</L>
      <L>##### #####</L>
    </Level>
    <Level Id="In the cloud again" Width="12" Height="10">
      <L>     #####</L>
      <L>     #   #</L>
      <L>  #### # ###</L>
      <L>###.$. $ $ #</L>
      <L>#  .$# # # #</L>
      <L>#   $@     #</L>
      <L>###.#####$##</L>
      <L> # . .    #</L>
      <L> #   ######</L>
      <L> #####</L>
    </Level>
    <Level Id="Easy Omlette" Width="11" Height="11">
      <L>  #####</L>
      <L> ##  @####</L>
      <L>##.$.$.$.##</L>
      <L># $. # .$ #</L>
      <L># .  $  . #</L>
      <L># $#$#$#$ #</L>
      <L># .  $  . #</L>
      <L># $. # .$ #</L>
      <L>##.$.$.$.##</L>
      <L> ####   ##</L>
      <L>    #####</L>
    </Level>
    <Level Id="Cunning" Width="8" Height="10">
      <L>#######</L>
      <L>#     #</L>
      <L># *..$##</L>
      <L># $ .$ #</L>
      <L>####.# #</L>
      <L># $ .$ #</L>
      <L># *..$ #</L>
      <L># @ #$ #</L>
      <L>###    #</L>
      <L>  ######</L>
    </Level>
    <Level Id="Dash" Width="10" Height="11">
      <L>    #####</L>
      <L>#####   ##</L>
      <L>#   @ #  #</L>
      <L># #$# ## #</L>
      <L>#   #  $ #</L>
      <L># #....###</L>
      <L># $ #   #</L>
      <L>### # $ #</L>
      <L>  # # # #</L>
      <L>  #     #</L>
      <L>  #######</L>
    </Level>
    <Level Id="Hammerhead" Width="11" Height="10">
      <L>########</L>
      <L>#   #  #</L>
      <L># . $ $#</L>
      <L>## .#  #</L>
      <L> #.## $####</L>
      <L>## .      #</L>
      <L># .#@## # #</L>
      <L># ##  $ $ #</L>
      <L>#    ######</L>
      <L>######</L>
    </Level>
    <Level Id="Tree" Width="11" Height="11">
      <L> #########</L>
      <L>##   #   ##</L>
      <L>#  $ + $  #</L>
      <L># # #$# # #</L>
      <L># $ ... $ #</L>
      <L># ###$### #</L>
      <L># $.#.#.$ #</L>
      <L>#   $ $   #</L>
      <L>##.##.##.##</L>
      <L> #       #</L>
      <L> #########</L>
    </Level>
    <Level Id="Springs" Width="11" Height="11">
      <L>    #####</L>
      <L>    #   ###</L>
      <L>   ## #   #</L>
      <L>####  $ $ #</L>
      <L># . .#$#$ #</L>
      <L># . .@$ $ #</L>
      <L># .#.#$ $ #</L>
      <L># . .   ###</L>
      <L>#   # ###</L>
      <L>###   #</L>
      <L>  #####</L>
    </Level>
    <Level Id="Two's" Width="11" Height="11">
      <L>###########</L>
      <L>#     #   #</L>
      <L># $$  $ . #</L>
      <L>###.##$#.##</L>
      <L>  #.     #</L>
      <L>  # #@## ##</L>
      <L> ##.# #   #</L>
      <L> # .$ $.. #</L>
      <L> # #$#$#  #</L>
      <L> #     ####</L>
      <L> #######</L>
    </Level>
    <Level Id="EOF" Width="15" Height="9">
      <L>  ###########</L>
      <L>###         ###</L>
      <L># ..*$**.$*** #</L>
      <L># *  $.$.$. $ #</L>
      <L># .*$$.$.$.** #</L>
      <L># *  $.$.$. $ #</L>
      <L># .*.$.*.$.$$ #</L>
      <L>####  @#      #</L>
      <L>   ############</L>
    </Level>
  </LevelCollection>
</SokobanLevels>
