<?xml version="1.0" encoding="utf-8"?>
<SokobanLevels xmlns:xsi="http://www.w3.org/2001/XMLSchema-instance" xsi:schemaLocation="SokobanLev.xsd">
  <Title>Chrysalis Collection 2</Title>
  <Description>
The 2nd collection of 50 puzzles taken from my creations in the
members section of letslogic.com - roughly in order of publish date.
  </Description>
  <Email>david@chrysalis.co.za</Email>
  <Url>http://www.letslogic.com</Url>
  <LevelCollection Copyright="David Buchweitz" MaxWidth="33" MaxHeight="26">
    <Level Id="Elle" Width="11" Height="18">
      <L>#########</L>
      <L>#    #  #</L>
      <L>#.$ $#$ #</L>
      <L>#.#  #  #</L>
      <L>#.$ $#$ #</L>
      <L>#.#  #  #</L>
      <L>#.$ $#$ #</L>
      <L>#.#  #  #</L>
      <L>#.$ $#$ #</L>
      <L>#.#  #  #</L>
      <L>#.$ $#$ #</L>
      <L>#.#  #  #</L>
      <L>#.$ $#$ #</L>
      <L>#.#  #  ###</L>
      <L>#.$ $@$   #</L>
      <L>#.# # # # #</L>
      <L>#.......  #</L>
      <L>###########</L>
    </Level>
    <Level Id="9x9x9x9" Width="9" Height="9">
      <L>  #####</L>
      <L>###   ###</L>
      <L># .$.$. #</L>
      <L># $   $ #</L>
      <L>##.$+$.##</L>
      <L>#   #   #</L>
      <L># $.*.$ #</L>
      <L>###   ###</L>
      <L>  #####</L>
    </Level>
    <Level Id="In the cloud" Width="11" Height="10">
      <L> ######</L>
      <L>##    ####</L>
      <L>#  $$$   #</L>
      <L># .#.#.#.##</L>
      <L>#  #      #</L>
      <L>#    @ #  #</L>
      <L>##$#$#$#$ #</L>
      <L> #   ...  #</L>
      <L> ####    ##</L>
      <L>    ######</L>
    </Level>
    <Level Id="Rabbit" Width="12" Height="11">
      <L>    ########</L>
      <L>    #      #</L>
      <L>  ### #### #</L>
      <L>###. $ .   #</L>
      <L># $ #.##$###</L>
      <L># #$.+.$  #</L>
      <L>#   #. ## #</L>
      <L># $.   .$ #</L>
      <L>###$## $# #</L>
      <L>  #       #</L>
      <L>  #########</L>
    </Level>
    <Level Id="Mr Miagi" Width="13" Height="21">
      <L>   #######</L>
      <L>  #       #</L>
      <L> #  ## ##  #</L>
      <L>#  ..$ $..  #</L>
      <L># $..###..$ #</L>
      <L>## #  *  # ##</L>
      <L> # $$ @ $$ #</L>
      <L> ## .$$$. ##</L>
      <L>  ## ... ##</L>
      <L>   ##   ##</L>
      <L>     #.#</L>
      <L>   ##   ##</L>
      <L>  # $ . $ #</L>
      <L># # ## ## # #</L>
      <L>### $ . $ ###</L>
      <L>  # ## ## #</L>
      <L>  # $ . $ #</L>
      <L>  #       #</L>
      <L>   #######</L>
      <L>     # #</L>
      <L>    ## ##</L>
    </Level>
    <Level Id="Easy One" Width="13" Height="7">
      <L>##### #######</L>
      <L>#   ###..   #</L>
      <L># $$$.@.$$$ #</L>
      <L>#   ..###   #</L>
      <L>## # ## #####</L>
      <L> #   #</L>
      <L> #####</L>
    </Level>
    <Level Id="Tetrissy" Width="25" Height="9">
      <L>  ########## ##########</L>
      <L>###   ##   ###   ##   ###</L>
      <L>#   $ .. $ . . $ .. $   #</L>
      <L># #   ##   # #   ##   # #</L>
      <L># ##$####$##@##$####$## #</L>
      <L># #   ##   # #   ##   # #</L>
      <L>#   $ .. $ . . $ .. $   #</L>
      <L>###   ##   ###   ##   ###</L>
      <L>  ########## ##########</L>
    </Level>
    <Level Id="zigzag" Width="9" Height="9">
      <L> #######</L>
      <L> #     #</L>
      <L> #$$$$ #</L>
      <L>##.#.#.##</L>
      <L>#. . . .#</L>
      <L>####$ # #</L>
      <L>  # $ $ #</L>
      <L>  # @ ###</L>
      <L>  #####</L>
    </Level>
    <Level Id="Anchor" Width="10" Height="10">
      <L>  ########</L>
      <L>  #      #</L>
      <L>  #$##$# #</L>
      <L>  # .. # #</L>
      <L>  # .    #</L>
      <L>###  . # #</L>
      <L># $ .. $ #</L>
      <L># #$##$###</L>
      <L>#       @#</L>
      <L>##########</L>
    </Level>
    <Level Id="Double" Width="10" Height="10">
      <L>#####  ###</L>
      <L>#   #### #</L>
      <L># $    + #</L>
      <L># $# ##. #</L>
      <L># $ $.#.##</L>
      <L>##.#.$ $ #</L>
      <L># .## #$ #</L>
      <L># .    $ #</L>
      <L># ####   #</L>
      <L>###  #####</L>
    </Level>
    <Level Id="Under The Boardwalk" Width="15" Height="10">
      <L>###############</L>
      <L>#             #</L>
      <L># ########### #</L>
      <L># #           #</L>
      <L># #$#$#@#$#$# #</L>
      <L># $.........$ #</L>
      <L># #..*.*.*..# #</L>
      <L># $$$#$$$#$$$ #</L>
      <L>#    #        #</L>
      <L>###############</L>
    </Level>
    <Level Id="Zuma" Width="13" Height="10">
      <L>         ####</L>
      <L> #########  #</L>
      <L> #          #</L>
      <L> # #$$$$$#  #</L>
      <L>## #        #</L>
      <L>#...####$ ###</L>
      <L>#...      #</L>
      <L>#... $$$###</L>
      <L>#####  @#</L>
      <L>    #####</L>
    </Level>
    <Level Id="Around The Block" Width="9" Height="11">
      <L>  #####</L>
      <L>  #   #</L>
      <L>### $ ##</L>
      <L>#   #  ##</L>
      <L># $ $ $ #</L>
      <L># # # # #</L>
      <L># $ $.*.#</L>
      <L>### @.#.#</L>
      <L>  ##$...#</L>
      <L>   #  ###</L>
      <L>   ####</L>
    </Level>
    <Level Id="Incrementor" Width="20" Height="20">
      <L>       ######</L>
      <L>       #    #</L>
      <L>       # #$ #</L>
      <L>       # #  #</L>
      <L>       # #$ ####</L>
      <L>     ### #.. $ #</L>
      <L>     #   #.### #</L>
      <L>###### ###.$ # #####</L>
      <L>#      #...$ #     #</L>
      <L># ######.$ $ ..$ $ #</L>
      <L># $......$@$ .#### #</L>
      <L>#   #$$$$$ $$.#    #</L>
      <L>### #      $ .# ####</L>
      <L>  # # $ $*.*..# #</L>
      <L>  # # $ $.##### #</L>
      <L>  # #####.#     #</L>
      <L>  #    $..# #####</L>
      <L>  ###### $# #</L>
      <L>       #    #</L>
      <L>       ######</L>
    </Level>
    <Level Id="Tee" Width="13" Height="12">
      <L> #########</L>
      <L> #       ###</L>
      <L>##.$ $ $.$ ##</L>
      <L>#  ##### #  #</L>
      <L># $#  .#  $ #</L>
      <L># .#... . # #</L>
      <L># $#  .## $ #</L>
      <L>#  #####  # #</L>
      <L># .$ $ $.$+ #</L>
      <L>#### # #  ###</L>
      <L>   #      #</L>
      <L>   ########</L>
    </Level>
    <Level Id="9th Symphony" Width="15" Height="15">
      <L>   #   #   #</L>
      <L>  # # # # # #</L>
      <L> #   #   #   #</L>
      <L>#  $   $   $  #</L>
      <L> #   # # #   #</L>
      <L>  # # . . # #</L>
      <L> #   . # .   #</L>
      <L>#  $# #*# #$  #</L>
      <L> #   . # .   #</L>
      <L>  # # . . # #</L>
      <L> #   # # #   #</L>
      <L>#  $   $   $  #</L>
      <L> #   #   #   #</L>
      <L>  # # #@# # #</L>
      <L>   #   #   #</L>
    </Level>
    <Level Id="Bowtie" Width="11" Height="10">
      <L> #########</L>
      <L>##   @   ##</L>
      <L># $#$#$#$ #</L>
      <L>#...$ $...#</L>
      <L>#  #$ $#  #</L>
      <L>#    $    #</L>
      <L># $.$#$.$ #</L>
      <L>## . . . ##</L>
      <L> ##.###.##</L>
      <L>  ### ###</L>
    </Level>
    <Level Id="Cramped Cross" Width="10" Height="10">
      <L>   #####</L>
      <L> ###.$ ##</L>
      <L> # $.$  #</L>
      <L>## #.$# ##</L>
      <L>#........#</L>
      <L>#$$$.$$$$#</L>
      <L>#   .$   #</L>
      <L>####.$@$##</L>
      <L>   #.$  #</L>
      <L>   ######</L>
    </Level>
    <Level Id="Have Mercy" Width="9" Height="10">
      <L>  #####</L>
      <L>  #   ###</L>
      <L>###$# $ #</L>
      <L>#   #.# #</L>
      <L># $ .+. #</L>
      <L>### #.# #</L>
      <L> # $ .# #</L>
      <L> #  $ $ #</L>
      <L> ###  ###</L>
      <L>   ####</L>
    </Level>
    <Level Id="Interlinked" Width="11" Height="12">
      <L>  #######</L>
      <L> ##.....##</L>
      <L> #.     .#</L>
      <L>##.# @ #.#</L>
      <L># .$$$$$.##</L>
      <L># $.....$ #</L>
      <L># $# # #$ #</L>
      <L># $     $ #</L>
      <L>###$$$$$# #</L>
      <L>  #       #</L>
      <L>  ##    ###</L>
      <L>   ######</L>
    </Level>
    <Level Id="Octopus" Width="12" Height="12">
      <L>##########</L>
      <L>#..... * #</L>
      <L>#. $.#$$ ###</L>
      <L>#.$$.. $ . #</L>
      <L>#....#$$$# #</L>
      <L>#.#.#  $   #</L>
      <L># $ $  $ ###</L>
      <L>#*$$$$$+ #</L>
      <L>#   $   ##</L>
      <L>###.# ###</L>
      <L>  #   #</L>
      <L>  #####</L>
    </Level>
    <Level Id="Basking in the sun" Width="11" Height="10">
      <L>     #####</L>
      <L>######. @#</L>
      <L>#.    $ .#</L>
      <L># $#$## ##</L>
      <L>##    # #</L>
      <L># .##.$ ###</L>
      <L># ## $# $ #</L>
      <L>#      .# #</L>
      <L>######    #</L>
      <L>     ######</L>
    </Level>
    <Level Id="T-Bone" Width="10" Height="10">
      <L>##########</L>
      <L>#.  .#  .#</L>
      <L>## # $  ##</L>
      <L> # # ##$#</L>
      <L> # $ @  #</L>
      <L> # ###$.#</L>
      <L> #.  $ ###</L>
      <L> ##$#    #</L>
      <L>  #   .  #</L>
      <L>  ########</L>
    </Level>
    <Level Id="Fangs" Width="11" Height="11">
      <L>###########</L>
      <L>#  #   #  #</L>
      <L># $.$.$.$ #</L>
      <L># .$ $ $. #</L>
      <L>##$ ... $##</L>
      <L># .$.@.$. #</L>
      <L>##$ ... $##</L>
      <L># .$ $ $. #</L>
      <L># $.$.$.$ #</L>
      <L>#  #   #  #</L>
      <L>###########</L>
    </Level>
    <Level Id="Whirlpool" Width="21" Height="21">
      <L>      ###########</L>
      <L>      #         #</L>
      <L>  ##### ####### ###</L>
      <L>  #   $ $     $ $ #</L>
      <L>### ### ##### # # ###</L>
      <L>#     $ $     $ $   #</L>
      <L># #$#$# #####.# #$# #</L>
      <L># #     ......#   # #</L>
      <L># #$#$# #####.# #$# #</L>
      <L>#       ...@#.#     #</L>
      <L># #$#$# #.###.# #$# #</L>
      <L># #     #......   # #</L>
      <L># #$#$# #.##### #$# #</L>
      <L>#       .......     #</L>
      <L>### # # # ##### # # #</L>
      <L>  # # $ $     $ $ # #</L>
      <L>  # ### ##### # ### #</L>
      <L>  #   $ $     $ $   #</L>
      <L>  ##### ####### #####</L>
      <L>      #         #</L>
      <L>      ###########</L>
    </Level>
    <Level Id="Diagonal" Width="13" Height="13">
      <L>#############</L>
      <L>#..         #</L>
      <L>#.#.$ $# ## #</L>
      <L># .#.$ $ .# #</L>
      <L># $.#.$ $ # #</L>
      <L>#  $.#.$ $# #</L>
      <L># $ $.@.$ $ #</L>
      <L># #$ $.#.$  #</L>
      <L>#   $ $.#.$ #</L>
      <L>###. $ $.#. #</L>
      <L>  ## #$ $.#.#</L>
      <L>   #      ..#</L>
      <L>   ##########</L>
    </Level>
    <Level Id="Snakes" Width="33" Height="11">
      <L>#################################</L>
      <L>#                               #</L>
      <L># ***. *  . ***. *  . ***. ***. #</L>
      <L># *    *  * *  * * *  *    *    #</L>
      <L># *    *  * *  * * *  *    *    #</L>
      <L># **** ** * *  *@**   ***  **** #</L>
      <L>#    * * ** **** * *  *       * #</L>
      <L>#    * *  * *  * * *  *       * #</L>
      <L># $*** $  * $  * $  * $*** $*** #</L>
      <L>#                               #</L>
      <L>#################################</L>
    </Level>
    <Level Id="Which Path?" Width="19" Height="23">
      <L>         ######</L>
      <L>         #    ####</L>
      <L>        ## ##    #</L>
      <L>    #####   #### #</L>
      <L>   ##     $    # #</L>
      <L>  ##  ## $#### # #</L>
      <L> ##  ## $  # # # #</L>
      <L>##  ## $ # # # # #</L>
      <L>#  ## $  @ # # # #</L>
      <L># ## $ ### # # # #</L>
      <L># # $  # # # # # #</L>
      <L># #$ # # # # # # ##</L>
      <L># #.   # # # # #  #</L>
      <L># ##.# ### # # ## #</L>
      <L>#  ##.     # #  # #</L>
      <L>##  # .# # #### # #</L>
      <L> ##   #.        # #</L>
      <L>  ######.#  ##### #</L>
      <L>       # .  #     #</L>
      <L>       # #.## #####</L>
      <L>       # ###  #</L>
      <L>       #     ##</L>
      <L>       #######</L>
    </Level>
    <Level Id="Slinky" Width="13" Height="11">
      <L>  ###########</L>
      <L>  #     #   #</L>
      <L> ##$# $ . # #</L>
      <L> #  . # ### #</L>
      <L> #  # # #   #</L>
      <L>###$#.@.#$###</L>
      <L>#   # # #  #</L>
      <L># ### # .  #</L>
      <L># # . $ #$##</L>
      <L>#   #     #</L>
      <L>###########</L>
    </Level>
    <Level Id="Catherine Wheel" Width="21" Height="21">
      <L> ###################</L>
      <L>##.................##</L>
      <L>#.#       #       #.#</L>
      <L>#. #$$$$$$$$$$$$$# .#</L>
      <L>#. $ #    #      $ .#</L>
      <L>#. $ #### #### ##$ .#</L>
      <L>#. $           # $ .#</L>
      <L>#. $ # $$$$$$. # $ .#</L>
      <L>#. $ # $     $ # $ .#</L>
      <L>#. $ # $ $.. $   $ .#</L>
      <L>#.#$## $ .@. $ ##$#.#</L>
      <L>#. $   $ ..$ $ # $ .#</L>
      <L>#. $ # $     $ # $ .#</L>
      <L>#. $ # .$$$$$$ # $ .#</L>
      <L>#. $ #           $ .#</L>
      <L>#. $## #### #### $ .#</L>
      <L>#. $      #    # $ .#</L>
      <L>#. #$$$$$$$$$$$$$# .#</L>
      <L>#.#       #       #.#</L>
      <L>##.................##</L>
      <L> ###################</L>
    </Level>
    <Level Id="Welcome to..." Width="23" Height="19">
      <L>#######################</L>
      <L>#                     #</L>
      <L># *...$....$....$...* #</L>
      <L># .$$$$.$$.$.$$*$.$$$ #</L>
      <L># *$   ....$....$...$ #</L>
      <L># .$$$$.$$.$.$$ $.$$$ #</L>
      <L># ....$.$ .$.$  $.... #</L>
      <L># $$$$$$$$$$$$$$$$$$$ #</L>
      <L># ....$....$.$ .$.$ . #</L>
      <L># $..$$.$$.$.$$.$.$$. #</L>
      <L># $..$ .@$.$. $.$..$. #</L>
      <L># $..$ .$$.$....$.$.. #</L>
      <L># $..$$....$$..$$.$$. #</L>
      <L>#                     #</L>
      <L>#######################</L>
      <L>   ##             ##</L>
      <L>   ##             ##</L>
      <L>  ####           ####</L>
      <L>  ####           ####</L>
    </Level>
    <Level Id="4x4 skewed" Width="11" Height="9">
      <L>##########</L>
      <L>#  $   . #</L>
      <L># $#$#.#.#</L>
      <L>#  $   . #</L>
      <L>## # @ # ##</L>
      <L> # .   $  #</L>
      <L> #.#.#$#$ #</L>
      <L> # .   $  #</L>
      <L> ##########</L>
    </Level>
    <Level Id="6x4" Width="15" Height="12">
      <L>     #####</L>
      <L>###### @ ######</L>
      <L>#  $   .   $  #</L>
      <L># $#$#.#.#$#$ #</L>
      <L>#  $   .   $  #</L>
      <L>## ### # ### ##</L>
      <L> # .   $   . #</L>
      <L> #.#.#$#$#.#.#</L>
      <L> # .   $   . #</L>
      <L> ### ##### ###</L>
      <L>   #       #</L>
      <L>   #########</L>
    </Level>
    <Level Id="Shuriken" Width="11" Height="13">
      <L>########</L>
      <L>#      ###</L>
      <L>##$#$# #.#</L>
      <L>#  $ . . #</L>
      <L># $#$#.#.##</L>
      <L>#  $ $ . .#</L>
      <L># $#.@.#$ #</L>
      <L>#. . $ $  #</L>
      <L>##.#.#$#$ #</L>
      <L> # . . $  #</L>
      <L> #.# #$#$##</L>
      <L> ###      #</L>
      <L>   ########</L>
    </Level>
    <Level Id="Puzzler" Width="14" Height="14">
      <L>    ####</L>
      <L>    #  #</L>
      <L>    # $#</L>
      <L>#####  ####</L>
      <L>#    $ $  #</L>
      <L>#  $.....$#</L>
      <L>###$.# #. ####</L>
      <L>  # .#+ .$   #</L>
      <L>  # .# #.  $ #</L>
      <L>###$.*.*.$####</L>
      <L>#  $ $ $  #</L>
      <L># $ ####$ #</L>
      <L>#   #  #  #</L>
      <L>#####  ####</L>
    </Level>
    <Level Id="Riser" Width="27" Height="26">
      <L>######           ######</L>
      <L>#    #############    #</L>
      <L># ##               ## #</L>
      <L># #  #############    #</L>
      <L>#    #           #  # #</L>
      <L>##.#$#           ##.#$##</L>
      <L> # # #############   . #</L>
      <L> # .                ## #</L>
      <L> # ## #############  $ #</L>
      <L> # $  #           #  # #</L>
      <L> ##.#$#           ##.#$##</L>
      <L>  # # #############   . #</L>
      <L>  # .        @       ## #</L>
      <L>  # ## #############  $ #</L>
      <L>  # $  #           #  # #</L>
      <L>  ##.#$#           ##.#$##</L>
      <L>   # # #############   . #</L>
      <L>   # .                ## #</L>
      <L>   # ## #############  $ #</L>
      <L>   # $  #           #  # #</L>
      <L>   ##.#$#           ##.#$##</L>
      <L>    # # #############     #</L>
      <L>    #                   # #</L>
      <L>    # ## ############# ## #</L>
      <L>    #    #           #    #</L>
      <L>    ######           ######</L>
    </Level>
    <Level Id="Quicky" Width="12" Height="8">
      <L>   #####</L>
      <L>####  @#####</L>
      <L>#  .$#     #</L>
      <L># $  .$# # #</L>
      <L>#  .$# .$  #</L>
      <L>###  .$  # #</L>
      <L>  #####.   #</L>
      <L>      ######</L>
    </Level>
    <Level Id="Cargo Net with Training Wheels" Width="15" Height="14">
      <L> #############</L>
      <L> #           #</L>
      <L> # ######### ##</L>
      <L>## #       #  #</L>
      <L>#  #.$$.$$.## #</L>
      <L># ##$..$..$   #</L>
      <L>#   .$$.$$. ###</L>
      <L>### $..$..$   #</L>
      <L>#   .$$.$$.## #</L>
      <L># ##$..$..$#  #</L>
      <L>#  #   @   # ##</L>
      <L>## ######### #</L>
      <L> #           #</L>
      <L> #############</L>
    </Level>
    <Level Id="Cargo Net" Width="11" Height="10">
      <L> #########</L>
      <L> #       #</L>
      <L> #.$$.$$.##</L>
      <L>##$..$..$ #</L>
      <L># .$$.$$. #</L>
      <L># $..$..$ #</L>
      <L># .$$.$$.##</L>
      <L>##$..$..$#</L>
      <L> #   @   #</L>
      <L> #########</L>
    </Level>
    <Level Id="Ear" Width="9" Height="11">
      <L>#######</L>
      <L>#...  ##</L>
      <L>#.#.   ##</L>
      <L>#... #  #</L>
      <L>#  #$$$ #</L>
      <L>##  $@$ #</L>
      <L> ###$$$##</L>
      <L> #     #</L>
      <L> # # ###</L>
      <L> #   #</L>
      <L> #####</L>
    </Level>
    <Level Id="Here Boy" Width="11" Height="12">
      <L>  #######</L>
      <L> #       #</L>
      <L># @#$$#$ #</L>
      <L> # $ ..$ #</L>
      <L>  #  .. #</L>
      <L>   ##..###</L>
      <L>#  # .. $ #</L>
      <L> ### #$$# #</L>
      <L>   #      #</L>
      <L>    ######</L>
      <L>     #  #</L>
      <L>    ## ##</L>
    </Level>
    <Level Id="Passage with Bridge" Width="10" Height="16">
      <L>   ######</L>
      <L>   #    #</L>
      <L> ###$$# #</L>
      <L>## .  . #</L>
      <L>#  #$$###</L>
      <L>#  $. #</L>
      <L>#  #$.###</L>
      <L>##.#  . #</L>
      <L> # .  #.##</L>
      <L> ###.$#  #</L>
      <L>   # .$  #</L>
      <L> ###$$#  #</L>
      <L> # +  # ##</L>
      <L> # #$$. #</L>
      <L> #    ###</L>
      <L> ######</L>
    </Level>
    <Level Id="Rotary" Width="11" Height="11">
      <L>#####  ####</L>
      <L>#    ##   #</L>
      <L># $.$#  @ #</L>
      <L># .$.$.$  #</L>
      <L># $. .$. #</L>
      <L> ##$.#.$##</L>
      <L> # .$. .$ #</L>
      <L>#  $.$.$. #</L>
      <L># #  #$.$ #</L>
      <L>#   ##    #</L>
      <L>####  #####</L>
    </Level>
    <Level Id="Wacky Wednesday" Width="13" Height="12">
      <L>   #########</L>
      <L>   #       #</L>
      <L>  ##$#$#$# #</L>
      <L>###  @     #</L>
      <L># $$$# # # #</L>
      <L># $  $$$ # #</L>
      <L># ## # # # #</L>
      <L>#..........##</L>
      <L>####### ##  #</L>
      <L>      #     #</L>
      <L>      #  ####</L>
      <L>      ####</L>
    </Level>
    <Level Id="Fiver" Width="8" Height="8">
      <L>#######</L>
      <L>#     ##</L>
      <L># $ $  #</L>
      <L>##$#$# #</L>
      <L>#...$  #</L>
      <L>#.. # ##</L>
      <L>### @ #</L>
      <L>  #####</L>
    </Level>
    <Level Id="Center Shuriken" Width="10" Height="13">
      <L>    #####</L>
      <L>##### @ #</L>
      <L>#   # # #</L>
      <L>#   $ $ ##</L>
      <L>##$#.##  #</L>
      <L>#  #...$ #</L>
      <L># $...#  #</L>
      <L>#  ##.#$##</L>
      <L>## $ $  #</L>
      <L> # #    #</L>
      <L> # #### #</L>
      <L> #      #</L>
      <L> ########</L>
    </Level>
    <Level Id="Broken Ladder" Width="11" Height="13">
      <L>###########</L>
      <L># $ .#. $ #</L>
      <L>#  $.$.$  #</L>
      <L># $ .#. $##</L>
      <L>#  $.*.$ #</L>
      <L>##$ .#. $#</L>
      <L> # $.+.$ #</L>
      <L> #$ .#. $##</L>
      <L> # $.*.$  #</L>
      <L>##$ .#. $ #</L>
      <L>#  $.*.$  #</L>
      <L># $ .#. $ #</L>
      <L>###########</L>
    </Level>
    <Level Id="Handlebars" Width="14" Height="13">
      <L>#####  ####</L>
      <L>#   ####  #</L>
      <L># $    $$ ####</L>
      <L>##$#$ ##     #</L>
      <L> #  $ $  ### #</L>
      <L> ##.#+$.$# # #</L>
      <L> #..#.$..### #</L>
      <L> #.$ # #.    #</L>
      <L> #.$    . ## #</L>
      <L> ## ####  #  #</L>
      <L> #     #### ##</L>
      <L> #####      #</L>
      <L>     ########</L>
    </Level>
    <Level Id="Puzzler II" Width="12" Height="12">
      <L>##### ######</L>
      <L>#   ###    #</L>
      <L># $     $$ #</L>
      <L>### $ #@ $##</L>
      <L>  ### $$  #</L>
      <L> ##.###  $##</L>
      <L>##..#.#$ $ #</L>
      <L>#. ... $   #</L>
      <L>#..  .###  #</L>
      <L>####  # ####</L>
      <L>   #  #</L>
      <L>   ####</L>
    </Level>
    <Level Id="Corner Camper" Width="10" Height="10">
      <L>#### #####</L>
      <L># @###.*.#</L>
      <L># $   . .#</L>
      <L>#    # $##</L>
      <L>##$# $  #</L>
      <L> #  $ #$##</L>
      <L>##$ #    #</L>
      <L>#. .   $ #</L>
      <L>#.*.###  #</L>
      <L>##### ####</L>
    </Level>
  </LevelCollection>
</SokobanLevels>
