<?xml version="1.0" encoding="utf-8"?>
<SokobanLevels xmlns:xsi="http://www.w3.org/2001/XMLSchema-instance" xsi:schemaLocation="SokobanLev.xsd">
  <Title>Chuchubi08</Title>
  <Description>
50 new to enjoy
  </Description>
  <Email>serenata@setarnet.aw</Email>
  <LevelCollection Copyright="Eric F Tchong" MaxWidth="29" MaxHeight="23">
    <Level Id="chuchubi08 starter" Width="21" Height="13">
      <L>  #################</L>
      <L>  # ............. #</L>
      <L>  # ............. #</L>
      <L>####.###.#.#.###.####</L>
      <L># $   $  # #  $   $ #</L>
      <L># $   #  # #  #   $ #</L>
      <L># ### #$##$##$# ### #</L>
      <L># $ $ #  $ $  # $ $ #</L>
      <L># $ $ #   $   # $ $ #</L>
      <L>#  $   $$$$$$$   $  #</L>
      <L># $ ###   @   ### $ #</L>
      <L>#     #########     #</L>
      <L>#######       #######</L>
    </Level>
    <Level Id="village" Width="13" Height="11">
      <L>     ####</L>
      <L>     #..#</L>
      <L>   ###..###</L>
      <L>#### ...  #</L>
      <L>#  # .*.  ###</L>
      <L># $$  ##$$  #</L>
      <L>#  #$$$ $ # #</L>
      <L># $# @    # #</L>
      <L>#  ######## #</L>
      <L>##          #</L>
      <L> ############</L>
    </Level>
    <Level Id="picaro" Width="12" Height="11">
      <L>     #####</L>
      <L>     #   #</L>
      <L>    ##$# ###</L>
      <L> ####  $   #</L>
      <L> #  $      #</L>
      <L> #..# $#$$##</L>
      <L>##..$  #  #</L>
      <L>#...####$ ##</L>
      <L>#...$   @$ #</L>
      <L>#   #  #   #</L>
      <L>############</L>
    </Level>
    <Level Id="douana" Width="12" Height="19">
      <L>  #####</L>
      <L>###   ###</L>
      <L>#  $# $ ###</L>
      <L>#     $ $ #</L>
      <L>###$#     #</L>
      <L>  # ###$# #</L>
      <L>  # $ # $ ##</L>
      <L>  #   $    #</L>
      <L>  ## #  $ @#</L>
      <L> ##  #### ##</L>
      <L> # $      #</L>
      <L> # # ##.. #</L>
      <L> #  $ #.  #</L>
      <L> ##  $##.##</L>
      <L>  #   ...##</L>
      <L>  ##$ #  .#</L>
      <L>   #  ....#</L>
      <L>   #####..#</L>
      <L>       ####</L>
    </Level>
    <Level Id="etude" Width="23" Height="16">
      <L>####  #####</L>
      <L>#  ####   #</L>
      <L>#         #</L>
      <L>#  ##### ## ####  #####</L>
      <L>## ....# ## #  ####   #</L>
      <L>#  ....# #  # $    $$ #</L>
      <L>#  ....# ## #  ##$$   #</L>
      <L>## ....#  ### $     $ #</L>
      <L> # ....#      #$ $$   #</L>
      <L> # ##### # # $# $ ##@##</L>
      <L> #       # #      # $ #</L>
      <L> ####### #$#####$##   #</L>
      <L>       # # $ $ $  # $##</L>
      <L>       #          $  #</L>
      <L>       ############  #</L>
      <L>                  ####</L>
    </Level>
    <Level Id="deepdive" Width="16" Height="21">
      <L>      #########</L>
      <L>    ###       #</L>
      <L> ####  $ $$$$ #</L>
      <L> #    $     $ #</L>
      <L>##$####  #$  ##</L>
      <L>#   $ #$ #  $ ##</L>
      <L># $      #   $ #</L>
      <L>## $#### #$$$$ #</L>
      <L> #  # #  $   $ #</L>
      <L> ######$ ## # @#</L>
      <L>      #  #  ####</L>
      <L>      #     #</L>
      <L> ###### ###$#</L>
      <L> #      #   #</L>
      <L>## #### # ###</L>
      <L>#.    # # #</L>
      <L>#......   #</L>
      <L>#.....#   ##</L>
      <L>##.........#</L>
      <L> ######..###</L>
      <L>      ####</L>
    </Level>
    <Level Id="sonate" Width="16" Height="20">
      <L>           ####</L>
      <L>####### ####  #</L>
      <L>#     # #     #</L>
      <L>#     ### ... ##</L>
      <L>## ##......#.  #</L>
      <L># .... ##  #.  #</L>
      <L># .   ###  #.  #</L>
      <L># . # ### ... ##</L>
      <L>#     ###     #</L>
      <L>##### ##### ###</L>
      <L> #    ##### #</L>
      <L> #  ####### ####</L>
      <L> # $$  ####    #</L>
      <L>## $   ####    #</L>
      <L>#  $       ## ##</L>
      <L>#  $ $$$$$$$   #</L>
      <L>## $ $   # $   #</L>
      <L> # $$$ ### $$$ #</L>
      <L> #     # #@    #</L>
      <L> ####### #######</L>
    </Level>
    <Level Id="lulu gone away" Width="20" Height="14">
      <L>            ####</L>
      <L>            #..##</L>
      <L>           ##...###</L>
      <L>           # .....##</L>
      <L>           # #   ..#</L>
      <L> ########### # $  .#</L>
      <L>##             #  .#</L>
      <L>#   # ###### #$#$  #</L>
      <L># $ #  $     #     #</L>
      <L># $ # $ $  #########</L>
      <L>##$ #$ $ $ #</L>
      <L> #  $  $ @##</L>
      <L> #  #######</L>
      <L> ####</L>
    </Level>
    <Level Id="smart kid" Width="16" Height="14">
      <L> ############</L>
      <L> #  ###     ##</L>
      <L> # $$   $ #  ###</L>
      <L> #  # ###$#$   #</L>
      <L>### #  $    $# #</L>
      <L># $ #    $ # # #</L>
      <L># $ ###### # # #</L>
      <L>#@  ##   $ # $ #</L>
      <L>## $#   $    $ #</L>
      <L> #  # .$  .#####</L>
      <L> #  ##.###.##</L>
      <L> # $*.......#</L>
      <L> #  # ......#</L>
      <L> ############</L>
    </Level>
    <Level Id="zzzz" Width="29" Height="16">
      <L> ############################</L>
      <L> #    ##     ##### ####     #</L>
      <L> # $$    $$$            $$$ #</L>
      <L> #  $$$    $$$$ ### $$$$$   #</L>
      <L> ##   $$$    #    $$$      ##</L>
      <L>  ####  $$$     $$$    ### #</L>
      <L>  #..##   $$$ $$$    ##### #</L>
      <L>###...#     $$$    #   ### ##</L>
      <L>#......###    ###  ### ###  #</L>
      <L>#........###  #@#  ### ###  #</L>
      <L>#...........### ####        #</L>
      <L>##...........#              #</L>
      <L> #########  ## ###### #######</L>
      <L>         #             #</L>
      <L>         #             #</L>
      <L>         ###############</L>
    </Level>
    <Level Id="chimarucu" Width="21" Height="18">
      <L>     ####</L>
      <L>   ###  ########</L>
      <L>   #           ##</L>
      <L>  ## # $ ###$$  #####</L>
      <L>  #  $ # #   $$ $ $ #</L>
      <L>###  $## #$#      $@#</L>
      <L># $ $ #  # # #$ #####</L>
      <L># $$  # $$ $ #  $ $ #</L>
      <L>#    ##      #$ $   #</L>
      <L>#### #########  $   #</L>
      <L> ### .......     $###</L>
      <L> # $ .......#  $  #</L>
      <L> # $$$.####.##$# $##</L>
      <L> #    ..#... $ #   #</L>
      <L> #### ..#...   #####</L>
      <L>  ### ..#...$$$#</L>
      <L>    ###.....   #</L>
      <L>      ##########</L>
    </Level>
    <Level Id="get dizzy" Width="12" Height="18">
      <L> ##########</L>
      <L> #   . .  ##</L>
      <L> # $#. .#$ #</L>
      <L> # $ . . $ #</L>
      <L> # $ . . $ #</L>
      <L> # $ . . $ #</L>
      <L> # $#. .#$ #</L>
      <L> # $ . . $ #</L>
      <L> # $ . . $ #</L>
      <L> # $ . . $ #</L>
      <L> # $#. .#$ #</L>
      <L> # $ . . $ #</L>
      <L> # $ .$. $ #</L>
      <L> # $ .$.@$ #</L>
      <L>###$#.$.#$ #</L>
      <L>#    .$.   #</L>
      <L>#   ########</L>
      <L>#####</L>
    </Level>
    <Level Id="bleep bleep" Width="13" Height="12">
      <L>#########</L>
      <L>#..###  #####</L>
      <L>#....$      #</L>
      <L>#.... $$$## #</L>
      <L>#...#  $ ## #</L>
      <L>#..##$ $ $  #</L>
      <L>##  $  # # ##</L>
      <L>##$# $ $@#$#</L>
      <L> #     ### #</L>
      <L> #$ $#     #</L>
      <L> #   #######</L>
      <L> #####</L>
    </Level>
    <Level Id="mango walk" Width="9" Height="10">
      <L>  ######</L>
      <L>  #@   #</L>
      <L>###$$$ #</L>
      <L>#     ##</L>
      <L>#   $  #</L>
      <L># $#$#.#</L>
      <L># $ $..##</L>
      <L># # ... #</L>
      <L>#####.. #</L>
      <L>    #####</L>
    </Level>
    <Level Id="slimming down" Width="17" Height="11">
      <L>   ######</L>
      <L>  ##    #########</L>
      <L>  #  #          #</L>
      <L> ## # $#$#$#$#  #</L>
      <L>##  #$ #     #$ #</L>
      <L>#  # $ # $ $##  #</L>
      <L># # @$ # $  $  ##</L>
      <L>#  $$#.#..**# ##</L>
      <L>##    ........#</L>
      <L> #########...##</L>
      <L>         #####</L>
    </Level>
    <Level Id="sokodream 1" Width="16" Height="11">
      <L> #####</L>
      <L> #   #</L>
      <L> # # #######</L>
      <L> # #    #..#</L>
      <L> #$ $ $  *.#</L>
      <L> #  #####..#####</L>
      <L> # $  $ # $ .*+#</L>
      <L>##  $   $   .*.#</L>
      <L># $ #####  #####</L>
      <L>#   #   ####</L>
      <L>#####</L>
    </Level>
    <Level Id="sokodream 2" Width="12" Height="10">
      <L>######</L>
      <L>#    #</L>
      <L># ...#</L>
      <L>## # #####</L>
      <L> # # $.  #</L>
      <L> # #  *  ###</L>
      <L> #  $ * $  #</L>
      <L> #@##$#### #</L>
      <L> #         #</L>
      <L> ###########</L>
    </Level>
    <Level Id="sokodream 3" Width="15" Height="16">
      <L> #############</L>
      <L> #  #   #    ##</L>
      <L> # $$ $ #$$ $ #</L>
      <L> #  # # # $ # #</L>
      <L> #  # $     # #</L>
      <L> ## ####### # #</L>
      <L> #  $ $ ....# #</L>
      <L>##      .#..  #</L>
      <L># $$$#####..###</L>
      <L>#    #.*.**.#</L>
      <L>#  $$#......#</L>
      <L>## $@ ####..#</L>
      <L> # $$$ $ ####</L>
      <L> #       #</L>
      <L> ###   ###</L>
      <L>   ######</L>
    </Level>
    <Level Id="nitro one" Width="15" Height="15">
      <L>       ####</L>
      <L> #######  ####</L>
      <L> #         $ #</L>
      <L>##$$##.# $ $ #</L>
      <L>#   #..##$## #</L>
      <L>#  $$$.. $.# #</L>
      <L>##  #  # ... #</L>
      <L> # ##.###.## ##</L>
      <L> # ... #  #   #</L>
      <L> # #.$ ..$$$  #</L>
      <L> # ##$##..#  ##</L>
      <L> # $ $ #.##$ #</L>
      <L> # $       $ #</L>
      <L> ###@ ########</L>
      <L>   ####</L>
    </Level>
    <Level Id="nitro two" Width="16" Height="15">
      <L>################</L>
      <L>#  #  #  #  #  #</L>
      <L>#     #$ #$ #$ #</L>
      <L># $#$    #  #  #</L>
      <L>#  #  #$   $#$ #</L>
      <L># $#$ #  #$    #</L>
      <L>#  #  #$ #  #$ #</L>
      <L>##$## #  #$ #  #</L>
      <L>#  #  ## #  #$ #</L>
      <L>#    $#  ##$#  #</L>
      <L># $#    $#  ## #</L>
      <L>#..#..#.+ .*#  #</L>
      <L>#.*#.*#.*#..   #</L>
      <L>#..#..#..#..#  #</L>
      <L>################</L>
    </Level>
    <Level Id="troepiaal" Width="16" Height="16">
      <L>       ########</L>
      <L>  ######      #</L>
      <L>  #   #  #$##$##</L>
      <L>### #     .$.$ #</L>
      <L>#   $$#$#      #</L>
      <L># $...  #$$#####</L>
      <L># #*.*# #  #</L>
      <L># *...# $. #</L>
      <L>###*.*# #$ #</L>
      <L>#.....# $. #</L>
      <L>##### # $$ #</L>
      <L>    # $ # @#</L>
      <L>    #   ####</L>
      <L>    ##$  #</L>
      <L>     #   #</L>
      <L>     #####</L>
    </Level>
    <Level Id="blenchi" Width="12" Height="10">
      <L>############</L>
      <L>#          #</L>
      <L># $$.**.#$ #</L>
      <L>#  $.#.....#</L>
      <L># #$.*$ #..#</L>
      <L>#  $.# $#..#</L>
      <L>#  $.$@ ####</L>
      <L># $$$$#$#</L>
      <L>#       #</L>
      <L>#########</L>
    </Level>
    <Level Id="totolica" Width="20" Height="15">
      <L>                ####</L>
      <L>            #####@ #</L>
      <L>          ###   #$ #</L>
      <L>          #      $ #</L>
      <L>          #$ $## $ #</L>
      <L>  #########    $ $ #</L>
      <L>###.....  # $$ #$# #</L>
      <L>#...###.# $ #  $ $ #</L>
      <L>#...*.*. #.$$$ #   #</L>
      <L>##......$ # #  #$###</L>
      <L> ######.#   # ##  #</L>
      <L>      #.**  $ $ $ #</L>
      <L>      # # ### $$  #</L>
      <L>      #   # #    ##</L>
      <L>      ##### ######</L>
    </Level>
    <Level Id="warawara" Width="15" Height="18">
      <L>       ####</L>
      <L>       #  #####</L>
      <L>       #   $  #</L>
      <L>       #  $$  #</L>
      <L>       # *# $ #</L>
      <L>       ##.# ###</L>
      <L>   ######+# #</L>
      <L>   #.....*# #</L>
      <L>####.##$..# #</L>
      <L>#  *.# $$#  ###</L>
      <L>#.$  # # $    #</L>
      <L>##.$##     $  #</L>
      <L> #.    ##$### #</L>
      <L> ## $   #     #</L>
      <L>  ### # #######</L>
      <L>    #$# #</L>
      <L>    #   #</L>
      <L>    #####</L>
    </Level>
    <Level Id="moffie" Width="7" Height="18">
      <L> ####</L>
      <L> #  ###</L>
      <L> #  $ #</L>
      <L> # *$ #</L>
      <L> # *  #</L>
      <L> # *$ #</L>
      <L> # *  #</L>
      <L> # *$ #</L>
      <L> # *  #</L>
      <L> # *# #</L>
      <L> # *  #</L>
      <L> # *# #</L>
      <L> # *  #</L>
      <L> # *#@#</L>
      <L>## *  #</L>
      <L># ..$##</L>
      <L># ...#</L>
      <L>######</L>
    </Level>
    <Level Id="moffie 2" Width="7" Height="18">
      <L> ####</L>
      <L> #  ###</L>
      <L> #  $ #</L>
      <L> # *$ #</L>
      <L> # *  #</L>
      <L> # *$ #</L>
      <L> # *  #</L>
      <L> # *$ #</L>
      <L> # *  #</L>
      <L> # *# #</L>
      <L> # *  #</L>
      <L> # *$ #</L>
      <L> # *  #</L>
      <L> # *#@#</L>
      <L>## *  #</L>
      <L># ..*##</L>
      <L># ...#</L>
      <L>######</L>
    </Level>
    <Level Id="moffie 3" Width="7" Height="18">
      <L> ####</L>
      <L> #  ###</L>
      <L> #  $ #</L>
      <L> # *$ #</L>
      <L> # *  #</L>
      <L> # *$ #</L>
      <L> # *  #</L>
      <L> # *$ #</L>
      <L> # *  #</L>
      <L> # *$ #</L>
      <L> # *  #</L>
      <L> # *$ #</L>
      <L> # *  #</L>
      <L> # *#@#</L>
      <L>## *. #</L>
      <L># ..*##</L>
      <L># ...#</L>
      <L>######</L>
    </Level>
    <Level Id="moffie 4" Width="7" Height="18">
      <L> ####</L>
      <L> #  ###</L>
      <L> #  $ #</L>
      <L> # *$ #</L>
      <L> # *  #</L>
      <L> # *$ #</L>
      <L> # *  #</L>
      <L> # *$ #</L>
      <L> # *  #</L>
      <L> # *$ #</L>
      <L> # *  #</L>
      <L> # *$ #</L>
      <L> # *  #</L>
      <L> # *$@#</L>
      <L>##.*. #</L>
      <L># ..*##</L>
      <L># ...#</L>
      <L>######</L>
    </Level>
    <Level Id="sportpark" Width="24" Height="8">
      <L>####</L>
      <L>#  ####################</L>
      <L>#                     ##</L>
      <L># .# # # # # # # # #.  #</L>
      <L>##$$$$$$$$$$$$$$$$$$$$ #</L>
      <L>#@ . . . . . . . . . ###</L>
      <L># . . . . . . . . .  #</L>
      <L>######################</L>
    </Level>
    <Level Id="jungle jane" Width="16" Height="18">
      <L>      ####</L>
      <L> ######  #</L>
      <L> #   $   #</L>
      <L>## $ ### ###</L>
      <L>#  #   $   #</L>
      <L>#.$  $ ### #</L>
      <L>#.#$ #   $ ###</L>
      <L>#. .$  $ #   #</L>
      <L>#. .#$ # ##$ ###</L>
      <L>###. .$  $@    #</L>
      <L>  #.#.#$ # ##$ #</L>
      <L>  ###. .$  $   #</L>
      <L>    #.#.#$ # ###</L>
      <L>    ###. .$  #</L>
      <L>      #.#.#$ #</L>
      <L>      ###.   #</L>
      <L>        #.####</L>
      <L>        ###</L>
    </Level>
    <Level Id="worm" Width="24" Height="9">
      <L>####</L>
      <L>#  #</L>
      <L>#  ####################</L>
      <L>#                     ##</L>
      <L>##.# # # # # # # # #.  #</L>
      <L># $$$$$$$$$$$$$$$$$$$$ #</L>
      <L>#@ . . . . . . . . . ###</L>
      <L># .#.#.#.#.#.#.#.#.# #</L>
      <L>######################</L>
    </Level>
    <Level Id="worms" Width="25" Height="11">
      <L>########################</L>
      <L># .#.#.#.#.#.#.#.#.# # ##</L>
      <L>#  . . . . . . . . .    #</L>
      <L># $$$$$$$$$$$$$$$$$$$$  #</L>
      <L># .# # # # # # # # #. # #</L>
      <L>#                     ###</L>
      <L>##.# # # # # # # # #.  #</L>
      <L># $$$$$$$$$$$$$$$$$$$$ #</L>
      <L>#  . . . . . . . . . ###</L>
      <L>#@.#.#.#.#.#.#.#.#.# #</L>
      <L>######################</L>
    </Level>
    <Level Id="fill up" Width="26" Height="7">
      <L>#########################</L>
      <L>#            .          #</L>
      <L>#  $ # # # # # # # # #  ##</L>
      <L>#  ********** ********** #</L>
      <L>###  # # # # # # # # # $ #</L>
      <L>  #          . @         #</L>
      <L>  ########################</L>
    </Level>
    <Level Id="marathon walk" Width="23" Height="21">
      <L>     ####</L>
      <L>######  ###</L>
      <L>#  $ $    #########</L>
      <L>#   $ $  ##.......#####</L>
      <L>## $ $ $    #.## .....#</L>
      <L> #  $ $ $ ###. #     .#</L>
      <L> # $ $ $            #.#</L>
      <L> #  $ $ $ ##  ## ....##</L>
      <L> # $ $ $   # ### .####</L>
      <L> #### $ $  # ### .#</L>
      <L>    #$ $     ### .#</L>
      <L>    # $ $ ## ### .#</L>
      <L>#####$ $   # ### .#</L>
      <L>#   $ $ $  #   # .#</L>
      <L>#  $ $ $      ## .#####</L>
      <L># $ $ $ $ ##. ## .....#</L>
      <L>#  $ $ $   #.  #     .#</L>
      <L># $ $ $ $  #.  ######.#</L>
      <L>## $ $ $   #. .......##</L>
      <L> #@ ########..########</L>
      <L> ####      ####</L>
    </Level>
    <Level Id="dribble" Width="12" Height="16">
      <L>       #####</L>
      <L> #######   #</L>
      <L>##  #..# $ #</L>
      <L># $ #..# $ #</L>
      <L># $ #..# $ #</L>
      <L># $ #..# $ #</L>
      <L># $ #..# $ #</L>
      <L># $ #..# $ #</L>
      <L># $ #..# $ #</L>
      <L># $ #..# $ #</L>
      <L># $ #..# $ #</L>
      <L># $ #..# $ #</L>
      <L># $ $..$ $ #</L>
      <L># $ #..   ##</L>
      <L># @ #######</L>
      <L>#####</L>
    </Level>
    <Level Id="dribble more" Width="12" Height="16">
      <L>       #####</L>
      <L> #######   #</L>
      <L>##  #..# $ #</L>
      <L># $ #..# $ #</L>
      <L># $ #.*# $ #</L>
      <L># $ #..# $ #</L>
      <L># $ #.*# $ #</L>
      <L># $ #..# $ #</L>
      <L># $ #.*# $ #</L>
      <L># $ #..# $ #</L>
      <L># $ #.*# $ #</L>
      <L># $ #..# $ #</L>
      <L># $ $..*.$ #</L>
      <L># $ #.... ##</L>
      <L># @ #######</L>
      <L>#####</L>
    </Level>
    <Level Id="dribble final" Width="12" Height="16">
      <L>       #####</L>
      <L>########   #</L>
      <L>#   #..#$$ #</L>
      <L># $ #...   #</L>
      <L># $ #.*#$$ #</L>
      <L># $ #..#   #</L>
      <L># $ #.*#$$ #</L>
      <L># $ #..#   #</L>
      <L># $ #.*#$$ #</L>
      <L># $ #..#   #</L>
      <L># $ #**#*$ #</L>
      <L># $ #..#.  #</L>
      <L># $ $..**$ #</L>
      <L># $$#.... ##</L>
      <L># @ #######</L>
      <L>#####</L>
    </Level>
    <Level Id="rampage" Width="22" Height="13">
      <L>  ######</L>
      <L> ##    ####</L>
      <L> # $ $    #</L>
      <L>## $@$### #######</L>
      <L>#  $$       $   #</L>
      <L>#  $  $ $ $ ### #</L>
      <L>##   ########   #</L>
      <L> ##           ########</L>
      <L>  ##$####$$##  $     #</L>
      <L>   # .......*.*  ##$ #</L>
      <L>   #####....#..###   #</L>
      <L>       ##..##### #####</L>
      <L>        ####</L>
    </Level>
    <Level Id="bringamosa" Width="15" Height="13">
      <L>          #####</L>
      <L>          #.. #</L>
      <L>       ####.$ #</L>
      <L>       #....$ #</L>
      <L>       #....$ #</L>
      <L>########....$ #</L>
      <L>#.........# $ #</L>
      <L>########$$$$$ #</L>
      <L># $         $ #</L>
      <L># $ #    $$$$ #</L>
      <L># $$$$$$$#    #</L>
      <L>#       @######</L>
      <L>##########</L>
    </Level>
    <Level Id="big one" Width="9" Height="23">
      <L>  #####</L>
      <L>  #   #</L>
      <L> ##$@$#</L>
      <L> # .*.#</L>
      <L> #  * #</L>
      <L> ## * #</L>
      <L>  # * #</L>
      <L>  # * #</L>
      <L>  # * #</L>
      <L>  # * #</L>
      <L>  # * #</L>
      <L>  # * #</L>
      <L>  # * #</L>
      <L>  # * #</L>
      <L>  # * #</L>
      <L>  # * #</L>
      <L>  # * #</L>
      <L> ## * #</L>
      <L> #  $ #</L>
      <L> #  $ ###</L>
      <L>###..* ##</L>
      <L>###    ##</L>
      <L>#########</L>
    </Level>
    <Level Id="double one" Width="15" Height="23">
      <L> #####   #####</L>
      <L> #   #   #   #</L>
      <L>##$@$#  ##   #</L>
      <L>#  $ #  #  . #</L>
      <L>#  $ #  #... #</L>
      <L>## $ #  ## . #</L>
      <L> # $ #   # . #</L>
      <L> # $ #   # . #</L>
      <L> # $ #   # . #</L>
      <L> # $ #   # . #</L>
      <L> # $ #   # . #</L>
      <L> # $ #   # . #</L>
      <L> # $ #   # . #</L>
      <L> # $ #   # . #</L>
      <L> # $ #   # . #</L>
      <L> # $ #   # . #</L>
      <L> # $ #   # . #</L>
      <L>## $ ##### . #</L>
      <L>#  $       . #</L>
      <L>#  $ ####$#. ##</L>
      <L># $ $#    ... #</L>
      <L>##     ####   #</L>
      <L>###############</L>
    </Level>
    <Level Id="dancing cat" Width="13" Height="13">
      <L>  #########</L>
      <L>  #  #    #</L>
      <L>###    ## ##</L>
      <L>#   $ $ #  #</L>
      <L># $   # ## ##</L>
      <L># $$#$# .. .#</L>
      <L>#  $@  ##...#</L>
      <L>## $#   #...#</L>
      <L> # $ $$$#.#.#</L>
      <L> # $    #...#</L>
      <L> ###$$ $ ..##</L>
      <L>   #       #</L>
      <L>   #########</L>
    </Level>
    <Level Id="polar beer" Width="17" Height="12">
      <L> ########</L>
      <L>##      ###</L>
      <L>#  ##$#$$ #######</L>
      <L>#            $  #</L>
      <L># $$##$ $ $ $#$ #</L>
      <L>#  $    $ $  $@ #</L>
      <L># $ # *####. $ ##</L>
      <L># #$##......####</L>
      <L># # # ..#.###</L>
      <L># # $$.....#</L>
      <L># #   .....#</L>
      <L>############</L>
    </Level>
    <Level Id="lafayette" Width="25" Height="14">
      <L>#########           ####</L>
      <L>#       ###      ####  #</L>
      <L># $$$  $  ########    $##</L>
      <L># #   ### ####     $$$$ #</L>
      <L># # ###    ##  $ $$$    #</L>
      <L># $   $  #$#   $$$..##..#</L>
      <L># $ ## $ $   $$$  #..#..#</L>
      <L>#   #  $   $$$  ..#*.#..#</L>
      <L># $#     $$$....##.*....#</L>
      <L># $   $$$  ###.......#..#</L>
      <L># $  $   #####....#######</L>
      <L># $$$@####  ###.......#</L>
      <L>#    ##       #########</L>
      <L>######</L>
    </Level>
    <Level Id="solver in trouble?" Width="20" Height="22">
      <L>####################</L>
      <L>#                  #</L>
      <L># .#########$#$#$# #</L>
      <L># .................#</L>
      <L>#..###############$#</L>
      <L>#..#               #</L>
      <L>#..# $ $ $ $$ $  $ #</L>
      <L>#..# $$$$$$  $$ $$ #</L>
      <L>#..#      $   $  $ #</L>
      <L>#..#@ $ $ $ $ $ $  #</L>
      <L>##.######## ########</L>
      <L> #          #</L>
      <L> #  ####### ##</L>
      <L> #       ##  #</L>
      <L> ## #  #   $ #</L>
      <L> #       # ###</L>
      <L> # #   #     #</L>
      <L> #   ### ### #</L>
      <L> ###         #</L>
      <L>   # #### ####</L>
      <L>   #      #</L>
      <L>   ########</L>
    </Level>
    <Level Id="black diamond" Width="16" Height="14">
      <L>   ####</L>
      <L>   #..#####</L>
      <L> ###*.....###</L>
      <L>##.*..*.$.. #</L>
      <L>#.....$.$.#$####</L>
      <L>#.*.#$#$###  $ #</L>
      <L>#..#.          #</L>
      <L>#######$$$$$$ ##</L>
      <L>     #  $ $ $ #</L>
      <L>     #      $ #</L>
      <L>     #@$ $ $$ #</L>
      <L>     ###$$$$  #</L>
      <L>       #      #</L>
      <L>       ########</L>
    </Level>
    <Level Id="carnaval 2009" Width="21" Height="16">
      <L>      ######</L>
      <L>      #   @#</L>
      <L>#######$$$$######</L>
      <L>#          $    #</L>
      <L># $$$##$# #####.#</L>
      <L>#   $ $   $    .#</L>
      <L>###     $  $$ #.#####</L>
      <L>  ###$$##$$#  #.#...#</L>
      <L>  #   $ $  # $#.#...#</L>
      <L>  # #$#   $#  #.#...#</L>
      <L>  # #  #   $  #.#...#</L>
      <L>  #   $ # $###......#</L>
      <L>  # #         .....##</L>
      <L>  # ## #$$ $###   ##</L>
      <L>  #    #    # #####</L>
      <L>  ###########</L>
    </Level>
    <Level Id="trampoline" Width="19" Height="14">
      <L>        #####</L>
      <L>#########   ######</L>
      <L>#        $$      #</L>
      <L># #$####  $ #### #</L>
      <L># #    ####$#  $ ##</L>
      <L># ##$$@   $ $ ##  #</L>
      <L># #  ###  $       #</L>
      <L># #.....#$$$ $# ###</L>
      <L># #..... $ $  # #</L>
      <L># #.....$  $ ## ##</L>
      <L># #..... #####   #</L>
      <L># ######       $ #</L>
      <L>#        #########</L>
      <L>##########</L>
    </Level>
    <Level Id="alice in wonderland" Width="26" Height="19">
      <L>    ##############</L>
      <L> ####            ####</L>
      <L> #     $            #####</L>
      <L>##  $#$$$$$$$ $ $ $     #</L>
      <L>#    #   $    ######  $ #</L>
      <L>#  $##$$   ###.....# $##</L>
      <L>#   #    ##........#  #</L>
      <L>#  $##  ##.........#$ ###</L>
      <L>#    # #........###     ##</L>
      <L>#  #    .....####  $ $$  #</L>
      <L>#  ###   .####   $    ####</L>
      <L>#    ### #####$      ##</L>
      <L>##           #  $### #</L>
      <L> #      ###    $ # ###</L>
      <L>##$$$# ## #$ $$  #  ##</L>
      <L>#    # #  #  $  ##</L>
      <L>## $   #  # $  ##</L>
      <L> ##   ##  ##@ ##</L>
      <L>  #####    ####</L>
    </Level>
    <Level Id="backup moves" Width="24" Height="18">
      <L> #############</L>
      <L> #           ####</L>
      <L> #$#$#$#$#$# $  ###</L>
      <L> # # # # # # # $  ###</L>
      <L>## #         # # $  ###</L>
      <L>#     $ $ $      # $  #</L>
      <L>#   $  # ##  #     #$ #</L>
      <L>##   ###  ##$  #      #</L>
      <L> # $##  $  #   # $  #$#</L>
      <L>##  # $  $ # $ ###    ##</L>
      <L>#  ##  $  @###  ##  $ .#</L>
      <L># $ $ #####..* $### # .#</L>
      <L>#     $ $ #...   #   ..#</L>
      <L>##        ##..   ......#</L>
      <L> ## $ $ $  #.....#..#.##</L>
      <L>  ######   ##.#......##</L>
      <L>       ##      #######</L>
      <L>        #########</L>
    </Level>
  </LevelCollection>
</SokobanLevels>
