<?xml version="1.0" encoding="utf-8"?>
<SokobanLevels xmlns:xsi="http://www.w3.org/2001/XMLSchema-instance" xsi:schemaLocation="SokobanLev.xsd">
  <Title>Chuchubi 12</Title>
  <Description>
Chuchubi 12 last set for this year. Enjoy.
  </Description>
  <Email>serenata@setarnet.aw</Email>
  <LevelCollection Copyright="Eric F Tchong" MaxWidth="42" MaxHeight="31">
    <Level Id="double safari" Width="30" Height="17">
      <L> ####</L>
      <L> #  #</L>
      <L> #  #######################</L>
      <L> #                        #</L>
      <L> ##*##$#$#$#$#$#$#$#$#$#  ####</L>
      <L> # ......                    #</L>
      <L> # **************************#</L>
      <L> ##.* * * * * * * * * * * *. #</L>
      <L>  #+                       .##</L>
      <L> #########$#$#$#$########## #</L>
      <L>##.                       . #</L>
      <L># .* * * * * * * * * * * *.##</L>
      <L>#************************** #</L>
      <L>#                  ........ #</L>
      <L>####  #$#$#$#$#$#$#$#$#$##*##</L>
      <L>   #                        #</L>
      <L>   ##########################</L>
    </Level>
    <Level Id="mind therapy" Width="39" Height="20">
      <L>#######################################</L>
      <L>#                  @                  #</L>
      <L># #### $ #### #### $ #### #### $ #### #</L>
      <L># #  # $ #  # #  # $ #  # #  # $ #  # #</L>
      <L># #### $ #### # ## $ ## # #### $ #### #</L>
      <L># #         ###         ###         # #</L>
      <L>#   $ $ $         $$$         $ $ $   #</L>
      <L># $$$ $#$ $$$ $$$  #  $$$ $$$ $#$ $$$ #</L>
      <L>#   $ $ $   #.#   $$$   #.#   $ $ $   #</L>
      <L># #      ####.#  $   $  #.####      # #</L>
      <L># #### $ #  #.# $# $ #$ #.#  # $ #### #</L>
      <L># #  # $ #  #.#  # $ #  #.#  # $ #  # #</L>
      <L># #### $ ####.#### $ ####.#### $ #### #</L>
      <L>#            .     .     .            #</L>
      <L>#############.####...####.#############</L>
      <L>          #...#####.#####...#</L>
      <L>          #. ............. .#</L>
      <L>          #. ..####.####.. .#</L>
      <L>          #. ............. .#</L>
      <L>          ###################</L>
    </Level>
    <Level Id="stuff the robot" Width="25" Height="28">
      <L>     ###############</L>
      <L>     #     # #     #</L>
      <L>     #  $$$   $$$  #</L>
      <L>    #  $   #$#   $  #</L>
      <L>   #  $ $ $   $ $ $  #</L>
      <L>  #  $    $ $ $    $  #</L>
      <L>##  $ ##$$$#.#$$$## $  ##</L>
      <L>#  $  #    #.#    #  $  #</L>
      <L># $   $ $  #.#  $ $   $ #</L>
      <L>## $  $  ###.###  $  $ ##</L>
      <L> #  $  #####.#####  $  #</L>
      <L> ##  $ ####...#### $  ##</L>
      <L>   #  $ ##. * .## $  #</L>
      <L>    #   ##. + .##   #</L>
      <L>    ######. # .######</L>
      <L>         #. # .#</L>
      <L>         #. # .#</L>
      <L>         #. # .#</L>
      <L>        ##. # .##</L>
      <L>        #..   ..#</L>
      <L>        #.......#</L>
      <L>        #.#####.#</L>
      <L>        #.#   #.#</L>
      <L>        #.#   #.#</L>
      <L>        #.#   #.#</L>
      <L>        #.#   #.#</L>
      <L>        #.#   #.#</L>
      <L>        ###   ###</L>
    </Level>
    <Level Id="apple pie" Width="13" Height="11">
      <L>#####   #####</L>
      <L>#  ######   #</L>
      <L># $#    $ $ #</L>
      <L># $   $   ###</L>
      <L>#  ##$#*..#</L>
      <L># $   ....#</L>
      <L>#  # $##..##</L>
      <L>##@#$ .    #</L>
      <L> # #  ###  #</L>
      <L> ###  # ####</L>
      <L>   ####</L>
    </Level>
    <Level Id="rock a bye baby" Width="14" Height="14">
      <L>######</L>
      <L>#    #</L>
      <L># #@ #########</L>
      <L># # *. #   # #</L>
      <L># ##..   $ $ #</L>
      <L>#  #..$$#  . #</L>
      <L># $#....#... #</L>
      <L>#  $.## ## . #</L>
      <L>#   ## $ $ ###</L>
      <L># $  $     #</L>
      <L>####$#$# ###</L>
      <L>  #  $ $ $ #</L>
      <L>  #        #</L>
      <L>  ##########</L>
    </Level>
    <Level Id="game fudge" Width="12" Height="13">
      <L>  ######</L>
      <L>  #    ####</L>
      <L>### *  $  #</L>
      <L>#   *  *  ##</L>
      <L># ***  *** #</L>
      <L>### ****   #</L>
      <L>  # *@ *   #</L>
      <L> ## *  *   #</L>
      <L> #  ****   #</L>
      <L> #  *  *   #</L>
      <L> #***  *** #</L>
      <L> #    .    #</L>
      <L> ###########</L>
    </Level>
    <Level Id="game fudge 2" Width="12" Height="13">
      <L>  #######</L>
      <L>  # .   ###</L>
      <L>### *# *  #</L>
      <L>#   *  *  ##</L>
      <L># ***  *** #</L>
      <L>### ****   #</L>
      <L>  # *@ * $ #</L>
      <L> ## *  * $ #</L>
      <L> #. **** $ #</L>
      <L> #  *  *   #</L>
      <L> #***  *** #</L>
      <L> #    .    #</L>
      <L> ###########</L>
    </Level>
    <Level Id="T problem" Width="12" Height="11">
      <L>######</L>
      <L>#   @#</L>
      <L># $$$####</L>
      <L>#       ####</L>
      <L>##$###$$$  #</L>
      <L># .....    #</L>
      <L># . .$.$ $ #</L>
      <L>### . ######</L>
      <L>  # .$#</L>
      <L>  # . #</L>
      <L>  #####</L>
    </Level>
    <Level Id="3 key rooms" Width="27" Height="15">
      <L>###########################</L>
      <L>#                         #</L>
      <L># $$$###$$$##.##$$$###$$$ #</L>
      <L># #                     # #</L>
      <L># # $$$######$######$$$ # #</L>
      <L># #        ## ##        # #</L>
      <L># ##$###$$$ $ $ $$$###$## #</L>
      <L># # .....    *    ..... # #</L>
      <L># # ...*.$ $ * $ $.*... # #</L>
      <L># ###...#####.#####...### #</L>
      <L># $ ...*#####.#####*... $ #</L>
      <L># $ #...#####.#####...# $ #</L>
      <L># $$#########.#########$$ #</L>
      <L>#            @            #</L>
      <L>###########################</L>
    </Level>
    <Level Id="xmas lilly" Width="11" Height="10">
      <L> ##########</L>
      <L> #        #</L>
      <L>##$###### #</L>
      <L>#   $ #@# #</L>
      <L>#  $...   #</L>
      <L># #$..$ ###</L>
      <L>## ...# #</L>
      <L> # #$$$ #</L>
      <L> #    ###</L>
      <L> ######</L>
    </Level>
    <Level Id="mango market" Width="21" Height="18">
      <L> ######### #########</L>
      <L> #       # #       #</L>
      <L> # $$$$$$# #$$$$$$ #</L>
      <L>## $  $  ###  $  $ ##</L>
      <L>#  $             $  #</L>
      <L>#  ###$$##.##$$###  #</L>
      <L>##.#.#  #.*.#  #.#.##</L>
      <L> #...#$ # . # $#...#</L>
      <L> #...#  # . #  #...#</L>
      <L> #...#$ ##*## $#...#</L>
      <L> # $   $ #.# $   $ #</L>
      <L>## $$$$  #.#  $$$$ ##</L>
      <L>#       $ $ $       #</L>
      <L>#..$ $ $  @  $ $ $..#</L>
      <L>#..###*.#####.*###..#</L>
      <L>#### #..#   #..# ####</L>
      <L>     #..#   #..#</L>
      <L>     ####   ####</L>
    </Level>
    <Level Id="fishy" Width="16" Height="12">
      <L> ############</L>
      <L> #          #</L>
      <L> #$ #$$#$## #</L>
      <L> #  #  #  # #</L>
      <L> #$ #$ #$ #$####</L>
      <L>##  #  #  #  $ #</L>
      <L># $  $@#*..* $ #</L>
      <L># $$# $....#   #</L>
      <L>#     #..*   # #</L>
      <L>##### ....######</L>
      <L>    ###...#</L>
      <L>      #####</L>
    </Level>
    <Level Id="evelina" Width="12" Height="12">
      <L>     ######</L>
      <L>    ##    #</L>
      <L>   ## $## #</L>
      <L> ###...$  ##</L>
      <L> # ...# $  #</L>
      <L>## $..# $  #</L>
      <L># $#..# $$ #</L>
      <L>#  $..# $  #</L>
      <L>## #.####$ #</L>
      <L> # @ $ $   #</L>
      <L> ###      ##</L>
      <L>   ########</L>
    </Level>
    <Level Id="margo" Width="15" Height="9">
      <L>    ##########</L>
      <L>    #...     ##</L>
      <L>   ##***$$$   #</L>
      <L>   #....  $## #</L>
      <L>####.#.#  $   #</L>
      <L>#@ $$$$$ #$ ###</L>
      <L># $       $ #</L>
      <L>#####....#  #</L>
      <L>    #########</L>
    </Level>
    <Level Id="diary" Width="15" Height="17">
      <L>    ###########</L>
      <L>    #    #    #</L>
      <L> #### $$$#$$$ #</L>
      <L> #  #    #    #</L>
      <L>## $# $$$#$$$ #</L>
      <L># $ $         #</L>
      <L># $ ##$#.######</L>
      <L>#      #.$  ..#</L>
      <L>####$ $#.####.#</L>
      <L> #     $.# $..#</L>
      <L> #  $   .#  ..#</L>
      <L> #### ##.$...##</L>
      <L>   #  ##. .# #</L>
      <L>  ## $# .#*# #</L>
      <L>  # $ # *... #</L>
      <L>  #@  # ....##</L>
      <L>  ############</L>
    </Level>
    <Level Id="typsy transport" Width="28" Height="31">
      <L>############################</L>
      <L>#                          #</L>
      <L># ##########$#$########### #</L>
      <L>#                          #</L>
      <L># #########$$#$$$######### #</L>
      <L>#            #             #</L>
      <L># #######$$$$#$$$$$####### #</L>
      <L>#            #             #</L>
      <L># #####$$$$$$#$$$$$$$##### #</L>
      <L>#            #             #</L>
      <L># ###$$$$$$$$#$$$$$$$$$### #</L>
      <L>#            #             #</L>
      <L># #$$$$$$$$$$#$$$$$$$$$$$# #</L>
      <L>#            #             #</L>
      <L>#$$$$$$$$$$$$#$$$$$$$$$$$$$#</L>
      <L>#            #             #</L>
      <L>#............#.............#</L>
      <L>#            #             #</L>
      <L># #..........#...........# #</L>
      <L># #          #           # #</L>
      <L># ###........#.........### #</L>
      <L># #          #           # #</L>
      <L># #####......#.......##### #</L>
      <L># #          #           # #</L>
      <L># #######....#.....####### #</L>
      <L># #          #           # #</L>
      <L># #########..#...######### #</L>
      <L># #          #           # #</L>
      <L># ##########.#.########### #</L>
      <L>#            @             #</L>
      <L>############################</L>
    </Level>
    <Level Id="game room" Width="17" Height="16">
      <L>      #####</L>
      <L>     ##   #</L>
      <L>    ##  $ #</L>
      <L>#####   #######</L>
      <L>#  ## $     #.#</L>
      <L># $##$ $# $ #.#</L>
      <L>#  ## $ # # #.##</L>
      <L>## ##   # # #..#</L>
      <L> # ## $ #$$ #..#</L>
      <L> # #  # # $ #..#</L>
      <L> # # $# # $ #..#</L>
      <L>## ##@# #   #..#</L>
      <L>#  ##$# #  ##..##</L>
      <L>#     $         #</L>
      <L>##  #   #####   #</L>
      <L>#########   #####</L>
    </Level>
    <Level Id="4 rounds to go" Width="15" Height="23">
      <L>#####     #####</L>
      <L>#   #######   #</L>
      <L># $         $ #</L>
      <L># $$.# # #.$$ #</L>
      <L>#  .$     $.  #</L>
      <L># $$.# # #.$$ #</L>
      <L># $.$#.#.#$.$ #</L>
      <L>#  $.  #  .$  #</L>
      <L>###.$# # #$.###</L>
      <L>  #  #.#.#  #</L>
      <L>  #    .    #</L>
      <L>  ##...@...##</L>
      <L>  #    .    #</L>
      <L>  #  #.#.#  #</L>
      <L>###.$# # #$.###</L>
      <L>#  $.  #  .$  #</L>
      <L># $.$#.#.#$.$ #</L>
      <L># $$.# # #.$$ #</L>
      <L>#  .$     $.  #</L>
      <L># $$.# # #.$$ #</L>
      <L># $         $ #</L>
      <L>#   #######   #</L>
      <L>#####     #####</L>
    </Level>
    <Level Id="just push" Width="12" Height="14">
      <L> #######</L>
      <L>##     #####</L>
      <L># $$$$     #</L>
      <L># $  $$$$$ #</L>
      <L># $......$ #</L>
      <L># $.#....$ #</L>
      <L># $......$ #</L>
      <L># $ ..#..$ #</L>
      <L># $$...#.$ #</L>
      <L># #..... $ #</L>
      <L># $   $$$  #</L>
      <L>#  $$$$   ##</L>
      <L>##@     ###</L>
      <L> ########</L>
    </Level>
    <Level Id="3 times 4" Width="13" Height="13">
      <L>##########</L>
      <L>#        #</L>
      <L># # ### ##</L>
      <L># # $   ##</L>
      <L># #$ $ ###</L>
      <L>#   $  $@#</L>
      <L>##### $ $###</L>
      <L>    #  $   ##</L>
      <L>    ## ..*  #</L>
      <L>     ##.*.$ #</L>
      <L>      #..*# #</L>
      <L>      #...###</L>
      <L>      #####</L>
    </Level>
    <Level Id="small" Width="15" Height="6">
      <L>##########</L>
      <L>#       @######</L>
      <L># $*$*$*$*....#</L>
      <L>#             #</L>
      <L>##  ###########</L>
      <L> ####</L>
    </Level>
    <Level Id="medium" Width="15" Height="6">
      <L>##########</L>
      <L>#       @######</L>
      <L># $$$$****....#</L>
      <L>#             #</L>
      <L>##  ###########</L>
      <L> ####</L>
    </Level>
    <Level Id="large" Width="42" Height="7">
      <L>##########################################</L>
      <L>#                                    @#  #</L>
      <L># $$$$$$$$$$$$$$$$$$$$$$$$$$$**********..#</L>
      <L># $                          ............#</L>
      <L>#######################################..#</L>
      <L>                            #............#</L>
      <L>                            ##############</L>
    </Level>
    <Level Id="extra large" Width="25" Height="20">
      <L>  ######################</L>
      <L>  #                    #</L>
      <L>  # $$$$$$$$$$$$$$$$$$ #</L>
      <L>  #                 @$ #</L>
      <L>###################### #</L>
      <L>#                      #</L>
      <L># $$$$$$$$$$$$$$$$$$$$ #</L>
      <L>#                    $ #</L>
      <L>###################### #</L>
      <L>#                      #</L>
      <L># $$$$$$$$$$$$$$$$$$$$ #</L>
      <L>#                    $ #</L>
      <L>###################### #</L>
      <L>#. #................   #</L>
      <L>#..***************** ..#</L>
      <L>#...................##.##</L>
      <L>#..################.##. #</L>
      <L>#............#    #.... #</L>
      <L>##############    #  ####</L>
      <L>                  ####</L>
    </Level>
    <Level Id="round up" Width="19" Height="15">
      <L>          #######</L>
      <L>      #####     ##</L>
      <L>#######  #  $    #</L>
      <L>#     #     $ $  ##</L>
      <L># $   #  ##### $  #</L>
      <L>## $  #      ## $ #</L>
      <L> ###$ #.......# $ #</L>
      <L>   # $ .......# $ #</L>
      <L>   #$@#......## $ #</L>
      <L>   # $##....##  $ #</L>
      <L>  ##$  ######   $ #</L>
      <L>  #              ##</L>
      <L>  ## $$ $$ $ $ $ #</L>
      <L>   ##     ########</L>
      <L>    #######</L>
    </Level>
    <Level Id="round up 2" Width="19" Height="15">
      <L>          #######</L>
      <L>      #####     ##</L>
      <L>#######  ## $ #  #</L>
      <L>#     #     $ $  ##</L>
      <L># $  $#  ##### $  #</L>
      <L>## $  #      ## $ #</L>
      <L> ###$ #.......# $ #</L>
      <L>   #   .......# $ #</L>
      <L>   #$ #......## $ #</L>
      <L>   #  ##....### $ #</L>
      <L>  ##$  #######  $ #</L>
      <L>  # @$           ##</L>
      <L>  ## $$ $$ $ $ $ #</L>
      <L>   ##     ########</L>
      <L>    #######</L>
    </Level>
    <Level Id="power lift" Width="28" Height="15">
      <L>              ######   #####</L>
      <L>              #    #   #...#</L>
      <L>############### $$$#####...#</L>
      <L>#     #   #     $ $    #...#</L>
      <L># $$ $$   $ $ #  $  #  #...#</L>
      <L>#  $ $  ### # #     # ##...#</L>
      <L>#  $$$  ##  $ ### $$#$ $...#</L>
      <L>#      ##   #####   # $#...#</L>
      <L>#####  $  ###   $ $ # @#...#</L>
      <L> # $  # $   #  ## ######...#</L>
      <L> #  $ #$##  $  ## *........#</L>
      <L> #  # #  $ #$# #           #</L>
      <L> ## $        $ #   #####   #</L>
      <L>  #  #######   #####   #####</L>
      <L>  ####     #####</L>
    </Level>
    <Level Id="melon pie" Width="14" Height="15">
      <L>############</L>
      <L>#          #</L>
      <L>### $#$$+#.#</L>
      <L>  #   $ .#.#</L>
      <L>  # ######.###</L>
      <L>###   $  #...#</L>
      <L># $$ $$ $#*..#</L>
      <L># $ $    $...#</L>
      <L># $$..##$# .##</L>
      <L>#   ..## ## #</L>
      <L>### ####  $ #</L>
      <L> #          #</L>
      <L> # $ ########</L>
      <L> #   #</L>
      <L> #####</L>
    </Level>
    <Level Id="egg roll" Width="10" Height="10">
      <L>  ####</L>
      <L>  #  ###</L>
      <L>### $$ ###</L>
      <L>#..$  $  #</L>
      <L>#.. $@#  #</L>
      <L>#.*$### ##</L>
      <L>#..     #</L>
      <L>### #$###</L>
      <L>  #   #</L>
      <L>  #####</L>
    </Level>
    <Level Id="tangerine" Width="12" Height="13">
      <L>###########</L>
      <L>#         #</L>
      <L># $$$$$$$ #</L>
      <L># $.....$ ##</L>
      <L>##..$$$$.. #</L>
      <L> #.*.$.$$. #</L>
      <L> #.$ . @$. #</L>
      <L> #.$* .$$. #</L>
      <L> #..$$$$.. #</L>
      <L> ##....... #</L>
      <L>  ##$$$$$ ##</L>
      <L>   #      #</L>
      <L>   ########</L>
    </Level>
    <Level Id="smarties" Width="20" Height="13">
      <L>               ####</L>
      <L>          ######  #</L>
      <L>     ###### $     #</L>
      <L> #####   #  $ ##  #</L>
      <L> #   $ #$$  # $   #</L>
      <L> # #$# .$. $###$# ##</L>
      <L> #   #$.*.         #</L>
      <L>### #  .*..# ##### #</L>
      <L>#      ....#$    $ #</L>
      <L># $### ###.#  $  $ #</L>
      <L>#   # $ # .####$$  #</L>
      <L>#####  @# ......####</L>
      <L>    #############</L>
    </Level>
    <Level Id="tropical storm" Width="15" Height="12">
      <L>####</L>
      <L># .#########</L>
      <L># *        ##</L>
      <L># .#$#### $ #</L>
      <L>##.# $  #$ $###</L>
      <L> #............#</L>
      <L> #.#$$# # $ $ #</L>
      <L> #.$@  #  # $ #</L>
      <L> #. $$ #  $ ###</L>
      <L> #.$ $ $$$$ #</L>
      <L> #.        ##</L>
      <L> ###########</L>
    </Level>
    <Level Id="chapel" Width="11" Height="13">
      <L>   #####</L>
      <L>  ## . ##</L>
      <L> ##  *  ##</L>
      <L>##  * *  ##</L>
      <L>#  *   *  #</L>
      <L># *     * #</L>
      <L># * *** * #</L>
      <L># * *@* * #</L>
      <L># * *$* * #</L>
      <L># *     * #</L>
      <L># ******* #</L>
      <L>#         #</L>
      <L>###########</L>
    </Level>
    <Level Id="chapel 2" Width="11" Height="13">
      <L>   #####</L>
      <L>  ## . ##</L>
      <L> ##  *  ##</L>
      <L>##  * *  ##</L>
      <L>#  *   *  #</L>
      <L># *     * #</L>
      <L># * *** * #</L>
      <L># * *@* * #</L>
      <L># * *** * #</L>
      <L># *     * #</L>
      <L># ***$*** #</L>
      <L>#         #</L>
      <L>###########</L>
    </Level>
    <Level Id="side walk 1" Width="25" Height="11">
      <L>   ###################</L>
      <L>  ##        #        ##</L>
      <L> ##  ****** # ******  ##</L>
      <L>##  *     * # *     *  ##</L>
      <L>#  *  *** * # * ***  *  #</L>
      <L>#.*   * * *   * *@*   $ #</L>
      <L>#  *  *** * # * ***  *  #</L>
      <L>##  *     * # *     *  ##</L>
      <L> ##  ****** # ******  ##</L>
      <L>  ##        #        ##</L>
      <L>   ###################</L>
    </Level>
    <Level Id="side walk 2" Width="25" Height="11">
      <L>   ###################</L>
      <L>  ##        #        ##</L>
      <L> ##  ****** $ ******  ##</L>
      <L>##  *     * # *     *  ##</L>
      <L>#  *  *** * # * ***  *  #</L>
      <L>#.*   * * *   * *@*   *.#</L>
      <L>#  *  *** * # * ***  *  #</L>
      <L>##  *     * # *     *  ##</L>
      <L> ##  ****** $ ******  ##</L>
      <L>  ##        #        ##</L>
      <L>   ###################</L>
    </Level>
    <Level Id="mixim" Width="21" Height="14">
      <L>      ########</L>
      <L>      #      #</L>
      <L>      # ####$#######</L>
      <L>      # # .........#</L>
      <L> ###### # ....##...#</L>
      <L> #    # *.*..###...#</L>
      <L>##$$  # ##.#.###...#</L>
      <L>#     # $ .*.####..#</L>
      <L>##$#$## # $##### $ ##</L>
      <L># $ $ $ $ $ $ $ $   #</L>
      <L>#       $     $@$$$ #</L>
      <L># $ $ $  $$$$$$$    #</L>
      <L>#########         ###</L>
      <L>        ###########</L>
    </Level>
    <Level Id="grave digger" Width="31" Height="12">
      <L>  ######               ######</L>
      <L>  #    #               #    #</L>
      <L>  #$$$ ###  #######  ### $$$#</L>
      <L>  #  $   ####..+..####   $  #</L>
      <L>  #  $$$      $*$      $$$  #</L>
      <L>  #$   $$$$$$$$.$$$$$$$$   $#</L>
      <L>  #  .....#.#.#.#.#.#.....  #</L>
      <L>  #$ ######. ..... .###### $#</L>
      <L>###  .......#######.......  ###</L>
      <L># $$ $ $ # .#     #. # $ $ $$ #</L>
      <L>#     #######     #######     #</L>
      <L>#######                 #######</L>
    </Level>
    <Level Id="lunar lander" Width="32" Height="25">
      <L>   ######</L>
      <L>   #    #</L>
      <L>#### $$ ######</L>
      <L>#            #</L>
      <L># $ $ $ $$$$ ######</L>
      <L># $ $ $           ###########</L>
      <L># $ $ $ $$$$ $ $         #  #</L>
      <L>######$    # $ $ $$$$$$$ #  ##</L>
      <L>     #     # $ $ $     $     #</L>
      <L>     #$$$$ ########### $ $$$ #</L>
      <L>  ####      ##.......# $ $ $ #</L>
      <L>  # $ $$$ $$#........# $ $ $ #</L>
      <L>  # $     $ #........# $ $ $ #</L>
      <L>  #   $ $   #.......## $ $ $ #</L>
      <L>  ####### $$#####...#  $ $ $ #</L>
      <L>        # $ $ $ #...## $ $ $ ##</L>
      <L>        #   $ $ ##...# $ $@$  ##</L>
      <L>        ### $ $ ##...# $ $$$   #</L>
      <L>          #     ##...# $     $ #</L>
      <L>       ##########....# $$$$# $ #</L>
      <L>       #.............#       $##</L>
      <L>       #.............#######  #</L>
      <L>       #....................  #</L>
      <L>       ###########   ##########</L>
      <L>                 #####</L>
    </Level>
    <Level Id="paradise island" Width="32" Height="20">
      <L>       ################</L>
      <L>       #              #####</L>
      <L>       # $$ $ $ $  $   $  #</L>
      <L>  ######$  $ $ $ $ $ $  $ ###</L>
      <L>###    # $ #####  $#### $   ####</L>
      <L>#   $$ #  $  $ # $ #  # $ # $ @#</L>
      <L>#   $  # $ #   #   #  # $ #  $ #</L>
      <L>### $$$#$  ## $#####$ #     $  #</L>
      <L>  #      $  # $  $ $  # $ ######</L>
      <L> ##$####  $ #         # $ #</L>
      <L>## $        #  ######## $ #</L>
      <L>#  $ ########$ # $ $ $  $ #</L>
      <L># $$ #          ....... # ##</L>
      <L># $  # #########....... $  #</L>
      <L>#    # #.......#...######$ #</L>
      <L>###### #.......######.. $  #</L>
      <L>     # #...............    #</L>
      <L>     # ######$$#...... #####</L>
      <L>     #         #......##</L>
      <L>     ##################</L>
    </Level>
    <Level Id="bahia" Width="28" Height="16">
      <L>######       ###############</L>
      <L>#    #       #    #   #    #</L>
      <L># # $###     # $ $$$$ $$ $ #</L>
      <L># #    ####### $        $$ #</L>
      <L># ##$           $  $ $ $#  #</L>
      <L>#  # $ ***** #    # $   #$ #</L>
      <L># $$   *      #$###$##$ #  #</L>
      <L>#  ### $  $   #      $  #  #</L>
      <L>## #   $ $#.#.#  $$$ ####$ #</L>
      <L># $  $ #  #.#.$$ $   $     #</L>
      <L>#   #######.#.# $$ $ $ $ $ #</L>
      <L>#####     #.#.#    #   #  @#</L>
      <L>       ####.#.##############</L>
      <L>       #.... ..............#</L>
      <L>       #.... ..............#</L>
      <L>       #####################</L>
    </Level>
    <Level Id="general store" Width="14" Height="16">
      <L>       #####</L>
      <L>       #@  ##</L>
      <L>       # $  #</L>
      <L>     ###  $ #</L>
      <L> #####.##$  #</L>
      <L> #    .   $##</L>
      <L> #  $#.##  #</L>
      <L> ##  #..* $###</L>
      <L>  # $#*.#  # #</L>
      <L>  #  ...*$   #</L>
      <L>  #$ #..# ## #</L>
      <L>  #  $... $  #</L>
      <L>###. #   ## ##</L>
      <L># $ $#$#$#  #</L>
      <L>#          ##</L>
      <L>############</L>
    </Level>
    <Level Id="DOD" Width="22" Height="20">
      <L> ####################</L>
      <L> #     #      #     #</L>
      <L> # $$$   $$$$   $$$ #</L>
      <L> # $  $ $    $ $  $ #</L>
      <L> # $ $  $ ## $  $ $ #</L>
      <L> # $ $  $ ## $  $ $ #</L>
      <L> # $ $  $ ## $  $ $ #</L>
      <L> # $  $ $    $#$  $ #</L>
      <L> # $$$   $$$$ # $$$ #</L>
      <L> #    ##      #     #</L>
      <L>################### ##</L>
      <L>#...           ...   #</L>
      <L>#.##.###....  .##.   #</L>
      <L>#. . ##.    .  . . ###</L>
      <L>#. .   . #  .  . . #</L>
      <L>#. .   . #  .  . . #</L>
      <L>#.  .##. #  .#.  . #</L>
      <L>#...@##.    .##...##</L>
      <L>####### ....#######</L>
      <L>      #######</L>
    </Level>
    <Level Id="nice two" Width="13" Height="13">
      <L>          ###</L>
      <L>  ######### #</L>
      <L>  #.......$ #</L>
      <L>  ### # #$# #</L>
      <L>  # $$$$$ # #</L>
      <L>###.    $.# #</L>
      <L>#  .$$@$$.  #</L>
      <L># #.$    .###</L>
      <L># # $$$$$ #</L>
      <L># #$# # ###</L>
      <L># $.......#</L>
      <L># #########</L>
      <L>###</L>
    </Level>
    <Level Id="go left" Width="13" Height="10">
      <L> ####</L>
      <L> #  ####</L>
      <L> # $   #</L>
      <L>##  #$$######</L>
      <L>#   #       #</L>
      <L># #$#$$ $ $@#</L>
      <L>#  ....$#####</L>
      <L>## *..* #</L>
      <L> ###... #</L>
      <L>   ######</L>
    </Level>
    <Level Id="tea house" Width="9" Height="11">
      <L>#######</L>
      <L>#.....#</L>
      <L>#.*...#</L>
      <L>####  #</L>
      <L>#  #$$###</L>
      <L>#  $    #</L>
      <L># $#$$# #</L>
      <L>## $ $  #</L>
      <L>#@$    ##</L>
      <L>####   #</L>
      <L>   #####</L>
    </Level>
    <Level Id="tea tower" Width="12" Height="15">
      <L>   #######</L>
      <L>####     #</L>
      <L>#    #$$ #</L>
      <L># #### $ #</L>
      <L>#.     $ #</L>
      <L>#..... $ #</L>
      <L>#.#    $ #</L>
      <L>### #*#$ #</L>
      <L> #  #. $ #</L>
      <L> #  $. $ #</L>
      <L> ## #.#$ ###</L>
      <L>  # ...$   #</L>
      <L>  ##.*.$$$ #</L>
      <L>   ##   @###</L>
      <L>    ######</L>
    </Level>
    <Level Id="trap suite" Width="13" Height="14">
      <L>   ######</L>
      <L> ###    #</L>
      <L> # $ ##.#</L>
      <L> # $  ..#</L>
      <L> #@$ #..#</L>
      <L>## $ #..#</L>
      <L>#  $ #..#####</L>
      <L>#  $##..#   #</L>
      <L>###       $ #</L>
      <L>  # $ $ # $ #</L>
      <L>  ####  ##  #</L>
      <L>     ## # $ #</L>
      <L>      #     #</L>
      <L>      #######</L>
    </Level>
    <Level Id="in less pushes" Width="25" Height="23">
      <L>     #####   ########</L>
      <L>   ###   #  ##      #</L>
      <L>   #  $  # ##  #### #</L>
      <L>   # $#$ ###  ##  # #</L>
      <L>   #   $     $$  $# #</L>
      <L>   #   # $$$$$  $ $ #</L>
      <L>   # # $  $     #   #</L>
      <L>   # $  #   # $ #####</L>
      <L>   # ##  $ ## ###  ######</L>
      <L>   # $  $#$ #           #</L>
      <L>   ##$ #      $###$ $$# #</L>
      <L>   # $ $  # #  ###  $ # #</L>
      <L>   # $### #   ###   $   #</L>
      <L>   #   #  #$#####$ ## ###</L>
      <L> ####  # #@ #####  .#  .#</L>
      <L> #    $# $  #.......###.#</L>
      <L> # #$  ## #.#...........#</L>
      <L> #   $  $ ###...........#</L>
      <L>###  #    #########...#.#</L>
      <L># $ ##########    ##..#.#</L>
      <L># # #             #######</L>
      <L>#   #</L>
      <L>#####</L>
    </Level>
    <Level Id="parlor of dices" Width="20" Height="11">
      <L> ############</L>
      <L>##          ########</L>
      <L># $ $ $ $ $  ......#</L>
      <L>#  $ $ $ $   .####.#</L>
      <L># $ $ $ $ $ #.#  #.#</L>
      <L>#  $  #######.#  #.#</L>
      <L># $#$##     #.## #.#</L>
      <L>#  $ # $$$$ #. ###.#</L>
      <L>## $ # $  $  * ....#</L>
      <L> #  @#      #. ....#</L>
      <L> ###################</L>
    </Level>
  </LevelCollection>
</SokobanLevels>
