<?xml version="1.0" encoding="utf-8"?>
<SokobanLevels xmlns:xsi="http://www.w3.org/2001/XMLSchema-instance" xsi:schemaLocation="SokobanLev.xsd">
  <Title>Classic</Title>
  <Description>
Collection containing puzzles with various types of strategies, used
over the years that I play Sokoban
  </Description>
  <Email>jhogloria@hotmail.com</Email>
  <LevelCollection Copyright="Jorge Gloria" MaxWidth="16" MaxHeight="15">
    <Level Id="#01" Width="14" Height="12">
      <L>##############</L>
      <L>#   #   #    #</L>
      <L># # #$$ #  + #</L>
      <L># # # $ #  #.#</L>
      <L># $     #. . #</L>
      <L># # #$$ #  #.#</L>
      <L># # #   #  . #</L>
      <L># # ###### ###</L>
      <L>#            #</L>
      <L>########## # #</L>
      <L>         #   #</L>
      <L>         #####</L>
    </Level>
    <Level Id="#02" Width="15" Height="11">
      <L> #############</L>
      <L> #...# @ #...#</L>
      <L> #.  # # #  .#</L>
      <L> #           #</L>
      <L> #  ## # ##  #</L>
      <L>###### # ######</L>
      <L>#   #  #  #   #</L>
      <L># $    #    $ #</L>
      <L># $$#$ # $#$$ #</L>
      <L>#   #     #   #</L>
      <L>###############</L>
    </Level>
    <Level Id="#03" Width="13" Height="8">
      <L>      #####</L>
      <L>#######   #</L>
      <L>#         #</L>
      <L># $$#$#*# ###</L>
      <L>#   #.....  #</L>
      <L># $$#$#.### #</L>
      <L>#   #  @    #</L>
      <L>#############</L>
    </Level>
    <Level Id="#04" Width="9" Height="10">
      <L>####</L>
      <L># @#</L>
      <L>#  ######</L>
      <L>#  #  #.#</L>
      <L># $#$ * #</L>
      <L># $.. . #</L>
      <L># $## . #</L>
      <L>#   ##$##</L>
      <L>#     $.#</L>
      <L>#########</L>
    </Level>
    <Level Id="#05" Width="11" Height="10">
      <L> #####</L>
      <L> #   #</L>
      <L> # $ ######</L>
      <L>## #  $   #</L>
      <L>#  ...$#$ #</L>
      <L>#  @..    #</L>
      <L>## # ######</L>
      <L> # $ #</L>
      <L> #   #</L>
      <L> #####</L>
    </Level>
    <Level Id="#06" Width="8" Height="8">
      <L> ######</L>
      <L>##  .+#</L>
      <L>#   **##</L>
      <L># #.$  #</L>
      <L># $ $  #</L>
      <L>###  ###</L>
      <L>  #  #</L>
      <L>  ####</L>
    </Level>
    <Level Id="#07" Width="9" Height="7">
      <L> #######</L>
      <L>  #  .  #</L>
      <L>###.$#$ #</L>
      <L># . .$  #</L>
      <L>#@#.$$*##</L>
      <L>#      #</L>
      <L>########</L>
    </Level>
    <Level Id="#08" Width="8" Height="7">
      <L>  ####</L>
      <L> ##. ###</L>
      <L>## . $ #</L>
      <L>#  .**@#</L>
      <L># $  $ #</L>
      <L>#####  #</L>
      <L>    ####</L>
    </Level>
    <Level Id="#09" Width="11" Height="9">
      <L>###########</L>
      <L>#    @    #</L>
      <L># $#*#.#$ #</L>
      <L>#  * ..*  #</L>
      <L># $# # #$ #</L>
      <L>#  *.. *  #</L>
      <L># $#.#*#$ #</L>
      <L>#         #</L>
      <L>###########</L>
    </Level>
    <Level Id="#10" Width="7" Height="11">
      <L>  ####</L>
      <L>  #  #</L>
      <L>  #  #</L>
      <L>  #$ #</L>
      <L> ## $##</L>
      <L> #  $ #</L>
      <L> #... #</L>
      <L>##$ ###</L>
      <L># . #</L>
      <L>#  @#</L>
      <L>#####</L>
    </Level>
    <Level Id="#11" Width="11" Height="6">
      <L>#######</L>
      <L># .* .#####</L>
      <L>#      $@ #</L>
      <L>#### $*   #</L>
      <L>   #  #####</L>
      <L>   ####</L>
    </Level>
    <Level Id="#12" Width="8" Height="7">
      <L> #####</L>
      <L> # @ #</L>
      <L> #$#$###</L>
      <L>## . $ #</L>
      <L>#  .*# #</L>
      <L>#  .   #</L>
      <L>########</L>
    </Level>
    <Level Id="#13" Width="11" Height="7">
      <L>       ####</L>
      <L>    ####@ #</L>
      <L>#####   . #</L>
      <L>#   $*$ * #</L>
      <L>#    . ####</L>
      <L>#####  #</L>
      <L>    ####</L>
    </Level>
    <Level Id="#14" Width="10" Height="8">
      <L>    #####</L>
      <L>   ##   #</L>
      <L>#### $  #</L>
      <L>#  $   ##</L>
      <L>#  @$###</L>
      <L>###.$.####</L>
      <L>  #    ..#</L>
      <L>  ########</L>
    </Level>
    <Level Id="#15" Width="11" Height="10">
      <L>    #######</L>
      <L>#####  .  #</L>
      <L>#   $@.## #</L>
      <L>#   ## ## #</L>
      <L>##  #     #</L>
      <L> ### $. # #</L>
      <L>  #   $   #</L>
      <L>  #  ##   #</L>
      <L>  #  ######</L>
      <L>  ####</L>
    </Level>
    <Level Id="#16" Width="8" Height="7">
      <L>#####</L>
      <L>#.. ####</L>
      <L># .$   #</L>
      <L>##  $  #</L>
      <L> ###@$ #</L>
      <L>   ##  #</L>
      <L>    ####</L>
    </Level>
    <Level Id="#17" Width="11" Height="10">
      <L>    #######</L>
      <L>#####  .. #</L>
      <L>#         #</L>
      <L>#  $.###  #</L>
      <L>###$ ######</L>
      <L>  #  #@#</L>
      <L>  ## $ #</L>
      <L> ###$$ #</L>
      <L> #.  . #</L>
      <L> #######</L>
    </Level>
    <Level Id="#18" Width="10" Height="9">
      <L>######</L>
      <L>#.#  ####</L>
      <L>#....   ##</L>
      <L># # ##   #</L>
      <L># # $    #</L>
      <L># ##$$ $ #</L>
      <L>#  $ #####</L>
      <L>#  #@#</L>
      <L>######</L>
    </Level>
    <Level Id="#19" Width="11" Height="8">
      <L>  #########</L>
      <L>###@ .....#</L>
      <L>#  $$## # #</L>
      <L>#   $   # #</L>
      <L>## $  $## #</L>
      <L> #####    #</L>
      <L>     ###  #</L>
      <L>       ####</L>
    </Level>
    <Level Id="#20" Width="11" Height="10">
      <L>      #####</L>
      <L>  #####.#.#</L>
      <L>###   ....#</L>
      <L>#  $ ## # #</L>
      <L>#     $ # #</L>
      <L>##    $## #</L>
      <L> #  # $@$ #</L>
      <L> ## ##$#  #</L>
      <L>  #    ####</L>
      <L>  ######</L>
    </Level>
    <Level Id="#21" Width="10" Height="8">
      <L>### #####</L>
      <L>#.###   #</L>
      <L># # * $ ##</L>
      <L># *  #  .#</L>
      <L># #$   . #</L>
      <L>#@$  ## ##</L>
      <L>###  $ .#</L>
      <L>  #######</L>
    </Level>
    <Level Id="#22" Width="7" Height="9">
      <L>  #####</L>
      <L>###  .#</L>
      <L># . $.#</L>
      <L>#  $$$#</L>
      <L>###$+ #</L>
      <L>  # $##</L>
      <L> ##  #</L>
      <L> #. .#</L>
      <L> #####</L>
    </Level>
    <Level Id="#23" Width="9" Height="8">
      <L>#########</L>
      <L>#. . #@ #</L>
      <L>#  *$$$*#</L>
      <L>#     $ #</L>
      <L>##.$###.#</L>
      <L> #  # ###</L>
      <L> ##.#</L>
      <L>  ###</L>
    </Level>
    <Level Id="#24" Width="10" Height="10">
      <L>######</L>
      <L># .  #</L>
      <L>#.$# ##</L>
      <L>#*$ $ ####</L>
      <L>#@* .  ..#</L>
      <L># ## $ ###</L>
      <L>#  $ # #</L>
      <L>### *$.#</L>
      <L>  ##   #</L>
      <L>   #####</L>
    </Level>
    <Level Id="#25" Width="7" Height="10">
      <L>######</L>
      <L>#   .##</L>
      <L># . *.#</L>
      <L># $$.##</L>
      <L>### .#</L>
      <L> # $ #</L>
      <L> #   #</L>
      <L> ##$$##</L>
      <L> #@ $.#</L>
      <L> ######</L>
    </Level>
    <Level Id="#26" Width="11" Height="7">
      <L>#########</L>
      <L>#  . .$.###</L>
      <L># ##$.  $@#</L>
      <L>#  # $  ###</L>
      <L>#     ###</L>
      <L>#    ##</L>
      <L>######</L>
    </Level>
    <Level Id="#27" Width="11" Height="10">
      <L>     #####</L>
      <L>    ##  @#</L>
      <L>   ##   $#</L>
      <L>  ##     #</L>
      <L> ##     $#</L>
      <L> # . ##  ##</L>
      <L>##   .#   #</L>
      <L>#.  # $   #</L>
      <L>########  #</L>
      <L>       ####</L>
    </Level>
    <Level Id="#28" Width="11" Height="10">
      <L>   ####</L>
      <L>   #  #</L>
      <L> ###  #</L>
      <L>##   $#####</L>
      <L>#..  .##  #</L>
      <L>#   $   $@#</L>
      <L>####  ## ##</L>
      <L>   ##*#   #</L>
      <L>    #     #</L>
      <L>    #######</L>
    </Level>
    <Level Id="#29" Width="11" Height="10">
      <L>    #######</L>
      <L>    #.    #</L>
      <L>   ##$#   #</L>
      <L>#### .## ##</L>
      <L>#   $     #</L>
      <L>#..   ##  #</L>
      <L>##   $##  #</L>
      <L> ###$ #####</L>
      <L>   #@ #</L>
      <L>   ####</L>
    </Level>
    <Level Id="#30" Width="8" Height="10">
      <L>     ###</L>
      <L>  ####.#</L>
      <L>  #..$ #</L>
      <L>  # $$ #</L>
      <L>  #.$  #</L>
      <L>  # #$.#</L>
      <L>###   ##</L>
      <L># *$*###</L>
      <L>#. . $@#</L>
      <L>########</L>
    </Level>
    <Level Id="#31" Width="7" Height="7">
      <L>  #####</L>
      <L> ## @ #</L>
      <L> # $#.#</L>
      <L>##  $ #</L>
      <L># $ # #</L>
      <L># ..  #</L>
      <L>#######</L>
    </Level>
    <Level Id="#32" Width="7" Height="8">
      <L>#######</L>
      <L>#     #</L>
      <L># $ $ #</L>
      <L>#...# #</L>
      <L>#.#$$ #</L>
      <L># * @##</L>
      <L>#  ###</L>
      <L>####</L>
    </Level>
    <Level Id="#33" Width="10" Height="9">
      <L>    ####</L>
      <L>  ###  ###</L>
      <L>  #  @   #</L>
      <L>  #$#.$. #</L>
      <L>### $  ###</L>
      <L># . .#$#</L>
      <L>#      #</L>
      <L>###  ###</L>
      <L>  ####</L>
    </Level>
    <Level Id="#34" Width="10" Height="8">
      <L> #######</L>
      <L>##   @ ##</L>
      <L>#   .*  ##</L>
      <L># $*$ *  #</L>
      <L>#  #.*#$ #</L>
      <L>## .$ . ##</L>
      <L> ##    ##</L>
      <L>  ######</L>
    </Level>
    <Level Id="#35" Width="15" Height="10">
      <L>       ########</L>
      <L>########..    #</L>
      <L>#      ###@## #</L>
      <L># $$$$  .. .. #</L>
      <L>#      ### ####</L>
      <L># $$$$ #      #</L>
      <L>#      # .  . #</L>
      <L># $$$$ # .... #</L>
      <L>#      #      #</L>
      <L>###############</L>
    </Level>
    <Level Id="#36" Width="16" Height="10">
      <L>################</L>
      <L>#              #</L>
      <L># $ $$$##$$$ $ #</L>
      <L>###  # .  #  ###</L>
      <L>  ## .    * ##</L>
      <L>   ## #**# ##</L>
      <L>    ##....##</L>
      <L>     ##.+##</L>
      <L>      ####</L>
      <L>       ##</L>
    </Level>
    <Level Id="#37" Width="9" Height="10">
      <L>#########</L>
      <L>#       #</L>
      <L># $ $ $ #</L>
      <L># ### $ #</L>
      <L># $.$ # #</L>
      <L># .*. $ #</L>
      <L># #*# ###</L>
      <L>#.$.$.#</L>
      <L>#. + .#</L>
      <L>#######</L>
    </Level>
    <Level Id="#38" Width="11" Height="9">
      <L>#####</L>
      <L>#   ##</L>
      <L>#    ######</L>
      <L>#.# $##   #</L>
      <L>##      $ #</L>
      <L># $ #..  ##</L>
      <L>#@$.###  #</L>
      <L>##  # ####</L>
      <L> ####</L>
    </Level>
    <Level Id="#39" Width="11" Height="11">
      <L>  #########</L>
      <L> ##.#.  $ #</L>
      <L> #    # $ #</L>
      <L> #   ###  #</L>
      <L>##. $ ### #</L>
      <L>#   # ### #</L>
      <L>#  # $ +# #</L>
      <L>##    $#  #</L>
      <L> #  #     #</L>
      <L> ##    # .#</L>
      <L>  #########</L>
    </Level>
    <Level Id="#40" Width="12" Height="11">
      <L>#######</L>
      <L>#     #</L>
      <L>#  .@.#</L>
      <L>##    ####</L>
      <L>### .  #.#</L>
      <L>#   ##   ###</L>
      <L>#    .  $  #</L>
      <L>##.#   $$  #</L>
      <L> #  # $$ $##</L>
      <L> ##       #</L>
      <L>  #########</L>
    </Level>
    <Level Id="#41" Width="16" Height="15">
      <L>########</L>
      <L>#      # #####</L>
      <L>#  .# $###   #</L>
      <L>#  ### #@$ # #</L>
      <L>#  #    $  $ #</L>
      <L>#.    $ #### ###</L>
      <L>#  .  ###  #   #</L>
      <L>#     .#   # $ #</L>
      <L># $ #  ##### $ #</L>
      <L>###       ## $ #</L>
      <L>  ####    ## $ #</L>
      <L>     ####      #</L>
      <L>      #...   ###</L>
      <L>      #... ###</L>
      <L>      ######</L>
    </Level>
    <Level Id="#42" Width="9" Height="10">
      <L> #######</L>
      <L> #.+$ .#</L>
      <L> ##$$$###</L>
      <L> ## #   #</L>
      <L>##  *   #</L>
      <L>#.  .####</L>
      <L>###$  #</L>
      <L>  #   #</L>
      <L>  #   #</L>
      <L>  #####</L>
    </Level>
    <Level Id="#43" Width="9" Height="11">
      <L> ######</L>
      <L> # .. #</L>
      <L> # *@$###</L>
      <L> ##$#   #</L>
      <L>  # *   #</L>
      <L>  # $####</L>
      <L>  #.  #</L>
      <L>  #   #</L>
      <L>###$  #</L>
      <L>#.    #</L>
      <L>#######</L>
    </Level>
    <Level Id="#44" Width="10" Height="10">
      <L>       ###</L>
      <L>########.#</L>
      <L># .    $@#</L>
      <L># * $ # $#</L>
      <L>##   ###.#</L>
      <L> #.# # ###</L>
      <L>##$  #</L>
      <L># $ ##</L>
      <L># . #</L>
      <L>#####</L>
    </Level>
    <Level Id="#45" Width="11" Height="10">
      <L>   ########</L>
      <L>   #. .. .#</L>
      <L>   # .   ##</L>
      <L>   ##.  ##</L>
      <L>##### $ #</L>
      <L># $   ###</L>
      <L>#@$$$ ##</L>
      <L>##   $ #</L>
      <L> ##    #</L>
      <L>  ######</L>
    </Level>
    <Level Id="#46" Width="12" Height="6">
      <L> ####</L>
      <L> #  ########</L>
      <L>##..  .  $ #</L>
      <L># $ $ $ $@ #</L>
      <L># . ######.#</L>
      <L>#####    ###</L>
    </Level>
    <Level Id="#47" Width="12" Height="7">
      <L>####   ####</L>
      <L>#  #####@.#</L>
      <L>#    *  **##</L>
      <L>#      $$  #</L>
      <L>#######.$. #</L>
      <L>      ###  #</L>
      <L>        ####</L>
    </Level>
    <Level Id="#48" Width="10" Height="10">
      <L>    #####</L>
      <L>   ## ..##</L>
      <L>   # *.$ #</L>
      <L>  ##     #</L>
      <L>###  $$ ##</L>
      <L>#.    ###</L>
      <L>###*$##</L>
      <L>  #  #</L>
      <L>  #@ #</L>
      <L>  ####</L>
    </Level>
    <Level Id="#49" Width="10" Height="10">
      <L>  ######</L>
      <L>  #..  ###</L>
      <L>  ### $@ #</L>
      <L>    # $  #</L>
      <L>  ### ####</L>
      <L>  #.  ####</L>
      <L>###$$    #</L>
      <L>#  $ #$  #</L>
      <L>#.   . . #</L>
      <L>##########</L>
    </Level>
    <Level Id="#50" Width="8" Height="12">
      <L>####</L>
      <L>#  ##</L>
      <L># $ ##</L>
      <L>#   .#</L>
      <L>##$ $#</L>
      <L> #   ##</L>
      <L> ## $@#</L>
      <L>  # .$##</L>
      <L>  ##$..#</L>
      <L>   #  .#</L>
      <L>   ## .#</L>
      <L>    ####</L>
    </Level>
    <Level Id="#51" Width="12" Height="12">
      <L>        ####</L>
      <L>  #######  #</L>
      <L>###  ## $  #</L>
      <L>#   . # $  #</L>
      <L>#     #  $##</L>
      <L>#### ## $$ #</L>
      <L>#### #   $ #</L>
      <L>#        #@#</L>
      <L>#.  ..######</L>
      <L>#.#####</L>
      <L>#.#</L>
      <L>###</L>
    </Level>
    <Level Id="#52" Width="10" Height="7">
      <L>#########</L>
      <L>#..##   #</L>
      <L># ..$$ $##</L>
      <L>#     .$ #</L>
      <L>#####$.$@#</L>
      <L>    #  ###</L>
      <L>    ####</L>
    </Level>
    <Level Id="#53" Width="12" Height="11">
      <L>      ######</L>
      <L>####  #    #</L>
      <L># @#  # $  #</L>
      <L># #####  ###</L>
      <L># # $ $ ###</L>
      <L># $       #</L>
      <L>##$###.#  ##</L>
      <L>#   #      #</L>
      <L>#   $.## ..#</L>
      <L>#  ##.##.###</L>
      <L>##########</L>
    </Level>
    <Level Id="#54" Width="8" Height="11">
      <L>   #####</L>
      <L>   #. +#</L>
      <L>#####$*#</L>
      <L>#.   . #</L>
      <L>## $$  #</L>
      <L> ### ###</L>
      <L>  #. $ #</L>
      <L>  #    #</L>
      <L>  # $  #</L>
      <L>  ###  #</L>
      <L>    ####</L>
    </Level>
    <Level Id="#55" Width="12" Height="12">
      <L>     ####</L>
      <L>     #  #</L>
      <L>     #  #</L>
      <L>     #  #</L>
      <L>     ## #</L>
      <L>  ##### #</L>
      <L> ##  #  ####</L>
      <L> #   #$ ...#</L>
      <L>##    $ ####</L>
      <L># $$ #*$####</L>
      <L>#    #@  ..#</L>
      <L>############</L>
    </Level>
    <Level Id="#56" Width="10" Height="10">
      <L> #####</L>
      <L> #  .####</L>
      <L> #   *. #</L>
      <L> # $ #  #</L>
      <L>###   $.#</L>
      <L>#   ### #</L>
      <L># $$#.#*##</L>
      <L>###   $ +#</L>
      <L>  ##   ###</L>
      <L>   #####</L>
    </Level>
    <Level Id="#57" Width="9" Height="11">
      <L>###</L>
      <L>#.####</L>
      <L>#.##.####</L>
      <L>#+$ .# .#</L>
      <L># $* #$ #</L>
      <L>### #   #</L>
      <L> #  $  $#</L>
      <L> # .#$$ #</L>
      <L> ##     #</L>
      <L>  #     #</L>
      <L>  #######</L>
    </Level>
    <Level Id="#58" Width="11" Height="9">
      <L>##########</L>
      <L># $     .#</L>
      <L># $ $   ##</L>
      <L>#  $  ####</L>
      <L>#  $$#  .#</L>
      <L>###. $$.##</L>
      <L>  #  #  .##</L>
      <L>  #### .+.#</L>
      <L>     ######</L>
    </Level>
    <Level Id="#59" Width="12" Height="8">
      <L>   ######</L>
      <L>  ##  . ####</L>
      <L>  #@$ $ .  #</L>
      <L>  # * # $# #</L>
      <L>  ##* #  $ #</L>
      <L>###  #  $###</L>
      <L>#.   *.   .#</L>
      <L>############</L>
    </Level>
    <Level Id="#60" Width="10" Height="9">
      <L>  ######</L>
      <L>  #.# .##</L>
      <L>  #. . .#</L>
      <L> ##$ $$ ##</L>
      <L>##  $#.  #</L>
      <L>#@$$ #   #</L>
      <L># $. #   #</L>
      <L>###  #####</L>
      <L>  ####</L>
    </Level>
    <Level Id="#61" Width="15" Height="10">
      <L>  ######</L>
      <L>  #  ..#</L>
      <L>  # $ ##  #####</L>
      <L>  ###.#####   #</L>
      <L>   #   ##     #</L>
      <L>####  $## #*###</L>
      <L>#@*  $$.    #</L>
      <L>#$$  .##   ##</L>
      <L>#. #########</L>
      <L>####</L>
    </Level>
    <Level Id="#62" Width="10" Height="8">
      <L>      ####</L>
      <L>   ####+ #</L>
      <L>   #  #$$#</L>
      <L>####$ # .#</L>
      <L>#     $  #</L>
      <L># *$ *.* #</L>
      <L>#. .  #  #</L>
      <L>##########</L>
    </Level>
    <Level Id="#63" Width="8" Height="9">
      <L> ######</L>
      <L> #   .#</L>
      <L> #*$@##</L>
      <L>##.$####</L>
      <L>#     .#</L>
      <L>#$.$$$ #</L>
      <L>#  #  .#</L>
      <L>#. #.$ #</L>
      <L>########</L>
    </Level>
    <Level Id="#64" Width="8" Height="10">
      <L>  ###</L>
      <L>  #.#</L>
      <L>### #</L>
      <L>#. $###</L>
      <L>#.* $@##</L>
      <L>#  $.$ #</L>
      <L>#.$$#  #</L>
      <L># . #$ #</L>
      <L>## .  ##</L>
      <L> ######</L>
    </Level>
    <Level Id="#65" Width="9" Height="9">
      <L>#####</L>
      <L># @ #####</L>
      <L># $$#.. #</L>
      <L>##      #</L>
      <L>#. $#..##</L>
      <L>##$ #$ ##</L>
      <L> #  #   #</L>
      <L> #  #   #</L>
      <L> ########</L>
    </Level>
    <Level Id="#66" Width="9" Height="9">
      <L>########</L>
      <L>#   #  ##</L>
      <L>#   $   #</L>
      <L>##  $   #</L>
      <L> #$ ##  #</L>
      <L> #  #####</L>
      <L> #*$ @ .#</L>
      <L> #   ...#</L>
      <L> ########</L>
    </Level>
    <Level Id="#67" Width="10" Height="10">
      <L>###</L>
      <L>#.########</L>
      <L># ... #@ #</L>
      <L>#  #  $$$#</L>
      <L>##  #  $ #</L>
      <L> #. .#  .#</L>
      <L>## #  $  #</L>
      <L>#   $$ ###</L>
      <L>#   #  #</L>
      <L>########</L>
    </Level>
    <Level Id="#68" Width="9" Height="8">
      <L>#########</L>
      <L>#   #   #</L>
      <L># $    $#</L>
      <L>#  $ #  #</L>
      <L>#  # * .#</L>
      <L>####$$*##</L>
      <L>  #...+#</L>
      <L>  ######</L>
    </Level>
    <Level Id="#69" Width="11" Height="11">
      <L>#####</L>
      <L>#.  #</L>
      <L>#.  ####</L>
      <L>##. #@ #</L>
      <L> # .#$ #</L>
      <L> # #  $##</L>
      <L> # #$ $ #</L>
      <L>##$#  # ##</L>
      <L>#    .$  ##</L>
      <L>#.  ## $ .#</L>
      <L>###########</L>
    </Level>
    <Level Id="#70" Width="10" Height="11">
      <L>   ######</L>
      <L>####    #</L>
      <L>#  #    #</L>
      <L>#.*$  ####</L>
      <L>#@ # $   #</L>
      <L>#.$# $   #</L>
      <L>#. ### $##</L>
      <L>#. # #$.#</L>
      <L>#.## #  #</L>
      <L>###  #  #</L>
      <L>     ####</L>
    </Level>
    <Level Id="#71" Width="11" Height="10">
      <L>###</L>
      <L>#.#########</L>
      <L>#    .#...#</L>
      <L># $ ###. ##</L>
      <L>##  #    #</L>
      <L># $$#  $ #</L>
      <L># $   $###</L>
      <L># @# $. #</L>
      <L>#####   #</L>
      <L>    #####</L>
    </Level>
    <Level Id="#72" Width="11" Height="10">
      <L>   #####</L>
      <L>   # . ##</L>
      <L>####    ###</L>
      <L>#  $.$$   #</L>
      <L># . $#  $ #</L>
      <L>#    ## $ #</L>
      <L>#@  .# $###</L>
      <L>###    .#</L>
      <L>  # ..###</L>
      <L>  #####</L>
    </Level>
    <Level Id="#73" Width="11" Height="7">
      <L>#### #####</L>
      <L>#  ###   ##</L>
      <L># $  $*...#</L>
      <L>#  $**+$  #</L>
      <L>#     #####</L>
      <L>#    ##</L>
      <L>######</L>
    </Level>
    <Level Id="#74" Width="8" Height="11">
      <L>  #####</L>
      <L>  # . #</L>
      <L>  # .$##</L>
      <L>  #$.  #</L>
      <L>  # .  #</L>
      <L>  #$.###</L>
      <L>### .#</L>
      <L>#@$$ ##</L>
      <L># $   #</L>
      <L>###   #</L>
      <L>  #####</L>
    </Level>
    <Level Id="#75" Width="11" Height="11">
      <L>##########</L>
      <L>#  #     #</L>
      <L>#.$#     #</L>
      <L>#.*.. ####</L>
      <L>#.$## #  #</L>
      <L>#. #  $ $##</L>
      <L># $#      #</L>
      <L>#  #### # #</L>
      <L># $#  # # #</L>
      <L># @#  #   #</L>
      <L>####  #####</L>
    </Level>
    <Level Id="#76" Width="10" Height="9">
      <L>####</L>
      <L>#  #####</L>
      <L># $@$  ###</L>
      <L># $# $.  #</L>
      <L>#   #$...#</L>
      <L>#     $* #</L>
      <L>#######..#</L>
      <L>      #  #</L>
      <L>      ####</L>
    </Level>
    <Level Id="#77" Width="10" Height="9">
      <L>#########</L>
      <L>#@*.... #</L>
      <L># $  *# ##</L>
      <L>#### .#$ #</L>
      <L> ##    $ #</L>
      <L> # $#$   #</L>
      <L> #      ##</L>
      <L> ###   ##</L>
      <L>   #####</L>
    </Level>
    <Level Id="#78" Width="10" Height="10">
      <L>     #####</L>
      <L>  #### . #</L>
      <L>  #.  ...#</L>
      <L>###$$##  #</L>
      <L>#    #@**#</L>
      <L>#  $ $   #</L>
      <L>#  #  ####</L>
      <L>### $ #</L>
      <L>  #   #</L>
      <L>  #####</L>
    </Level>
    <Level Id="#79" Width="10" Height="9">
      <L>   ####</L>
      <L>   #  ###</L>
      <L>  ##  * ##</L>
      <L>  #   $.@#</L>
      <L> ##*$#.. #</L>
      <L>##    ##.#</L>
      <L># $$    ##</L>
      <L>#     * #</L>
      <L>#########</L>
    </Level>
    <Level Id="#80" Width="10" Height="10">
      <L>  #####</L>
      <L>  #   ###</L>
      <L>###   $ #</L>
      <L>#  # $ .#</L>
      <L># $##$$@#</L>
      <L>#..   $###</L>
      <L>#####. . #</L>
      <L>    #  $ #</L>
      <L>    ## ..#</L>
      <L>     #####</L>
    </Level>
    <Level Id="#81" Width="8" Height="8">
      <L> #####</L>
      <L> #   ###</L>
      <L> #  $  #</L>
      <L> # ..# #</L>
      <L>##$#*..#</L>
      <L>#    $$#</L>
      <L>#   #@ #</L>
      <L>########</L>
    </Level>
  </LevelCollection>
</SokobanLevels>
