<?xml version="1.0" encoding="utf-8"?>
<SokobanLevels xmlns:xsi="http://www.w3.org/2001/XMLSchema-instance" xsi:schemaLocation="SokobanLev.xsd">
  <Title>Cosmac 8</Title>
  <Description>
New levels
  </Description>
  <Email>serenata@setarnet.aw</Email>
  <LevelCollection Copyright="Eric F Tchong" MaxWidth="40" MaxHeight="23">
    <Level Id="3 Musketeers" Width="9" Height="6">
      <L>   ####</L>
      <L>###   ###</L>
      <L>#..@$$  #</L>
      <L>##. $ # #</L>
      <L> ##     #</L>
      <L>  #######</L>
    </Level>
    <Level Id="Room to room" Width="16" Height="12">
      <L>  #######</L>
      <L>  #..  .#</L>
      <L>  #. $..####</L>
      <L>  # $###   ###</L>
      <L>  #  $..@$$  #</L>
      <L>### $##.$$ $ #</L>
      <L># $   ##     #</L>
      <L>#   $  #########</L>
      <L># # $$$$. $.$..#</L>
      <L># $ #  .. ..  .#</L>
      <L>#     ##########</L>
      <L>########</L>
    </Level>
    <Level Id="Lighthouse" Width="15" Height="12">
      <L> #######</L>
      <L> # ....#   ###</L>
      <L> # .####  #   #</L>
      <L> #..#     #$$ #</L>
      <L> #. #     #   #</L>
      <L>#   ##   ##$$ #</L>
      <L>#    ##### $  #</L>
      <L> # #        $ #</L>
      <L> #    #####$  #</L>
      <L> #   ######@$ #</L>
      <L> #####    ##  #</L>
      <L>           ###</L>
    </Level>
    <Level Id="Up to the clouds" Width="11" Height="11">
      <L>###########</L>
      <L>#   . .   #</L>
      <L>#  . . .  #</L>
      <L> #. . . .#</L>
      <L>  #     #</L>
      <L>   ## ##</L>
      <L>  # $ $ #</L>
      <L> # $ $ $ #</L>
      <L># $ $@$ $ #</L>
      <L>#         #</L>
      <L>###########</L>
    </Level>
    <Level Id="Clouds 2" Width="11" Height="12">
      <L>    ###</L>
      <L>#####.#####</L>
      <L>#   . .   #</L>
      <L>#  . . .  #</L>
      <L> #. . . .#</L>
      <L>  #     #</L>
      <L> ####$####</L>
      <L> #  $ $  #</L>
      <L> # $ $ $ #</L>
      <L># $ $@$ $ #</L>
      <L>#         #</L>
      <L>###########</L>
    </Level>
    <Level Id="Green Giant" Width="11" Height="12">
      <L>    ###</L>
      <L>#####.#####</L>
      <L>#.........#</L>
      <L>#. .#.#. .#</L>
      <L> # $ $ $ #</L>
      <L> #  $ $  #</L>
      <L> ##  $  ##</L>
      <L> #  $ $  #</L>
      <L> # $ $ $ #</L>
      <L># $ $@$ $ #</L>
      <L>#         #</L>
      <L>###########</L>
    </Level>
    <Level Id="Superman" Width="11" Height="12">
      <L>    ###</L>
      <L>#####.#####</L>
      <L>#   #.#   #</L>
      <L># $$#.#$$ #</L>
      <L># .$...$. #</L>
      <L># .$#*#$. #</L>
      <L># $$ . $$ #</L>
      <L># .#...#. #</L>
      <L>#  $$$$$  #</L>
      <L>#  $.+.$  #</L>
      <L>#         #</L>
      <L>###########</L>
    </Level>
    <Level Id="Mighty sokoban" Width="20" Height="12">
      <L>################</L>
      <L>#         #    #####</L>
      <L># $$$#$$$   ...#...#</L>
      <L># $ $ $ $ # . .#. .#</L>
      <L>#       # # ##     #</L>
      <L># $$$#$$$ # ...#...#</L>
      <L># $ $ $ $ # . .#. .#</L>
      <L>#       # # #      #</L>
      <L># $$$#$$$ # ...#...#</L>
      <L># $ $@$ $ # . . . .#</L>
      <L>#         #        #</L>
      <L>####################</L>
    </Level>
    <Level Id="Bridge over troubled water" Width="16" Height="12">
      <L>          #####</L>
      <L>          #   #</L>
      <L>  ######### # ##</L>
      <L>  # $ $        #</L>
      <L>  #     # #.   #</L>
      <L>###$$#$$# #..# #</L>
      <L># # $ $ # #... #</L>
      <L>#         #....#</L>
      <L># $$$#$$# ##...#</L>
      <L># $ $@$ ### #..#</L>
      <L>#         #  #.#</L>
      <L>###########  ###</L>
    </Level>
    <Level Id="Playground" Width="16" Height="12">
      <L>          #####</L>
      <L>          #...#</L>
      <L>  #########...##</L>
      <L>  #         $  #</L>
      <L>  # ##$#$## $  #</L>
      <L>##        #.#..#</L>
      <L>#   #$ $ $#.#..#</L>
      <L># #$  $@$ #.#..#</L>
      <L># #    $ $#.#..#</L>
      <L># #$$$$$  $    #</L>
      <L>#         #    #</L>
      <L>################</L>
    </Level>
    <Level Id="Mind Reader" Width="13" Height="10">
      <L>############</L>
      <L># ......   #</L>
      <L># $$$####  #</L>
      <L>###     ...#</L>
      <L>  # $$$$$$  #</L>
      <L>  #   # ... #</L>
      <L>  ##### $$$ #</L>
      <L>      #  #  #</L>
      <L>      ## @ ##</L>
      <L>        ###</L>
    </Level>
    <Level Id="Tea for Us" Width="13" Height="11">
      <L>  ##########</L>
      <L>##     #   #</L>
      <L>#  #       #</L>
      <L># # $# #   #</L>
      <L># # $  #    #</L>
      <L>#   $# #....#</L>
      <L># # $  #...##</L>
      <L># # $  #..#</L>
      <L>#@$$$$$#.#</L>
      <L>#      ##</L>
      <L>########</L>
    </Level>
    <Level Id="Butterfly farm" Width="17" Height="13">
      <L>           ######</L>
      <L>   #########....#</L>
      <L>   #..     #....#</L>
      <L>  #..# ##       #</L>
      <L>###... ## #$#  $#</L>
      <L># .  #$#    # $ #</L>
      <L># #    $  #$#$  #</L>
      <L># # # # $   $   #</L>
      <L>#     #  $ $#####</L>
      <L>##    #   $@#</L>
      <L>## ##$#$#$ $#</L>
      <L>##          #</L>
      <L>  ###########</L>
    </Level>
    <Level Id="Melodica" Width="12" Height="12">
      <L>        ####</L>
      <L>        #  #</L>
      <L>######  #  #</L>
      <L>##   ####..#</L>
      <L>#  #$#  ...#</L>
      <L>#    $  #..#</L>
      <L>#.# # $    #</L>
      <L>#.  #  $ $##</L>
      <L>#.  #   $@#</L>
      <L>###$#$#$ $#</L>
      <L>#         #</L>
      <L>###########</L>
    </Level>
    <Level Id="Circus" Width="11" Height="10">
      <L>###########</L>
      <L>##     #  #</L>
      <L>#  #$# #$ #</L>
      <L># $  #  $ #</L>
      <L>#  $ # $# #</L>
      <L># $@$$$$  #</L>
      <L># ##  $ # #</L>
      <L>#.#...#.  #</L>
      <L>#.......  #</L>
      <L>###########</L>
    </Level>
    <Level Id="Mini brainteaser" Width="11" Height="10">
      <L>###########</L>
      <L>#  ....#  #</L>
      <L># $#$# #  #</L>
      <L># $..#..$ #</L>
      <L># $ $#$ # #</L>
      <L># $@ $  $ #</L>
      <L># ## $$ # #</L>
      <L># #  .... #</L>
      <L>#    #### #</L>
      <L>###########</L>
    </Level>
    <Level Id="Rock formations" Width="11" Height="10">
      <L>###########</L>
      <L>#  ..*..  #</L>
      <L># #$#$#$# #</L>
      <L>#   . .   #</L>
      <L># $ * * $ #</L>
      <L># # #$# # #</L>
      <L># $ $@$ $ #</L>
      <L># # ### # #</L>
      <L>#  .. ..  #</L>
      <L>###########</L>
    </Level>
    <Level Id="House of love" Width="11" Height="10">
      <L>    ###</L>
      <L>    #.#</L>
      <L>   #...#</L>
      <L>  #.* *.#</L>
      <L>##. $ $ .##</L>
      <L>#.  $$$  .#</L>
      <L>#.$ $@$ $.#</L>
      <L># ##$$$## #</L>
      <L>#         #</L>
      <L>###########</L>
    </Level>
    <Level Id="Snowhite's house" Width="11" Height="8">
      <L>    ###</L>
      <L>#####.#####</L>
      <L># ..#.#.. #</L>
      <L># . $$$ . #</L>
      <L>#.$ $@$ $.#</L>
      <L>#.$#$$$#$.#</L>
      <L>#         #</L>
      <L>###########</L>
    </Level>
    <Level Id="Brickel Bay Hotel" Width="13" Height="10">
      <L>##########</L>
      <L>#...  #   #</L>
      <L>#...      #</L>
      <L>#.##$##$ $###</L>
      <L>#.#  #      #</L>
      <L>#.# $#$$$#$ #</L>
      <L>#.#  $ @ $  #</L>
      <L>#.# $#####$ #</L>
      <L>#.#         #</L>
      <L>#############</L>
    </Level>
    <Level Id="Brave Heart" Width="15" Height="13">
      <L>###############</L>
      <L>#             #</L>
      <L># #$# $#$ #$# #</L>
      <L>#    #   #    #</L>
      <L># # $.. ..$ # #</L>
      <L>#   . $*$ .   #</L>
      <L># #.###@###.# #</L>
      <L>#   . $ $ .   #</L>
      <L># #  .   .  # #</L>
      <L># $ $ .$. $ $ #</L>
      <L># #####.##### #</L>
      <L>#             #</L>
      <L>###############</L>
    </Level>
    <Level Id="Trickle Cabin" Width="13" Height="12">
      <L>#############</L>
      <L>#           #</L>
      <L>#   ##$##   #</L>
      <L># ##  .  ## #</L>
      <L>#     $     #</L>
      <L>#  #$$#$$#  #</L>
      <L>#  #..@..#  #</L>
      <L>#  #$$#$$#  #</L>
      <L>#  #.....#  #</L>
      <L># #### #### #</L>
      <L>#           #</L>
      <L>#############</L>
    </Level>
    <Level Id="Trickle U 2" Width="13" Height="12">
      <L>#############</L>
      <L>#           #</L>
      <L>#   ##$##   #</L>
      <L># ##.....## #</L>
      <L>#     $     #</L>
      <L># $#$$#$$#$ #</L>
      <L>#  #..@..#  #</L>
      <L># $#$$#$$#$ #</L>
      <L>#  #.....#  #</L>
      <L># #### #### #</L>
      <L>#           #</L>
      <L>#############</L>
    </Level>
    <Level Id="Pond of piranha's" Width="12" Height="12">
      <L>   #########</L>
      <L>###        #</L>
      <L>#  $$$#### #</L>
      <L># $#  $..# #</L>
      <L>#  #$@$..  #</L>
      <L># $#  #..# #</L>
      <L>#  #  #*.# #</L>
      <L># $#$$#..# #</L>
      <L>#  #..$..# #</L>
      <L># $#$.#### #</L>
      <L>#          #</L>
      <L>############</L>
    </Level>
    <Level Id="Zorro wins" Width="12" Height="11">
      <L>############</L>
      <L>#          #</L>
      <L># ******** #</L>
      <L># $ # #  * #</L>
      <L>#       #* #</L>
      <L># ******** #</L>
      <L># * # #  @ #</L>
      <L># *     #  #</L>
      <L># *******. #</L>
      <L>#          #</L>
      <L>############</L>
    </Level>
    <Level Id="Walk a marathon" Width="12" Height="11">
      <L>############</L>
      <L>#          #</L>
      <L># .#* *#*# #</L>
      <L># * * * *  #</L>
      <L># * * * *# #</L>
      <L># * * * *  #</L>
      <L># * * * *@ #</L>
      <L># * * * *  #</L>
      <L># * *** *$ #</L>
      <L>#          #</L>
      <L>############</L>
    </Level>
    <Level Id="Hall of Fear" Width="16" Height="20">
      <L>################</L>
      <L># *............#</L>
      <L>#   #..#########</L>
      <L>#####*.#</L>
      <L># $  ..#</L>
      <L>#   #*.#</L>
      <L>#####..#</L>
      <L># $   $#</L>
      <L>#   #  #</L>
      <L>##### $#</L>
      <L># $    #</L>
      <L>#   # $#</L>
      <L>#####  #</L>
      <L># $   $#</L>
      <L>#   #  ########</L>
      <L>##### $$  $ $ #</L>
      <L># $    $    $ #</L>
      <L>#   #$$#$$$   #</L>
      <L>#####  @   ####</L>
      <L>    #########</L>
    </Level>
    <Level Id="Hall of Fear Part 2" Width="18" Height="21">
      <L>             #####</L>
      <L>###############  #</L>
      <L># $ .            #</L>
      <L>#   #..#.........#</L>
      <L>#####*.#########.#</L>
      <L># $  ..  $   $ #.#</L>
      <L>#   #*.#   #   #.#</L>
      <L>#####..#########.#</L>
      <L># $   $  $   $ #.#</L>
      <L>#   #  #   #   #.#</L>
      <L>##### $##$######.#</L>
      <L># $      $   $ #.#</L>
      <L>#   # $#   #   #.#</L>
      <L>#####  #########.#</L>
      <L># $   $  $      .#</L>
      <L>#   #  ###########</L>
      <L>##### $$  $ $ #</L>
      <L># $    $    $ #</L>
      <L>#   #$$#$$$   #</L>
      <L>#####  @   ####</L>
      <L>    #########</L>
    </Level>
    <Level Id="Hall of Fear Part 3" Width="19" Height="21">
      <L>               ####</L>
      <L>               #..#</L>
      <L>    ####       #..#</L>
      <L>    #  #       #..#</L>
      <L>#####  #########..#</L>
      <L># $      $   $ #..#</L>
      <L>#   ## #   #   #..#</L>
      <L>#####  #########..#</L>
      <L># $   $  $   $ #..#</L>
      <L>#   #  #   #   #..#</L>
      <L>##### $##$######..#</L>
      <L># $      $   $ #..#</L>
      <L>#   # $#   #   #..#</L>
      <L>#####  #########..#</L>
      <L># $   $  $      ..#</L>
      <L>#   #  ########   #</L>
      <L>##### $$  $ $ #####</L>
      <L># $    $    $     #</L>
      <L>#   #$$#$$$   #   #</L>
      <L>#####  @   ########</L>
      <L>    #########</L>
    </Level>
    <Level Id="Artificial Intelligence" Width="16" Height="15">
      <L>      ##########</L>
      <L>######         #</L>
      <L>#@$    $ $ $ $ #</L>
      <L>#   #  #########</L>
      <L>######   $ $ $ #</L>
      <L># $   $  $   $ #</L>
      <L>#   #  $   $   #</L>
      <L>##### $##$######</L>
      <L>#.$ #      $ $ #</L>
      <L>#.  # ## # $   #</L>
      <L>#.$$$$...  $   #</L>
      <L>#....*...$ #####</L>
      <L>#..***...###</L>
      <L>#........#</L>
      <L>##########</L>
    </Level>
    <Level Id="Trickle charge" Width="16" Height="14">
      <L> #########</L>
      <L> #       #</L>
      <L> #@$ $ $ #</L>
      <L>########  #</L>
      <L>#  $ $ $  #</L>
      <L>#        $ ##</L>
      <L># #$$$$$  ..####</L>
      <L>#  $   $# .....#</L>
      <L># #$$$ $.......#</L>
      <L>#    $ $#......#</L>
      <L>#  $$$ $...#####</L>
      <L># ## # $.###</L>
      <L>#      #.#</L>
      <L>##########</L>
    </Level>
    <Level Id="Drop a few stones" Width="10" Height="14">
      <L>##########</L>
      <L>#        #</L>
      <L># $$#### #</L>
      <L># #    $ #</L>
      <L># $ $#####</L>
      <L># #  #</L>
      <L># # $#</L>
      <L># $   ###</L>
      <L># #   $@#</L>
      <L># $$$*###</L>
      <L>#.....#</L>
      <L>#.##.###</L>
      <L>#.  ...#</L>
      <L>########</L>
    </Level>
    <Level Id="Fun walk" Width="15" Height="13">
      <L>#############</L>
      <L>#           #</L>
      <L># $# $$#### #</L>
      <L>#    #    $  #</L>
      <L>#  $ $ $#### #</L>
      <L># $# #  $    #</L>
      <L>#  $ # $####$#</L>
      <L>####$$   $ # #</L>
      <L>#..#@#     # ##</L>
      <L>#..#########  #</L>
      <L>#...........  #</L>
      <L>#   ###########</L>
      <L>####</L>
    </Level>
    <Level Id="Fun miles" Width="25" Height="14">
      <L>#############</L>
      <L>#           #  ####</L>
      <L># $##$#$#$# ####  #######</L>
      <L>#  #      $       $ $ $ #</L>
      <L>#  $ $ #####$#$#$       #</L>
      <L># $# #  $  $   #  $ #####</L>
      <L>#  $ # ##@$    #$ ###   #</L>
      <L># $#$$   $## ###        #</L>
      <L>#    # $   # #.#$ ##....#</L>
      <L># $#$# ##### #.$  $ .####</L>
      <L>#            #....   ..#</L>
      <L>##############..#.#....##</L>
      <L>             #..........#</L>
      <L>             ############</L>
    </Level>
    <Level Id="Chinese dragon" Width="26" Height="14">
      <L>#############</L>
      <L>#           #  ####</L>
      <L># $$$..$#$# ####  #######</L>
      <L>#  $. ..  $       $ $ $ #</L>
      <L>#  . $..###..#$#$       #</L>
      <L># $# #. $ ...  #  $ #####</L>
      <L>#  $ #.##@. .  #$ ### . #</L>
      <L># $#$$ ....#.   ..$ # .$#</L>
      <L>#    $ $ # #.#$ . . $.. #</L>
      <L># $#$$ $$$$#.. .. .##.  ##</L>
      <L>#            ... $.... $ #</L>
      <L>############## $#$$$$$$$ #</L>
      <L>             #           #</L>
      <L>             #############</L>
    </Level>
    <Level Id="Extra Terrestial" Width="25" Height="14">
      <L>########          ####</L>
      <L>#      #      ####   #</L>
      <L># $$$# ##     # ...# #</L>
      <L># $  #  ###   # .# # #</L>
      <L># $$ ##   #   # .. # #</L>
      <L># $    ## ##### .# # ##</L>
      <L># $$$#   @      ...#  ##</L>
      <L>#     $$$#######    ...#</L>
      <L>#####  $  #    ######.##</L>
      <L>     # $  ###      # . #</L>
      <L>     # $    #      # . ##</L>
      <L>     # $ $  #      ##. .#</L>
      <L>     #  #####      ######</L>
      <L>     ####</L>
    </Level>
    <Level Id="Teresita" Width="12" Height="14">
      <L>  #####</L>
      <L>##    #</L>
      <L>#...  #</L>
      <L>##.#  ###</L>
      <L> #.#    #</L>
      <L> #.#  $ #</L>
      <L> #.#$## #</L>
      <L> #      ##</L>
      <L> ###  #  #</L>
      <L>    # #$ ###</L>
      <L>    #  $ $ #</L>
      <L>    # $  $@#</L>
      <L>    #  #####</L>
      <L>    ####</L>
    </Level>
    <Level Id="Stephanie" Width="39" Height="20">
      <L>######</L>
      <L>###########</L>
      <L># ...##########</L>
      <L># .   ...##########</L>
      <L># ...  .  ...##########</L>
      <L>#   .  .  .   ...##########</L>
      <L># ...  .  ..  . . . .##########</L>
      <L>###### .  .   ... . .  .###########</L>
      <L>##########... .   ... . . ...##########</L>
      <L># @   ########.   . . ... . . ...######</L>
      <L># $$$$$ $ ########. . . . . .  .  ... #</L>
      <L>#       $     ########. . . .  .  .   #</L>
      <L># $$$$$ $ $$$$$ $ ########. .  .  ..  #</L>
      <L>#       $           $ ########... .   #</L>
      <L># $$$$$ $ $$$$$$$$$$$ $ $ ########... #</L>
      <L>#   $   $                     ##### $##</L>
      <L># $$$$$ $ $$$$$$$$$$$$$$$$$$$$$ $ $ $ #</L>
      <L># $   $ $ $ $ $ $ $  $ $ $ $ $  $ $ $ #</L>
      <L>#                                     #</L>
      <L>#######################################</L>
    </Level>
    <Level Id="Dirty dancing" Width="13" Height="19">
      <L>  ###########</L>
      <L>  #...  #..##</L>
      <L>  #.#.. . .##</L>
      <L>  #.##.#.$.##</L>
      <L>  #...... . #</L>
      <L>### ##### ..#</L>
      <L>#.......  $.#</L>
      <L>######.... .#</L>
      <L># @   ####$.#</L>
      <L># $$$$$ $ ..#</L>
      <L>#   #   $ ..#</L>
      <L># $$$$$ $ $.#</L>
      <L>#   $   $ $.#</L>
      <L># $$$$$ $ $ #</L>
      <L>#       $ $ #</L>
      <L># $$$$$ $ $ #</L>
      <L># $ $ $$$$$ #</L>
      <L>#           #</L>
      <L>#############</L>
    </Level>
    <Level Id="Bumble Bee" Width="27" Height="18">
      <L>                   #####</L>
      <L>     ####     #######..##</L>
      <L>   ###...##  ##.........##</L>
      <L> ## $ $ $..###....$$$$$..#</L>
      <L> #  $.. $......$$$$ $.$$.#</L>
      <L>##$........##..$..$  .$.##</L>
      <L>#.......##........$$ .$.#</L>
      <L># $$$$ $@ $ $   $$  $ $ #</L>
      <L>#    ###  $ $ $$$  $$ $ #</L>
      <L>#####   ###   $....$    ##</L>
      <L>#    $  $ ##  $....$ $$  ##</L>
      <L>## $$$$    ## $....$  $$ .#</L>
      <L> #    $ $ $ #$##$$$$ $  ..#</L>
      <L> ## $ $$$$$ #    $   ######</L>
      <L>  ###       $  #  $$ #</L>
      <L>    #######   ###    #</L>
      <L>          ##### ##  ##</L>
      <L>                 ####</L>
    </Level>
    <Level Id="Bumble Bee 2" Width="39" Height="22">
      <L>                   #####  ############</L>
      <L>     ####     #######..## #    ....  #</L>
      <L>   ###...##  ##.........###$ $$$$.####</L>
      <L> ## $ $ $..###....$$$$$..#       ##</L>
      <L> #. $.. $......$$$$ $.$$.#$$$$$$ #</L>
      <L>##$........##..$..$  .$.##       ##</L>
      <L>#.......##........$$ .$.#.$$$$$$  ###</L>
      <L>#.$$$$.$@ $ $   $$  $ $ #.          ###</L>
      <L>#....###  $ $ $$$  $$ $ #..  $$$$$$  .#</L>
      <L>#####   ###   $....$    ##.  ...$    .#</L>
      <L>#    $  $ ##  $....$ $$  ##. ...$$$$$.#</L>
      <L>## $$$$    ## $....$  $$ .# $....   ..#</L>
      <L> #    $ $ $ #$##$$$$ $  ..# $$$ .  .###</L>
      <L> ## $ $$$$$ #    $   ######   $ . ###</L>
      <L>  ###       $  #  $$ #        $      #</L>
      <L>    #......   ###    # $  $$$$$   $ ##</L>
      <L>    #......#### ##     $  $     $ $ #</L>
      <L>    #######      #   #  $       $.# #</L>
      <L>                 ######  $$$$ ##. .##</L>
      <L>                      ###     ###.##</L>
      <L>                        ####### ###</L>
      <L>                           ##</L>
    </Level>
    <Level Id="Curious walk" Width="18" Height="15">
      <L>        ##########</L>
      <L>   ######        #</L>
      <L>   ##    $  #### #</L>
      <L>    ##  $  ##... #</L>
      <L>     #$ $$ #...  #</L>
      <L>     #  $  ##..  #</L>
      <L>#####   $$  ##.##</L>
      <L>#   $  # $# #...#</L>
      <L># #$  # @$  #..##</L>
      <L># $ $ $$$$ #...#</L>
      <L>#    $$    # ..#</L>
      <L>## $ $  $  ....#</L>
      <L> ###     ###  ##</L>
      <L>   ####### ####</L>
      <L>      ##</L>
    </Level>
    <Level Id="Houdini" Width="18" Height="13">
      <L>   ###############</L>
      <L>####..  .........#</L>
      <L>#  .... # ########</L>
      <L>#  #### #  #</L>
      <L># $  $ $ $ #</L>
      <L>#  $## # # #</L>
      <L>#  $ #   $ #</L>
      <L>#      $ # #</L>
      <L>#####  $$$ #</L>
      <L>#   $      #</L>
      <L># #$@$ $ ###</L>
      <L>#    #####</L>
      <L>######</L>
    </Level>
    <Level Id="Sleight of hand" Width="19" Height="14">
      <L>   ######### ######</L>
      <L>  ##       # #    #</L>
      <L> #  $  ### # # $$ #</L>
      <L>#  $ ....# ### $  #</L>
      <L># $##....# #   $$ #</L>
      <L>#    ..#.# # $ $  #</L>
      <L>#  #$..#.# # $ $$ #</L>
      <L>###  ....# # $ $  #</L>
      <L>  #  #...  #####$ #</L>
      <L>  #   ####        #</L>
      <L>  #  $ $ $ # $  @#</L>
      <L>  #          #####</L>
      <L>  ######  ####</L>
      <L>        ##</L>
    </Level>
    <Level Id="Rosita" Width="17" Height="17">
      <L>      #####</L>
      <L>      #   #</L>
      <L>      # $ #</L>
      <L>      #   #</L>
      <L>      ## ##</L>
      <L>       # #</L>
      <L>##### ## ## #####</L>
      <L>#   ##  .  ##   #</L>
      <L># $    .@.    $ #</L>
      <L>#   ##  .  ##   #</L>
      <L>##### ## ## #####</L>
      <L>       # #</L>
      <L>      ## ##</L>
      <L>      #   #</L>
      <L>      # $ #</L>
      <L>      #   #</L>
      <L>      #####</L>
    </Level>
    <Level Id="Rosita II" Width="17" Height="17">
      <L>      #####</L>
      <L>      #   #</L>
      <L>      # $ #</L>
      <L>      #   #</L>
      <L>    #### ####</L>
      <L>    #  # #  #</L>
      <L>##### $$.$$ #####</L>
      <L>#   #  ...  #   #</L>
      <L># $   ..@..   $ #</L>
      <L>#   #  ...  #   #</L>
      <L>##### $$.$$ #####</L>
      <L>    #  # #  #</L>
      <L>    #### ####</L>
      <L>      #   #</L>
      <L>      # $ #</L>
      <L>      #   #</L>
      <L>      #####</L>
    </Level>
    <Level Id="Rosita III" Width="17" Height="17">
      <L>     #######</L>
      <L>     #     #</L>
      <L>     # $$$ #</L>
      <L>     #     #</L>
      <L>    #### ####</L>
      <L>##### .   . #####</L>
      <L>#   # $$.$$ #   #</L>
      <L># $ # ..... # $ #</L>
      <L># $   ..@..   $ #</L>
      <L># $ # ..... # $ #</L>
      <L>#   # $$.$$ #   #</L>
      <L>##### .   . #####</L>
      <L>    #### ####</L>
      <L>     #     #</L>
      <L>     # $$$ #</L>
      <L>     #     #</L>
      <L>     #######</L>
    </Level>
    <Level Id="Bazooka" Width="17" Height="12">
      <L>#################</L>
      <L>#     #...#     #</L>
      <L># $$$$$$$$$$$$$ #</L>
      <L># $   . + .   $ #</L>
      <L># $$$$$$$$$$$$$ #</L>
      <L>#  .. . . . ..  #</L>
      <L>#####..#.#..#####</L>
      <L>     #.#.#.##</L>
      <L>     #.#.#.#</L>
      <L>     #.$.$.#</L>
      <L>     #. . .#</L>
      <L>     #######</L>
    </Level>
    <Level Id="Swinging Ninja" Width="17" Height="13">
      <L>#################</L>
      <L>#               #</L>
      <L># #$#$$$$$$###. #</L>
      <L># $ # $ $  #....#</L>
      <L># $          ...#</L>
      <L>#####$$# #.  .###</L>
      <L>   ##    #.#.####</L>
      <L>    #$ $ #.#.#</L>
      <L>    # $@$#.#.#</L>
      <L>    #$ $ .$$.#</L>
      <L>    # $ $# $.#</L>
      <L>    #..... ###</L>
      <L>    ########</L>
    </Level>
    <Level Id="Caves of Horror" Width="17" Height="13">
      <L>#################</L>
      <L>#               #</L>
      <L># #$##$##$$.....#</L>
      <L># $ #  $   ##.#.#</L>
      <L># $    # $ .....#</L>
      <L>### #$ $ # #.. .#</L>
      <L># # # #  $ ###..#</L>
      <L>#       #$ # ##.#</L>
      <L>#  #### $  #  ###</L>
      <L>##  $ #$ $##</L>
      <L># $ $ #@   #</L>
      <L>#     ######</L>
      <L>#######</L>
    </Level>
    <Level Id="Lucky seven" Width="11" Height="10">
      <L> #######</L>
      <L> #      ###</L>
      <L>##   $$$  #</L>
      <L>#  ###@$  #</L>
      <L>#... #$  ##</L>
      <L>#  .# $ ##</L>
      <L># . # $ #</L>
      <L># . #   #</L>
      <L># .     #</L>
      <L>#########</L>
    </Level>
    <Level Id="Triple seven" Width="26" Height="12">
      <L>###############</L>
      <L>#             #</L>
      <L># # # ### # # ####  ######</L>
      <L># $$$     $$$ ...#  # ...#</L>
      <L># #@$ # #   $ # .###    .#</L>
      <L>#  $  $$$  $   .  ...  .##</L>
      <L>#  $    $  $ ##.  # . #.##</L>
      <L>## $   $   $ ##. ##.###.##</L>
      <L>  ###  $ ###  #####.######</L>
      <L>    ## $      #####.##</L>
      <L>      #####   #   ###</L>
      <L>          #####</L>
    </Level>
    <Level Id="Triple seven part 2" Width="15" Height="23">
      <L>###############</L>
      <L>#             #</L>
      <L># # # ### # # #</L>
      <L># $$$     $$$ #</L>
      <L># #@$ # #   $ #</L>
      <L>#  $  $$$  $  #</L>
      <L>#  $    $  $ ##</L>
      <L>## $   $   $ ##</L>
      <L>#  ##  $ ###  #</L>
      <L>#   ## $      #</L>
      <L>#     #####   #</L>
      <L>########### ###</L>
      <L> #...     ... #</L>
      <L>  ##. ###   . #</L>
      <L>  #.  ... #.###</L>
      <L>  #.    . #.#</L>
      <L>  #.# #.# #.#</L>
      <L>  ### #.# ###</L>
      <L>    # #.# ##</L>
      <L>   ## ###  #</L>
      <L>  #        #</L>
      <L>  #   ######</L>
      <L>  ####</L>
    </Level>
    <Level Id="Explore planet venus" Width="15" Height="12">
      <L>###############</L>
      <L>#             #</L>
      <L># #.#.###.#.# #</L>
      <L># $ # #.... $ #</L>
      <L># #$  .#...$# #</L>
      <L>## $ $..##. $ #</L>
      <L>## $  .#..   ##</L>
      <L>## $ $ $ $ $ ##</L>
      <L>#  $#    ###  #</L>
      <L># $ ## $  $ $ #</L>
      <L>#    @#####   #</L>
      <L>###############</L>
    </Level>
    <Level Id="Lunar Lander" Width="9" Height="12">
      <L>#########</L>
      <L>#   .   #</L>
      <L>#   *   #</L>
      <L># #***# #</L>
      <L>#  * *  #</L>
      <L># *   * #</L>
      <L># * # * #</L>
      <L># *## * #</L>
      <L># *   * #</L>
      <L># * $ * #</L>
      <L>####@####</L>
      <L>   ###</L>
    </Level>
    <Level Id="Little Thinker" Width="9" Height="9">
      <L>#########</L>
      <L>#   .   #</L>
      <L># ***** #</L>
      <L># *   * #</L>
      <L>#  * *  #</L>
      <L># *   * #</L>
      <L># * $ * #</L>
      <L>####@####</L>
      <L>   ###</L>
    </Level>
    <Level Id="Little Alf" Width="9" Height="13">
      <L>   ###</L>
      <L>   #.#</L>
      <L> ###.###</L>
      <L> #  .  #</L>
      <L>##*$$$*##</L>
      <L>#   .   #</L>
      <L># ***** #</L>
      <L># *   * #</L>
      <L>#  * *  #</L>
      <L># *   * #</L>
      <L># * $ * #</L>
      <L>####@####</L>
      <L>   ###</L>
    </Level>
    <Level Id="3 Crosses" Width="17" Height="13">
      <L> ################</L>
      <L> #     #...  #  #</L>
      <L>## #$####..#$#. #</L>
      <L>#   $   #.  $ . #</L>
      <L># $$$$$@# $$$$$ #</L>
      <L># # $ ### # $ # #</L>
      <L># # $ # $ # $ # #</L>
      <L># #...  $  ...  #</L>
      <L>#  . .$$$$$. .#.#</L>
      <L>###. .# $ #. .###</L>
      <L>  #  .# $ ## .#</L>
      <L>  # .   #   . #</L>
      <L>  #############</L>
    </Level>
    <Level Id="Don't call 911" Width="14" Height="13">
      <L> ##########</L>
      <L> #.....#..#</L>
      <L>##.#$$ $  ###</L>
      <L>#... $ #$ ..#</L>
      <L>#...$$ # ...#</L>
      <L>#.#  $$$ .###</L>
      <L>#.#$## $ ##</L>
      <L>#.#    $   #</L>
      <L>#.. $$$$## ##</L>
      <L>###  $      ##</L>
      <L>  #$ #$$$$$$@#</L>
      <L>  #          #</L>
      <L>  ############</L>
    </Level>
    <Level Id="END of COSMAC 8" Width="40" Height="22">
      <L>################################</L>
      <L>#@                      ##     #</L>
      <L># ... *.* .. $ $   .*.$ ## $ $ #</L>
      <L># .   .$. . . $    . $  ##  $  #</L>
      <L># ..  * * . .$ *.. .* $    $ $ #</L>
      <L># * $ . .$.$.  .$.$.   $ $     #</L>
      <L># .*. . . *.   ..* .    $      #</L>
      <L># $ $    $ $    $ $    $ $     #</L>
      <L>#    $ $    $ $    $ $    $ $  #####</L>
      <L> #... *.. ...$.. .. $.  ...$    ...#</L>
      <L> #.  $.$. . $ * . .$.$. . $ $   . .#</L>
      <L> #.   . * *.. .$.$. ..* *   .*.$...#</L>
      <L> #.   . .$  . . * . . .$.     $ . .#</L>
      <L> #... ..* *.. .$.$. . * *..  $ $...##</L>
      <L> ## $ $    $ $    $ $    $ $    $ $ #</L>
      <L>  #  $      $      $      $      $  ####</L>
      <L>  # $ $    $ $    $ $    $ $    $ $    #</L>
      <L>  #    $ $    $ $    $ $    $ $    $ $ #</L>
      <L>  ####  $      $      $      $      $  #</L>
      <L>     # $ $    $ $    $ $    $ $    $ $ #</L>
      <L>     #                                 #</L>
      <L>     ###################################</L>
    </Level>
    <Level Id="END of COSMAC 8 Final" Width="40" Height="22">
      <L>################################</L>
      <L>#@                      ##     #</L>
      <L># ... #.# .. $ $   .#.$ ## $ $ #</L>
      <L># .   .$. . . $    . $  ##  $  #</L>
      <L># ..  # # . .$ #.. .# $    $ $ #</L>
      <L># # $ . .$.$.  .$.$.   $ $     #</L>
      <L># .#. . . #.   ..# .    $      #</L>
      <L># $ $    $ $    $ $    $ $     #</L>
      <L>#    $ $    $ $    $ $    $ $  #####</L>
      <L> #... #.. ...$.. .. $.  ...$    ...#</L>
      <L> #.  $.$. . $ # . .$.$. . $ $   . .#</L>
      <L> #.   . # #.. .$.$. ..# #   .#.$...#</L>
      <L> #.   . .$  . . # . . .$.     $ . .#</L>
      <L> #... ..# #.. .$.$. . # #..  $ $...##</L>
      <L> ## $ $    $ $    $ $    $ $    $ $ #</L>
      <L>  #  $      $      $      $      $  ####</L>
      <L>  # $ $    $ $    $ $    $ $    $ $    #</L>
      <L>  #    $ $    $ $    $ $    $ $    $ $ #</L>
      <L>  ####  $      $      $      $      $  #</L>
      <L>     # $ $    $ $    $ $    $ $    $ $ #</L>
      <L>     #                                 #</L>
      <L>     ###################################</L>
    </Level>
  </LevelCollection>
</SokobanLevels>
