<?xml version="1.0" encoding="utf-8"?>
<SokobanLevels xmlns:xsi="http://www.w3.org/2001/XMLSchema-instance" xsi:schemaLocation="SokobanLev.xsd">
  <Title>Cosmac 7</Title>
  <Description>
40 new levels from Aruba. Enjoy
  </Description>
  <Email>serenata@setarnet.aw</Email>
  <LevelCollection Copyright="Eric F Tchong" MaxWidth="20" MaxHeight="15">
    <Level Id="Small is beautiful" Width="8" Height="5">
      <L>  ######</L>
      <L> ##.# .#</L>
      <L>#  $@$ #</L>
      <L>#   $ .#</L>
      <L>########</L>
    </Level>
    <Level Id="Creative 5" Width="8" Height="7">
      <L>########</L>
      <L>#...#. #</L>
      <L>#  $@$ #</L>
      <L># $$$  #</L>
      <L>###  .##</L>
      <L>  #   #</L>
      <L>  #####</L>
    </Level>
    <Level Id="Fence it in" Width="8" Height="8">
      <L>########</L>
      <L>#...#. #</L>
      <L># $ #  #</L>
      <L># $    #</L>
      <L>## $$$##</L>
      <L>  # @. #</L>
      <L>  #    #</L>
      <L>  ######</L>
    </Level>
    <Level Id="Surprise" Width="8" Height="8">
      <L>########</L>
      <L>#   #  #</L>
      <L># $$$$ #</L>
      <L># $@$..#</L>
      <L># $$ .##</L>
      <L># # $..#</L>
      <L>#  ....#</L>
      <L>########</L>
    </Level>
    <Level Id="From J to T" Width="8" Height="8">
      <L>########</L>
      <L>#...#  #</L>
      <L># .$$$ #</L>
      <L># .@$  #</L>
      <L>##.$$  #</L>
      <L>  #  ##</L>
      <L>  #  #</L>
      <L>  ####</L>
    </Level>
    <Level Id="Coral" Width="8" Height="8">
      <L>########</L>
      <L>#...#  #</L>
      <L>#.**$$ #</L>
      <L># .@$  #</L>
      <L>##.$$$ #</L>
      <L>  #    #</L>
      <L>  #  ###</L>
      <L>  ####</L>
    </Level>
    <Level Id="Nine o'clock" Width="16" Height="10">
      <L>################</L>
      <L>#.  ###  #  #  #</L>
      <L>##       # $$$ #</L>
      <L> #. ###    $@$ #</L>
      <L> #. # #  # $$$ #</L>
      <L>##  #### #   $ #</L>
      <L>#. . .  .# $$$ #</L>
      <L>##.    ..#     #</L>
      <L>  ##..##########</L>
      <L>   ##### #</L>
    </Level>
    <Level Id="Daisies" Width="16" Height="9">
      <L>            ####</L>
      <L> ############  #</L>
      <L> # $ $      ...#</L>
      <L> #   $ $$   #..#</L>
      <L>##$#   $@#  #..#</L>
      <L>#  # #$#####...#</L>
      <L># $ $          #</L>
      <L>#       ########</L>
      <L>##########</L>
    </Level>
    <Level Id="Temple of Hanoi" Width="16" Height="13">
      <L>################</L>
      <L>#...........   #</L>
      <L>#######.#### # #</L>
      <L>#     #.       #</L>
      <L>#     #.     ###</L>
      <L>## ## #.    ####</L>
      <L> #        $ ####</L>
      <L> #   $ $ ###  ##</L>
      <L> # ###### $   #</L>
      <L> # $ $ $ $ $$ #</L>
      <L>## $ $ $ $ $@#</L>
      <L>#           #</L>
      <L>#############</L>
    </Level>
    <Level Id="Flying Dutchman" Width="14" Height="12">
      <L>##############</L>
      <L>#            #</L>
      <L># ####  #### #</L>
      <L># #..$  $..# #</L>
      <L># #..$  $..# #</L>
      <L># #..$  $..# #</L>
      <L># #........# #</L>
      <L># $$$$$$$$$$ #</L>
      <L>#    $@ $    #</L>
      <L># ####$$#### #</L>
      <L>#            #</L>
      <L>##############</L>
    </Level>
    <Level Id="Fix One" Width="13" Height="8">
      <L> #########</L>
      <L> #*****#.#</L>
      <L>##*  **  ##</L>
      <L>#*  $ *** ###</L>
      <L>#* @    *   #</L>
      <L># *******   #</L>
      <L>#         ###</L>
      <L>###########</L>
    </Level>
    <Level Id="One more to fix" Width="8" Height="7">
      <L>########</L>
      <L>#.*  ###</L>
      <L># * * ##</L>
      <L>## *$ ##</L>
      <L>## @  ##</L>
      <L>########</L>
      <L>########</L>
    </Level>
    <Level Id="Staircase" Width="8" Height="7">
      <L>########</L>
      <L>#.  #  #</L>
      <L># .$$  #</L>
      <L># $.$# #</L>
      <L># $@.# #</L>
      <L>#    . #</L>
      <L>########</L>
    </Level>
    <Level Id="Roses" Width="7" Height="7">
      <L>#######</L>
      <L>#. * .#</L>
      <L>#  $  #</L>
      <L>#*$ $*#</L>
      <L># .$. #</L>
      <L>#@ *  #</L>
      <L>#######</L>
    </Level>
    <Level Id="Clean the floor" Width="7" Height="7">
      <L>#######</L>
      <L># .   #</L>
      <L># $** #</L>
      <L>#$$  .#</L>
      <L>#.$$  #</L>
      <L>#@. . #</L>
      <L>#######</L>
    </Level>
    <Level Id="Troubled water" Width="8" Height="8">
      <L>########</L>
      <L>#      #</L>
      <L># $$*###</L>
      <L># #@   #</L>
      <L># .$$$*#</L>
      <L># # #. #</L>
      <L># .  ..#</L>
      <L>########</L>
    </Level>
    <Level Id="Cornerstone" Width="8" Height="8">
      <L>########</L>
      <L>#     .#</L>
      <L># $#$ $#</L>
      <L>#. $ @ #</L>
      <L>##$$.$.#</L>
      <L>#  $#. #</L>
      <L># .  ..#</L>
      <L>########</L>
    </Level>
    <Level Id="Happy birthday" Width="9" Height="9">
      <L>#########</L>
      <L>#...   .#</L>
      <L># $##$$ #</L>
      <L>#... @$##</L>
      <L>###$$$ ##</L>
      <L>#       #</L>
      <L>#..$$$$ #</L>
      <L>#..#    #</L>
      <L>#########</L>
    </Level>
    <Level Id="Happy Birthday II" Width="9" Height="9">
      <L>#########</L>
      <L>#...   .#</L>
      <L>#  ##$$ #</L>
      <L>#...$@$##</L>
      <L>###$$$ ##</L>
      <L>#       #</L>
      <L>#..$$$$ #</L>
      <L>#..#    #</L>
      <L>#########</L>
    </Level>
    <Level Id="Colombia Esmeralds" Width="9" Height="9">
      <L>#########</L>
      <L>#     # #</L>
      <L># #.$ . #</L>
      <L># #. *. #</L>
      <L># ## #$ #</L>
      <L># @$$#..#</L>
      <L>##$# $$.#</L>
      <L>#       #</L>
      <L>#########</L>
    </Level>
    <Level Id="Pioneer" Width="9" Height="9">
      <L>#########</L>
      <L>#.     .#</L>
      <L>#  #$ . #</L>
      <L>#$$ $ $ #</L>
      <L># @## ###</L>
      <L>#$$$  . #</L>
      <L>#.  #.  #</L>
      <L>#.  .   #</L>
      <L>#########</L>
    </Level>
    <Level Id="Get a dip" Width="9" Height="9">
      <L>#########</L>
      <L>#... $  #</L>
      <L>#.$. $  #</L>
      <L>#.. $@# #</L>
      <L># $$*$# #</L>
      <L>#*$ .   #</L>
      <L>#.  $$# #</L>
      <L># $   ..#</L>
      <L>#########</L>
    </Level>
    <Level Id="Line conditioner" Width="9" Height="9">
      <L>#########</L>
      <L>#. $ .$.#</L>
      <L>#  $. $.#</L>
      <L># $$$@$ #</L>
      <L># . $ # #</L>
      <L>#.  $.* #</L>
      <L>####$$$.#</L>
      <L>#...   .#</L>
      <L>#########</L>
    </Level>
    <Level Id="Little bus" Width="15" Height="7">
      <L>   #########</L>
      <L>   # ...   #</L>
      <L>   #$..* $ #</L>
      <L>####.###$# ####</L>
      <L># $ $ $ * $   #</L>
      <L>#@  $   .    .#</L>
      <L>###############</L>
    </Level>
    <Level Id="Talk of the town" Width="15" Height="7">
      <L>###############</L>
      <L>#   ....      #</L>
      <L># $ **.* $  $ #</L>
      <L>####.#*#$# $###</L>
      <L># $ $ $ * $ #</L>
      <L>#@    ...   #</L>
      <L>#############</L>
    </Level>
    <Level Id="Luz Marina" Width="15" Height="15">
      <L>##############</L>
      <L>#            #</L>
      <L># $ $ $ $ $  #</L>
      <L>###$#$#$#$#$ #</L>
      <L># $ $ $ $ $  #</L>
      <L>#@           #</L>
      <L>######  ######</L>
      <L>  ####   ##. #</L>
      <L>  #... # ##. #</L>
      <L> ####    ##.  #</L>
      <L> #...   #  ...#</L>
      <L> ##   # ##  #.#</L>
      <L>  #         #.#</L>
      <L>  ########  #.#</L>
      <L>         ######</L>
    </Level>
    <Level Id="Himalaya" Width="20" Height="15">
      <L> ###########</L>
      <L> #   #########</L>
      <L> #$ $#    ## #</L>
      <L>## $     $ $ #</L>
      <L>#   ####  $  #</L>
      <L>#  $ ### $ $ #</L>
      <L>##  #####  # ######</L>
      <L> # $####      ##..#</L>
      <L> #     #  $## ##. #</L>
      <L> # $# ####    # ...#</L>
      <L> #$ @ #      ## ...#</L>
      <L> # $$ ## # # ##..#.#</L>
      <L> #     #        .#.#</L>
      <L> ##############  #.#</L>
      <L>              ######</L>
    </Level>
    <Level Id="Gemstones" Width="11" Height="12">
      <L>    ###</L>
      <L>####   ####</L>
      <L>#         #</L>
      <L># # $#$ # #</L>
      <L>#  #...#  #</L>
      <L># $ $.$ $ #</L>
      <L># #..@..# #</L>
      <L># $ $.$ $ #</L>
      <L>#  #...#  #</L>
      <L># # $#$ # #</L>
      <L>#         #</L>
      <L>###########</L>
    </Level>
    <Level Id="Gemstones 2" Width="11" Height="12">
      <L>    ###</L>
      <L>####   ####</L>
      <L>#         #</L>
      <L># # $#$ # #</L>
      <L>#  #...#  #</L>
      <L># $ $.$ $ #</L>
      <L># #..+..# #</L>
      <L># $ $.$ $ #</L>
      <L>#  #...#  #</L>
      <L># # $$$ # #</L>
      <L>#         #</L>
      <L>###########</L>
    </Level>
    <Level Id="5 Dices" Width="11" Height="12">
      <L>    ###</L>
      <L>####   ####</L>
      <L>#         #</L>
      <L># $.$#$.$ #</L>
      <L># .$...$. #</L>
      <L># $ $.$ $ #</L>
      <L># #..@..# #</L>
      <L># $ $.$ $ #</L>
      <L># .$...$. #</L>
      <L># $.$#$.$ #</L>
      <L>#         #</L>
      <L>###########</L>
    </Level>
    <Level Id="Lights of Hope" Width="11" Height="11">
      <L>###########</L>
      <L>#         #</L>
      <L># $.$## # #</L>
      <L>#  $...#. #</L>
      <L># $#$.$ $ #</L>
      <L># $..@..$ #</L>
      <L># $ $.$#$ #</L>
      <L># .#...$  #</L>
      <L># # ##$.$ #</L>
      <L>#         #</L>
      <L>###########</L>
    </Level>
    <Level Id="Come to papa" Width="15" Height="11">
      <L>    ###########</L>
      <L>    #         #</L>
      <L>    # $$$$$$$ #</L>
      <L>    # $.....$ #</L>
      <L>####  $.....$ #</L>
      <L># $   $..+..$ #</L>
      <L>#   # $.....$ #</L>
      <L>##### $.....$ #</L>
      <L>    # $$$$$$$ #</L>
      <L>    #         #</L>
      <L>    ###########</L>
    </Level>
    <Level Id="Take your time" Width="16" Height="12">
      <L> ######    ###</L>
      <L>##....##  ##.###</L>
      <L>#   $ .####....#</L>
      <L># $ $       $$.#</L>
      <L>#####$ $$ $.$..#</L>
      <L>    #  # .######</L>
      <L>    # $# #</L>
      <L>  ###  #$#</L>
      <L>  # $ ## #</L>
      <L>  #  $ $ #</L>
      <L>  #@     #</L>
      <L>  ########</L>
    </Level>
    <Level Id="Fountain" Width="12" Height="9">
      <L>  ########</L>
      <L>  #      #</L>
      <L>  #@$ $  #</L>
      <L>###$#$#$####</L>
      <L>#       $  #</L>
      <L># $  ### $ #</L>
      <L>###   #    #</L>
      <L>#........###</L>
      <L>##########</L>
    </Level>
    <Level Id="Room service" Width="10" Height="7">
      <L>##########</L>
      <L>##.      #</L>
      <L>#..$ $## #</L>
      <L>#..$$  $ #</L>
      <L>#..#@$$# #</L>
      <L>######   #</L>
      <L>     #####</L>
    </Level>
    <Level Id="Eduardo" Width="10" Height="8">
      <L>##########</L>
      <L>#        #</L>
      <L># .*.$$$ #</L>
      <L>#  ... $ #</L>
      <L>#@.#.$$# #</L>
      <L># $  #   #</L>
      <L>####     #</L>
      <L>    ######</L>
    </Level>
    <Level Id="Cross and toss" Width="10" Height="9">
      <L>  ########</L>
      <L>  #  ....#</L>
      <L> #   $...#</L>
      <L>##$$$ #..#</L>
      <L>#   #$# ##</L>
      <L>#   $ @$ #</L>
      <L>##### $$ #</L>
      <L>    #    #</L>
      <L>    ######</L>
    </Level>
    <Level Id="Bubblegum" Width="10" Height="9">
      <L>  ########</L>
      <L> ##   ...#</L>
      <L> #  $#$..#</L>
      <L>##$  # ..#</L>
      <L>#  $###$##</L>
      <L>#@$     ##</L>
      <L>##### $  #</L>
      <L>    #    #</L>
      <L>    ######</L>
    </Level>
    <Level Id="Booby trap" Width="10" Height="12">
      <L>  ######</L>
      <L> #.....#</L>
      <L> #. ...#</L>
      <L> #$$...#</L>
      <L>#  # #####</L>
      <L>#        #</L>
      <L>### $$$  #</L>
      <L># $  $ $ #</L>
      <L># $ $ $@##</L>
      <L>#   #$###</L>
      <L>###     #</L>
      <L>   ######</L>
    </Level>
    <Level Id="Ink blots" Width="16" Height="12">
      <L>  ######</L>
      <L>  # #  ######</L>
      <L>  #         #</L>
      <L>  # # $###  #</L>
      <L>  # #  #.# $####</L>
      <L>  # ## #.#     #</L>
      <L>###$    .# $$$ #</L>
      <L># $ #   .#   $ #</L>
      <L>#      .## $ $ #</L>
      <L>### #  .# $ ####</L>
      <L>  #.....#@ #</L>
      <L>   #########</L>
    </Level>
  </LevelCollection>
</SokobanLevels>
