<?xml version="1.0" encoding="utf-8"?>
<SokobanLevels xmlns:xsi="http://www.w3.org/2001/XMLSchema-instance" xsi:schemaLocation="SokobanLev.xsd">
  <Title>Cosmac 9</Title>
  <Description>
Cosmac no.9 50 levels
  </Description>
  <Email>serenata@setarnet.aw</Email>
  <LevelCollection Copyright="Eric F Tchong" MaxWidth="48" MaxHeight="35">
    <Level Id="hello cosmac 9" Width="21" Height="13">
      <L> ###################</L>
      <L> #        #@# .....#</L>
      <L> # $ $ $$ #$# .###.#</L>
      <L> #####  $ # ##.# #.#</L>
      <L>     #$   #  #.# #.#</L>
      <L>###### $$## $#.## .#</L>
      <L># $ $  $  $        #</L>
      <L>#     #      # ### #</L>
      <L># $$$  $ $ $   #..  #</L>
      <L>##     #########..  #</L>
      <L> ######        #..  #</L>
      <L>               #.  #</L>
      <L>               #####</L>
    </Level>
    <Level Id="Chase a dragon" Width="20" Height="17">
      <L> ###################</L>
      <L> #                 #</L>
      <L> #$# #$  $$$$$ ### #</L>
      <L> # #$# # $ # $ # # #</L>
      <L> # # #   $@# $   # #</L>
      <L>## $     ### ###$# #</L>
      <L>#  #$# # $       $ #</L>
      <L># $# #$# ####$ $   #</L>
      <L>#  $ $ #$# $  ###$ #</L>
      <L>#                  #</L>
      <L>################# ##</L>
      <L>   #     #..       #</L>
      <L>   #... #..###. # ##</L>
      <L>   # #.  ...##..   #</L>
      <L>   #  .... ......  #</L>
      <L>   #######  ..######</L>
      <L>         ###########</L>
    </Level>
    <Level Id="Sparkling Tours" Width="19" Height="16">
      <L> ###########</L>
      <L> #   # #   #</L>
      <L> # $   # # #</L>
      <L> # $$ $# # #</L>
      <L> #  $  #$#  #</L>
      <L> ##### $@$  #</L>
      <L>    #  #$#  ####</L>
      <L>    # $# #$ $  #</L>
      <L>    #  $ $ $## ####</L>
      <L>    #       $  ...#</L>
      <L>    #### ########.#</L>
      <L>     # $ ...#.....#</L>
      <L>#####. . .........#</L>
      <L># $ $ $#$#######$$#</L>
      <L>#                 #</L>
      <L>###################</L>
    </Level>
    <Level Id="Rembrandt Rooms" Width="15" Height="16">
      <L>#############</L>
      <L>#  @#   #   #</L>
      <L>#.$$# $   # #</L>
      <L>#...# $$ $# #</L>
      <L>#.$$#  $  # #</L>
      <L>#.$.## ## $ #</L>
      <L>#    $ #  #$#</L>
      <L># $#   # $# #</L>
      <L>#  #$$$#  $ ###</L>
      <L>#  #   #    ..#</L>
      <L>####   #### ..#</L>
      <L>   #   #  $ ..#</L>
      <L>   #####. . ..#</L>
      <L>   # $ $ $#$..#</L>
      <L>   #     .....#</L>
      <L>   ############</L>
    </Level>
    <Level Id="Horse" Width="19" Height="13">
      <L>    ###############</L>
      <L>    ###   #       #</L>
      <L>    #  .$   $ $$$ #</L>
      <L>    #.*$$$ $  $@$ #</L>
      <L>#####.   $  # #####</L>
      <L>#.....$# # $$ #</L>
      <L>#..... $ #  #$#</L>
      <L>#....##### $# #</L>
      <L>#.#..#   #  $ ###</L>
      <L>#.#..#   # #    #</L>
      <L>######   # $$$$ #</L>
      <L>         #     ##</L>
      <L>         ########</L>
    </Level>
    <Level Id="Ride a donkey" Width="14" Height="13">
      <L>   ###########</L>
      <L>   # ..  #   #</L>
      <L>   # $ # $ $ #</L>
      <L>   # #..  $  #</L>
      <L>###    .#. # #</L>
      <L># $  #$.# $$ #</L>
      <L># $$ # .*  # #</L>
      <L>#@  ##$.# $# #</L>
      <L>#####...$  $ #</L>
      <L>    #####$#  #</L>
      <L>    #...  $. #</L>
      <L>     ###     #</L>
      <L>        ######</L>
    </Level>
    <Level Id="Coffee break" Width="8" Height="11">
      <L>   ####</L>
      <L>### ..##</L>
      <L>#  $$$ #</L>
      <L># ..$..#</L>
      <L># .#.#.#</L>
      <L># .* . #</L>
      <L>#   $$ #</L>
      <L>#  $@$ #</L>
      <L># $#$$ #</L>
      <L>#  #   #</L>
      <L>########</L>
    </Level>
    <Level Id="Have a beer" Width="8" Height="9">
      <L>###</L>
      <L>#.######</L>
      <L>#..$   #</L>
      <L>#. $ # #</L>
      <L>#.$ $$ #</L>
      <L>#. $@$ #</L>
      <L>#.*#$$ #</L>
      <L>#..    #</L>
      <L>########</L>
    </Level>
    <Level Id="Strip poker" Width="9" Height="8">
      <L>#######</L>
      <L>#  ...#</L>
      <L># $.$*###</L>
      <L>#  .*.$ #</L>
      <L>###.$@$ #</L>
      <L>  #.$$$ #</L>
      <L>  #     #</L>
      <L>  #######</L>
    </Level>
    <Level Id="Warming up" Width="9" Height="8">
      <L>#####</L>
      <L>#  .#</L>
      <L># $ .#</L>
      <L>#  $ .###</L>
      <L>## .$@$ #</L>
      <L>  ### # #</L>
      <L>    #   #</L>
      <L>    #####</L>
    </Level>
    <Level Id="Locomotive from the past" Width="24" Height="17">
      <L>                ######</L>
      <L>                #****#</L>
      <L>##########       #**#</L>
      <L>#........#       #**#</L>
      <L>#.$$$$$$.#        ##</L>
      <L>#. $    .###########</L>
      <L> #.$$$$$............###</L>
      <L> #.$    $ $$$$$$$$$ $.#</L>
      <L> #.$ $$$$ $@       $$ .#</L>
      <L> #.$      $$$$$$$$   $.#</L>
      <L>#. $$$$$$$$      $$$$$#</L>
      <L>#. $      $ $ $$     .#</L>
      <L> ##..***.######..*.*.##</L>
      <L>   #..*.#      #....#</L>
      <L>   #....#      #....#</L>
      <L>    #..#        #..#</L>
      <L>    ####        ####</L>
    </Level>
    <Level Id="Locomotive II oldie" Width="24" Height="17">
      <L>                ######</L>
      <L>                #****#</L>
      <L>##########       #**#</L>
      <L>#        #       #**#</L>
      <L># $**** $#        ##</L>
      <L>#  *  *  ###########</L>
      <L> # *  * *   * * *** ###</L>
      <L> # *@ * * $ *   *     #</L>
      <L> # *  * * *** * ***$   #</L>
      <L> # *  * * * * * *     .#</L>
      <L># $**** * *** *$***$  #</L>
      <L>#      $             .#</L>
      <L> ##.     ######.     ##</L>
      <L>   #    #      #    #</L>
      <L>   #    #      #    #</L>
      <L>    #..#        #..#</L>
      <L>    ####        ####</L>
    </Level>
    <Level Id="Sweet Soko ! train" Width="24" Height="17">
      <L>                ######</L>
      <L>                #****#</L>
      <L>##########       #**#</L>
      <L>#        #       #**#</L>
      <L># $$$$$$ #        ##</L>
      <L>#@$ $ $ $###########</L>
      <L> #$   $  $ $ $ $  $.###</L>
      <L> #...$$ $ . $ $ $ $.  #</L>
      <L> #.$$  $  .$$  $  $.$  #</L>
      <L> #...$...$. . ...$ .$  #</L>
      <L># $$. .$. .. $.$.$ $ $#</L>
      <L># ...$...$.$.$...$ .  #</L>
      <L> ## $ $$ ###### $ $  ##</L>
      <L>   #....#      #....#</L>
      <L>   #.$ .#      #.$ .#</L>
      <L>    #..#        #..#</L>
      <L>    ####        ####</L>
    </Level>
    <Level Id="Time for strawberries" Width="21" Height="15">
      <L>##########   ####</L>
      <L>#        #  ##  #</L>
      <L># $ $ $$$####  .#</L>
      <L># $$$$$  #      ####</L>
      <L># $  $  $#  ...  ..#</L>
      <L>#   $$ $ ..   . ...##</L>
      <L># $$ @$  #.  ..   ..#</L>
      <L>#  $$$ $ #. ..# ####</L>
      <L># $$  $  $. .#  #</L>
      <L># $  $$$ #. ..# ##</L>
      <L>#    $  $#.  ..  ###</L>
      <L>####$$$  ...  ..  . #</L>
      <L>   #  $$ #      .  .#</L>
      <L>   #     #..########</L>
      <L>   ##########</L>
    </Level>
    <Level Id="Crazy tricks" Width="12" Height="14">
      <L>   #####</L>
      <L>####...#</L>
      <L>#..$$$.####</L>
      <L>#..  $ $..#</L>
      <L>#.$ $$$ ..##</L>
      <L>#.$$ # $...#</L>
      <L>#.$ #  #####</L>
      <L>#.$ # $  $.#</L>
      <L>#.$     $..#</L>
      <L>#.$$$$$$####</L>
      <L>#.$     ...#</L>
      <L>#$$$$$$$$$.#</L>
      <L>#..    @...#</L>
      <L>############</L>
    </Level>
    <Level Id="Creative sokobaning" Width="23" Height="14">
      <L>   #####  #########</L>
      <L>####...#  #       ##</L>
      <L>#......#### $ $ $$ #</L>
      <L>#.........#   ##   #</L>
      <L>#.........##$  #$$ #</L>
      <L># $ $   $  #   #   #</L>
      <L># ### $#####$  #$ ##</L>
      <L>#   #         # $ #</L>
      <L># $  $ $#  #$ #   #</L>
      <L># ####  #  #  # # ##</L>
      <L>#    ##$##$#$ # #  ###</L>
      <L>####       # $$$$$$  ##</L>
      <L>   #########         @#</L>
      <L>           ############</L>
    </Level>
    <Level Id="Tangerine" Width="14" Height="11">
      <L>     #####</L>
      <L>######...#</L>
      <L>#   #. $.###</L>
      <L># $ $ $ $ .#</L>
      <L># ###.$#. .###</L>
      <L>#   #. . ..$ #</L>
      <L># $    $#$ $ #</L>
      <L># ####  #  # #</L>
      <L>#    ##$##$  #</L>
      <L>####@      ###</L>
      <L>   #########</L>
    </Level>
    <Level Id="Cascabel" Width="24" Height="16">
      <L>   ######      ####</L>
      <L>   #     #######  ######</L>
      <L>   #$ $  #             #</L>
      <L>   #  $ $ $$##### #    #</L>
      <L>####$$$$$$      # ### ##</L>
      <L>#        $$ #....      #</L>
      <L># $$$$$$$$  #...####   #</L>
      <L># $ $ $ $ $ #...#### ###</L>
      <L>#      @    #...#### #</L>
      <L>#################### #</L>
      <L>      #....######### #</L>
      <L>      #....######### #</L>
      <L>      #.....          #</L>
      <L>      #   #.          #</L>
      <L>      #      ######   #</L>
      <L>      #################</L>
    </Level>
    <Level Id="Double L" Width="23" Height="15">
      <L>        ######</L>
      <L>   #####     #</L>
      <L>   #     ##$ #</L>
      <L>####$$$$$    #</L>
      <L>#         ..#</L>
      <L># ## #####.##</L>
      <L>#     ####.##</L>
      <L>##########.##</L>
      <L>    #   .#.##########</L>
      <L>    #   .#          #</L>
      <L>    #  #.  ########$###</L>
      <L>    #  #.   $ $ $ $ $ #</L>
      <L>    #   .. #          #</L>
      <L>    #  ############  @#</L>
      <L>    ####          #####</L>
    </Level>
    <Level Id="Be smart" Width="14" Height="12">
      <L>   ##########</L>
      <L>####.....   #</L>
      <L>#.....      #</L>
      <L># ## ##### ###</L>
      <L>#          $ #</L>
      <L>#####$ $ # # #</L>
      <L>    #    # $ #</L>
      <L>    #$ $ # $@#</L>
      <L>    #  # #  ##</L>
      <L>    #$$# $   #</L>
      <L>    #     ####</L>
      <L>    #######</L>
    </Level>
    <Level Id="Be smart again" Width="14" Height="12">
      <L>   ##########</L>
      <L>####.....   #</L>
      <L>#.....      #</L>
      <L># ## ##### ###</L>
      <L>#          $ #</L>
      <L>#####$ $ # # #</L>
      <L>    #  # # $ #</L>
      <L>    #$ $ # $@#</L>
      <L>    #  # #  ##</L>
      <L>    #$$# $   #</L>
      <L>    #     ####</L>
      <L>    #######</L>
    </Level>
    <Level Id="15 To go" Width="14" Height="12">
      <L>#############</L>
      <L>#           #</L>
      <L># .....$ $  #</L>
      <L># #####$$$####</L>
      <L># # # #   #  #</L>
      <L># .....   #$ #</L>
      <L># # # #$$$#  #</L>
      <L># .....   #$@#</L>
      <L># # # # $$#  #</L>
      <L># # #$#$   $ #</L>
      <L>#   #     ####</L>
      <L>###########</L>
    </Level>
    <Level Id="Anti magnetic levitator" Width="21" Height="23">
      <L>     ###########</L>
      <L>     #.........#</L>
      <L>     #.   .   .#</L>
      <L>     #.   .   .#</L>
      <L>     #.. ### ..#</L>
      <L>     #.       .#</L>
      <L>     #.........#</L>
      <L>     # .     . #</L>
      <L>     # ..   .. #</L>
      <L>     # .  @  . #</L>
      <L>     # ....... #</L>
      <L>     ##### #####</L>
      <L>     #    $    #</L>
      <L>     #   $ $   #</L>
      <L>######  $ $ $  ######</L>
      <L>#      $ $ $ $      #</L>
      <L>#     $ $ $ $ $     #</L>
      <L>#    $ $ $ $ $ $    #</L>
      <L>#   $ $ $ $ $ $ $   #</L>
      <L>#  $ $ $ $ $ $ $ $  #</L>
      <L># $ $ $ $ $ $ $ $ $ #</L>
      <L>#                   #</L>
      <L>#####################</L>
    </Level>
    <Level Id="Pine tree" Width="21" Height="23">
      <L>          #</L>
      <L>     #####@#####</L>
      <L>     #    $    #</L>
      <L>     #   $.$   #</L>
      <L>    ##  $.$.$  ##</L>
      <L>    #  $.$.$.$  #</L>
      <L>   #  $.$.$.$.$  #</L>
      <L>  #  $.$.$.$.$.$  #</L>
      <L>##  $.$.$.$.$.$.$  ##</L>
      <L>#  $.$.$.$.$.$.$.$  #</L>
      <L># $.$.$.$.$.$.$.$.$ #</L>
      <L>#                   #</L>
      <L>########## ##########</L>
      <L>         #.#</L>
      <L>         #.#</L>
      <L>         #.#</L>
      <L>         #.#</L>
      <L>         #.#</L>
      <L>         #.#</L>
      <L>         #.#</L>
      <L>         #.#</L>
      <L>         #.#</L>
      <L>         ###</L>
    </Level>
    <Level Id="Move the top" Width="21" Height="14">
      <L>          #</L>
      <L>     #####@#####</L>
      <L>     #    $    #</L>
      <L>     #   * *   #</L>
      <L>    ##  * * *  ##</L>
      <L>    #  * * * *  #</L>
      <L>   #  * * * * *  #</L>
      <L>  #  * * * * * *  #</L>
      <L>##  * * * * * * *  ##</L>
      <L>#  * * * * * * * *  #</L>
      <L># * * * * * * * * * #</L>
      <L>#                   #</L>
      <L>##########.##########</L>
      <L>          #</L>
    </Level>
    <Level Id="Uri Geller Crystals" Width="21" Height="13">
      <L>         ###</L>
      <L>        #   #</L>
      <L>       #  #  #</L>
      <L>    #### $#. ####</L>
      <L>    #   $ # .   #</L>
      <L>   #   $ $#. .   #</L>
      <L>  #   $ $ # . .   #</L>
      <L>##   $ $ $#. . .   ##</L>
      <L>#   $ $ $ # . . .   #</L>
      <L>#  $ $ $  @  . . .  #</L>
      <L># $ $ $ $ # . . . . #</L>
      <L>#         #         #</L>
      <L>#####################</L>
    </Level>
    <Level Id="Uri Geller Crystals II" Width="21" Height="13">
      <L>         ###</L>
      <L>        #   #</L>
      <L>       #  #  #</L>
      <L>    #### $#. ####</L>
      <L>    #   $ # .   #</L>
      <L>   #   $ $#. .   #</L>
      <L>  #   $ $ # . .   #</L>
      <L>##   $ $ $#. . .   ##</L>
      <L>#   $ $ $ # . . .   #</L>
      <L>#  $ $ $ $@. . . .  #</L>
      <L># $ $ $ $ # . . . . #</L>
      <L>#         #         #</L>
      <L>#####################</L>
    </Level>
    <Level Id="Quicksand" Width="18" Height="10">
      <L> ######</L>
      <L>##     #########</L>
      <L># $$$$.........#</L>
      <L>#    $ #.# $$$.#</L>
      <L># $  $#  $$$ ..##</L>
      <L># $$$  $$$. #...#</L>
      <L># $  #@$  ..... ##</L>
      <L>#  $$$$$ #####...#</L>
      <L>##       #    #.##</L>
      <L>##########    ###</L>
    </Level>
    <Level Id="Tropical Serenaders" Width="18" Height="15">
      <L>##################</L>
      <L>#                #</L>
      <L># $$$$$$  $$$#.. #</L>
      <L># $  $ $# #  ##. #</L>
      <L># $  $ $  #  .#. #</L>
      <L># $$$  $#$#$ #.. #</L>
      <L># $   @$     #.. #</L>
      <L># #$$$$$###$ .#* #</L>
      <L># #          *#. #</L>
      <L>###$$$$$####..#..#</L>
      <L>  #         ..#..#</L>
      <L>  ##########.....#</L>
      <L>           #.....#</L>
      <L>           #.....#</L>
      <L>           #######</L>
    </Level>
    <Level Id="Windmills of your mind" Width="15" Height="15">
      <L>###############</L>
      <L>#             #</L>
      <L># .$. ### .$. #</L>
      <L># $ $. # .$ $ #</L>
      <L># .$ $. .$    #</L>
      <L># #.$ $.$ #.# #</L>
      <L># $ .$.$. ... #</L>
      <L># $$$.$@$.#.# #</L>
      <L># $  $.$.$.   #</L>
      <L># # $. .$ $.  #</L>
      <L>#  $.###.$ $. #</L>
      <L># $. #  #.$ $ #</L>
      <L>#  $.#  # .$. #</L>
      <L>#             #</L>
      <L>###############</L>
    </Level>
    <Level Id="Cliffhanger" Width="15" Height="16">
      <L>####</L>
      <L>#   #</L>
      <L># .$.#</L>
      <L># $ $.#</L>
      <L>##.$ $.#</L>
      <L>  #.$ $.#</L>
      <L>   #.$ $.#</L>
      <L>    #.$@$.#</L>
      <L>     #.$ $.#</L>
      <L>      #.$ $.#</L>
      <L>       #.$ $.#</L>
      <L>        #.$ $ #</L>
      <L>         #.$. #</L>
      <L>          #   #</L>
      <L>          #   #</L>
      <L>          #####</L>
    </Level>
    <Level Id="Cliffhanger II" Width="15" Height="16">
      <L>####       ####</L>
      <L>#   #     #   #</L>
      <L># .$.#   #.$. #</L>
      <L># $ $.# #.$   #</L>
      <L>##.$ $.#.$ $.##</L>
      <L>  #.$ $.$ $.#</L>
      <L>   #.$ $.$.#</L>
      <L>    #.$@$.#</L>
      <L>   #.$.$ $.#</L>
      <L>  #.$ $.$ $.#</L>
      <L> #.$ $.#.$ $.#</L>
      <L># $ $.# #.$ $ #</L>
      <L># . .#   #.$. #</L>
      <L>#   #     #   #</L>
      <L>#  #      #   #</L>
      <L>####      #####</L>
    </Level>
    <Level Id="Smart moves" Width="15" Height="13">
      <L> ###       ###</L>
      <L> #..#     #..#</L>
      <L> #...#   #...#</L>
      <L> #.. .###. ..#</L>
      <L> #..       ..#</L>
      <L>  # $ $ $ $ #</L>
      <L>   # $   $ #</L>
      <L>    # $ $ #</L>
      <L>    #  $  #</L>
      <L>##### $ $ #####</L>
      <L># $ $$$$$$$ $ #</L>
      <L>#            @#</L>
      <L>###############</L>
    </Level>
    <Level Id="Crown maker" Width="15" Height="15">
      <L>    #######</L>
      <L>   ##     ##</L>
      <L>   #  .$.  #</L>
      <L>    #. . .#</L>
      <L>    ##...##</L>
      <L>   # ..*.. #</L>
      <L>   #  $ $  #</L>
      <L>   ## ### ##</L>
      <L>    #  #  #</L>
      <L>    # $#$ #</L>
      <L>    #  #  #</L>
      <L>#####  #  #####</L>
      <L># $ $ $$$ $ $ #</L>
      <L>#            @#</L>
      <L>###############</L>
    </Level>
    <Level Id="Lift up your heart" Width="13" Height="17">
      <L>   ##   ##</L>
      <L>   #.###.#</L>
      <L> ##. .#. .##</L>
      <L> #.   .   .#</L>
      <L> # .  #  . #</L>
      <L> ###. # .###</L>
      <L>  #  .#.  #</L>
      <L>  #   .   #</L>
      <L>####$ # $####</L>
      <L>#  $ $#$ $  #</L>
      <L># $   $   $ #</L>
      <L>#  $  #  $  #</L>
      <L>### $ # $ ###</L>
      <L>   # $#$ #</L>
      <L>   #  $  #</L>
      <L>   ## @ ##</L>
      <L>     ###</L>
    </Level>
    <Level Id="Each stone in the same place" Width="19" Height="14">
      <L>   #######</L>
      <L>   #     #</L>
      <L>####$ # $####</L>
      <L>#  $ $ $ $  #</L>
      <L># $   $   $ #</L>
      <L>#  $  #  $  #####</L>
      <L>### $ # $ #.#  .#</L>
      <L>   # $#$ #. . . .#</L>
      <L>   #  $  .   .   .#</L>
      <L>   ## @ ##.  #  .#</L>
      <L>     ### # . # .#</L>
      <L>         #  .#.#</L>
      <L>         #   .#</L>
      <L>         ######</L>
    </Level>
    <Level Id="Blocking bones" Width="17" Height="14">
      <L>   #######</L>
      <L>   #    @##</L>
      <L>  ## $#$$  ##</L>
      <L>  #   $  $  #</L>
      <L>  # $ #  $ $#</L>
      <L>  # $$ $ $  #</L>
      <L>####  # # #$#####</L>
      <L>#..# $ $ #      #</L>
      <L>#..#  $      $$ #</L>
      <L>#..###  ##$$ #  #</L>
      <L>#....###.# $ #$ #</L>
      <L>#......... $$   #</L>
      <L>#...    .###  # #</L>
      <L>#################</L>
    </Level>
    <Level Id="Lighting parade" Width="23" Height="14">
      <L>####################</L>
      <L>#    #     ##......#</L>
      <L>#  $$$ $#$$  $#....####</L>
      <L>##  $   $  $  #.......#</L>
      <L> #  $ $ #  $ $#.......#</L>
      <L> # $$  $ $ $  #.......#</L>
      <L>#   #$  # # #$#####...#</L>
      <L># $ $  $ $ #      #...#</L>
      <L># $ $$$ $   $ ##$ #...#</L>
      <L># $  $ $  ## $ #  #...#</L>
      <L># # $  $$$ # $@#$ #...#</L>
      <L># $ $$ $ $   $$ $ ....#</L>
      <L>###        #      #   #</L>
      <L>  #####################</L>
    </Level>
    <Level Id="Antartica" Width="23" Height="14">
      <L>####################</L>
      <L>#                 .#</L>
      <L>#  ##$$$ $$### $ $.####</L>
      <L>## #   $$$  $  ###....#</L>
      <L> # # ###  # #$$$  ....#</L>
      <L> # $      $  $ $$ ....#</L>
      <L>#  $ $###$$$    $$*...#</L>
      <L># #$$$   $ $$$# # ....#</L>
      <L>#    $#  $  #   $$*...#</L>
      <L># $$ $ # #  ## $$ #...#</L>
      <L>#  $     $$ # @#......#</L>
      <L>#  $$$ $$#    ........#</L>
      <L>###        #......#...#</L>
      <L>  #####################</L>
    </Level>
    <Level Id="Easy Arithmetic" Width="23" Height="33">
      <L>#####################</L>
      <L>#                   #</L>
      <L># $ $$$ $$$ $   $$$ #</L>
      <L># $   $   $ $ $ $   #</L>
      <L># $ $$$ $$$ $$$ $$$ #</L>
      <L># $ $     $   $   $ #</L>
      <L># $ $$$ $$$   $ $$$ ###</L>
      <L>#                     #</L>
      <L># $$$ $$$  $   $   $  #</L>
      <L># $     $ $ $ $ $ $ $ #</L>
      <L># $$$  $   $   $  $ $ #</L>
      <L># $@$  $  $ $   $ $ $ #</L>
      <L># $$$  $   $   $   $  #</L>
      <L>#                     #</L>
      <L>## ####################</L>
      <L>#                     #</L>
      <L># . .     . . .   . . #</L>
      <L>#  .   .   .       .  #</L>
      <L># . .     . .   . . . #</L>
      <L>#                     #</L>
      <L># . . .   . . . . . . #</L>
      <L>#  .       .       .  #</L>
      <L># . .   . . . . . . . #</L>
      <L>#                     #</L>
      <L># . . . . .   . . . . #</L>
      <L>#  .   .       .   .  #</L>
      <L># . . . .   . . . . . #</L>
      <L>#                     #</L>
      <L># . . . . . . . . . . #</L>
      <L>#  .   .   .   .   .  #</L>
      <L># . . . . . . . . . . #</L>
      <L>#                     #</L>
      <L>#######################</L>
    </Level>
    <Level Id="Stone age Arithmetic" Width="26" Height="35">
      <L>#####################</L>
      <L>#                   #</L>
      <L># $ $$$ $$$ $   $$$ #</L>
      <L># $   $   $ $ $ $   #</L>
      <L># $ $$$ $$$ $$$ $$$ #</L>
      <L># $ $     $   $   $ #</L>
      <L># $ $$$#$$$## $#$$$ ###</L>
      <L>#                     #</L>
      <L># $$$ $$$  $   $   $  #</L>
      <L># $     $ $ $ $ $ $ $ #</L>
      <L># $$$  $   $   $  $ $ ###</L>
      <L># $@$  $  $ $   $ $ $   #</L>
      <L># $$$# $#  $#  $#  $# # #</L>
      <L>#                        #</L>
      <L>################### ##   #</L>
      <L> #                   # ###</L>
      <L> #. .     . . .   . .# #</L>
      <L> # .   .   .       . # #</L>
      <L> #. .     . .   . . .# #</L>
      <L> ##################  # #</L>
      <L> #. . .   . . . . . .# #</L>
      <L> # .       .       . # #</L>
      <L> #. .   . . . . . . .# #</L>
      <L>###################### #</L>
      <L># . . . . .   . . . .# #</L>
      <L>#  .   .       .   . # #</L>
      <L># . . . .   . . . . .# #</L>
      <L>#  ################### #</L>
      <L># . . . . . . . . . .# #</L>
      <L>#  .   .   .   .   . # #</L>
      <L># . . . . . . . . . .# #</L>
      <L>## ###################  #</L>
      <L> #                      #</L>
      <L> #  #####################</L>
      <L> ####</L>
    </Level>
    <Level Id="Sqrt 30 = 5.4772255" Width="48" Height="12">
      <L>##################</L>
      <L>#                #</L>
      <L>#      $$$$$$$$$ #</L>
      <L># $    $         ###############################</L>
      <L># $    $ $$$ $$$      ...###.###...#...#...#...#</L>
      <L># $$   $   $ $ $ $$$  .     . .   .   .   .   .#</L>
      <L>#  $   $ $$$ $ $      ...#  ...#  .#  . ... ...#</L>
      <L>#  $$ $$   $ $@$ $$$    .     .   .   . .## .###</L>
      <L>#   $ $  $$$ $$$      ... . ##. ##. ##. ... ...#</L>
      <L>#   $$$          ###############################</L>
      <L>#                #</L>
      <L>##################</L>
    </Level>
    <Level Id="Danger 117 VAC" Width="27" Height="15">
      <L>###########################</L>
      <L>###.###.##... .#.##.##...##</L>
      <L>##..  ..####.#.#.#. .#. ###</L>
      <L>## . ##.#  .. .#.#...#. ###</L>
      <L>###.  #.# #.  .#.#. .#. ###</L>
      <L>##... ... #.# #. #. .#...##</L>
      <L>### # # # #   #  #   #  ###</L>
      <L>###  . . . . . . . . .   ##</L>
      <L># $$ # $ #$$$#$$$#$$$#$$ ##</L>
      <L># $ $ $ $ $ $ $   $   $@$ #</L>
      <L># $ $ $$$ $ $ $   $$  $$  #</L>
      <L># $ $ $ $ $ $ $ $ $   $ $ #</L>
      <L># $$  $ $ $ $ $$$ $$$ $ $ #</L>
      <L>#                         #</L>
      <L>###########################</L>
    </Level>
    <Level Id="Valero's Wall Down" Width="11" Height="15">
      <L>###########</L>
      <L>#.      ###</L>
      <L>##.....  .#</L>
      <L>#....##$$.#</L>
      <L>#.....#   #</L>
      <L>#..#.$. $ #</L>
      <L>##### #$ ##</L>
      <L>#        ##</L>
      <L># $$$#   ##</L>
      <L># $ $  #  #</L>
      <L># $ $ $#$ #</L>
      <L># $@$  #  #</L>
      <L># $$$ $#$ #</L>
      <L>#        ##</L>
      <L>###########</L>
    </Level>
    <Level Id="Lolly's in distress" Width="11" Height="14">
      <L>########</L>
      <L>#      ##</L>
      <L># #$##  #</L>
      <L>#  $   $###</L>
      <L>#  $$# $@ #</L>
      <L># ## # $$ #</L>
      <L># $  #    #</L>
      <L># $  # ####</L>
      <L># $$ # $ .#</L>
      <L>#    # $ .#</L>
      <L>###### $$.#</L>
      <L>#...     .#</L>
      <L>#.........#</L>
      <L>###########</L>
    </Level>
    <Level Id="Alf with vacation" Width="16" Height="12">
      <L>################</L>
      <L>#       ###    #</L>
      <L># $$$# $  #$$$ #</L>
      <L># $@$  $   $   #</L>
      <L># $$$# $ ##$$  #</L>
      <L># $ $  $   $  .#</L>
      <L># $ $# $$$#$  .#</L>
      <L>#    #...    .##</L>
      <L>#### #..#.#..###</L>
      <L>#...........####</L>
      <L>#####.....######</L>
      <L>################</L>
    </Level>
    <Level Id="Watch out cameraman!!!" Width="15" Height="12">
      <L>########</L>
      <L>###....#</L>
      <L># .....######</L>
      <L># ***..     #</L>
      <L>#   ######  #</L>
      <L>###      #$ #</L>
      <L>  #      # $#</L>
      <L>  ### ####$ #</L>
      <L> #          ###</L>
      <L> # $ $#$$$$$$ #</L>
      <L> ####        @#</L>
      <L>   ############</L>
    </Level>
    <Level Id="Drag race" Width="18" Height="14">
      <L>    #######</L>
      <L>    ##....#</L>
      <L>    #.....######</L>
      <L>#####***..#    #</L>
      <L>#......####    #</L>
      <L>#  ##   $ $ #$ #</L>
      <L>#   ##      # $#</L>
      <L>#   #### ####$ #</L>
      <L>## ##          ###</L>
      <L> # ## $ $#$$$$$$ #</L>
      <L> # ####         @#</L>
      <L> #    $$$$ #######</L>
      <L> #       ###</L>
      <L> #########</L>
    </Level>
    <Level Id="Smoothly" Width="15" Height="11">
      <L>         #####</L>
      <L>         #   #</L>
      <L>##########  $#</L>
      <L>#            #</L>
      <L># #...####  $#</L>
      <L># $  ...  $  #</L>
      <L>#### ...####$#</L>
      <L> ###$#  #### ##</L>
      <L> #    $  $ $  #</L>
      <L> #       #   @#</L>
      <L> ##############</L>
    </Level>
    <Level Id="Swinging lane" Width="15" Height="11">
      <L> ##############</L>
      <L> #..........  #</L>
      <L> ##########.# #</L>
      <L> #     .....$ #</L>
      <L> # $###.###$# #</L>
      <L> # $ $      $ #</L>
      <L>####    $  ## #</L>
      <L>#   $$$##$$## #</L>
      <L># $ $ $ $   $ #</L>
      <L>###@      #####</L>
      <L>###########</L>
    </Level>
  </LevelCollection>
</SokobanLevels>
