<?xml version="1.0" encoding="utf-8"?>
<SokobanLevels xmlns:xsi="http://www.w3.org/2001/XMLSchema-instance" xsi:schemaLocation="SokobanLev.xsd">
  <Title>Cosmac 6</Title>
  <Description>
New levels from Aruba. Enjoy!!!
  </Description>
  <Email>serenata@setarnet.aw</Email>
  <LevelCollection Copyright="Eric F Tchong" MaxWidth="34" MaxHeight="19">
    <Level Id="Here we go" Width="11" Height="9">
      <L>   ########</L>
      <L>   #      #</L>
      <L>#### #$## #</L>
      <L>#  $$...# #</L>
      <L>#  @ #.## #</L>
      <L>##$$$ ..# #</L>
      <L> #    ### #</L>
      <L> ####     #</L>
      <L>    #######</L>
    </Level>
    <Level Id="Andante" Width="11" Height="8">
      <L>   ########</L>
      <L>   #....  #</L>
      <L>#### ##.  #</L>
      <L># $ $  # ##</L>
      <L>#  @     #</L>
      <L>##$$$##  #</L>
      <L> #      ##</L>
      <L> ########</L>
    </Level>
    <Level Id="Pathfinder" Width="17" Height="10">
      <L>   ####       ##</L>
      <L> ####  #######  #</L>
      <L> #  $  $    ##$ #</L>
      <L> # ## ####$ #   #</L>
      <L>## ## ##    #  ##</L>
      <L>##...   $  # $  #</L>
      <L>##. $#### #  $  #</L>
      <L># ...#@$ $     ##</L>
      <L># ...#    ######</L>
      <L>###########</L>
    </Level>
    <Level Id="Remote control" Width="17" Height="10">
      <L>   ######     ##</L>
      <L> ##      #####..#</L>
      <L> #  $  $ $  #...#</L>
      <L> # ## #  #$ #.. #</L>
      <L>## ##$ # $  #..##</L>
      <L>##  $  ## #     #</L>
      <L>## $    #       #</L>
      <L># $   @        ##</L>
      <L>#    #    ######</L>
      <L>###########</L>
    </Level>
    <Level Id="High Speed Power" Width="17" Height="10">
      <L>   ######</L>
      <L> ##      #####</L>
      <L> #  $ $  $    #</L>
      <L> # ## #  #$##.#</L>
      <L>##$##$#$ #  #.###</L>
      <L>##  $ #  ## #...#</L>
      <L>## $  # $ $ ....#</L>
      <L># $  $@##   ....#</L>
      <L>#    #    ######</L>
      <L>###########</L>
    </Level>
    <Level Id="Casibari Rock Formation" Width="17" Height="10">
      <L>#################</L>
      <L>#               #</L>
      <L># #    $ $ $# # #</L>
      <L># # #@.###  $ $ #</L>
      <L># # .  $ ## # # #</L>
      <L># #           $ #</L>
      <L>###.$# #$#$#$ # #</L>
      <L>#....           #</L>
      <L>#....############</L>
      <L>#####</L>
    </Level>
    <Level Id="Duo Forms" Width="18" Height="12">
      <L>###</L>
      <L>#.#</L>
      <L>#.##############</L>
      <L>#.# ...........#</L>
      <L>#.# $ $ $ $ $#$#</L>
      <L>#.#######  $   #</L>
      <L>#.$     # $#@#$#</L>
      <L>#.  $ $    $   #</L>
      <L>#.# ########$#$###</L>
      <L>#.# $ $ $ $  $ $ #</L>
      <L>#.#              #</L>
      <L>##################</L>
    </Level>
    <Level Id="Watch out" Width="16" Height="10">
      <L>    ###########</L>
      <L>    #         #</L>
      <L>    # $.####  #</L>
      <L>##### #..* #  #</L>
      <L># $ $ #... $  #</L>
      <L>#     $....#  #</L>
      <L>##########$#$###</L>
      <L>       # $ $ $@#</L>
      <L>       #       #</L>
      <L>       #########</L>
    </Level>
    <Level Id="Side by side" Width="12" Height="12">
      <L> #########</L>
      <L> #       #</L>
      <L> #$ ###  #</L>
      <L>##  ..#$####</L>
      <L>#  $..$    #</L>
      <L># $#..# #$ #</L>
      <L>#  #..# #  #</L>
      <L># $#..#$#$ #</L>
      <L>#  #..  # @#</L>
      <L># $### $#$##</L>
      <L>#         #</L>
      <L>###########</L>
    </Level>
    <Level Id="Golf" Width="15" Height="15">
      <L>  ##</L>
      <L> #  ###########</L>
      <L> #........... #</L>
      <L> #.#########  #</L>
      <L> #.#       # #</L>
      <L> #.# $###$   #</L>
      <L> ###  $ #  # #</L>
      <L> #   $  #$ # #</L>
      <L> #  $# $#  # #</L>
      <L># $$ #  #$$# #</L>
      <L>#  @ #  #  # #</L>
      <L>####### $  # #</L>
      <L>  # $ $  #   #</L>
      <L>  #         ##</L>
      <L>  ###########</L>
    </Level>
    <Level Id="Grass hopper" Width="11" Height="7">
      <L>#########</L>
      <L>#       #</L>
      <L># $..* $@##</L>
      <L>#  #$   $ #</L>
      <L> #$...#*# #</L>
      <L> #        #</L>
      <L> ##########</L>
    </Level>
    <Level Id="Roobol" Width="10" Height="10">
      <L>####</L>
      <L>#.###</L>
      <L>#.   #</L>
      <L>#.$   ###</L>
      <L>#. #$   ##</L>
      <L>#. #@#   #</L>
      <L>#. #$##$ #</L>
      <L> #$   $  #</L>
      <L> #       #</L>
      <L> #########</L>
    </Level>
    <Level Id="K 7" Width="8" Height="9">
      <L>########</L>
      <L>#..  .##</L>
      <L># ##$$.#</L>
      <L># #  $ #</L>
      <L># #$@$ #</L>
      <L># $    #</L>
      <L>#  $## #</L>
      <L>#.   ..#</L>
      <L>########</L>
    </Level>
    <Level Id="Garden of Eden" Width="14" Height="12">
      <L>########</L>
      <L>#..    #</L>
      <L>#.# $  ###</L>
      <L># ###  ####</L>
      <L>#  $@$  $ #</L>
      <L># $###  $ ##</L>
      <L>#.$        ##</L>
      <L>#.. #####$ ##</L>
      <L>###### $ $ ###</L>
      <L>     #.$ $ ..#</L>
      <L>     #..   .##</L>
      <L>     ########</L>
    </Level>
    <Level Id="Dual splitter" Width="13" Height="9">
      <L>#####</L>
      <L>#. ##########</L>
      <L>#.$ $ $ $ $ #</L>
      <L>#.  @     #.#</L>
      <L>#. ########.#</L>
      <L>#.         .#</L>
      <L># $ $ $ $ $.#</L>
      <L>########## .#</L>
      <L>         ####</L>
    </Level>
    <Level Id="Who goes first?" Width="13" Height="8">
      <L>###########</L>
      <L>#         #</L>
      <L># $ ### $####</L>
      <L>##  ......# #</L>
      <L> #$# #$.#   #</L>
      <L> #    $ $ $ #</L>
      <L> #### @######</L>
      <L>     ###</L>
    </Level>
    <Level Id="Fun stuff" Width="10" Height="10">
      <L>  ######</L>
      <L>  #  ###</L>
      <L>###     ##</L>
      <L>#   ##$  #</L>
      <L># #....# #</L>
      <L># ..$$$$ #</L>
      <L>##.$  @# #</L>
      <L>#  $#### #</L>
      <L>###      #</L>
      <L>  ########</L>
    </Level>
    <Level Id="Watertower" Width="7" Height="13">
      <L>######</L>
      <L>#    #</L>
      <L># *#$#</L>
      <L># *  #</L>
      <L># *# #</L>
      <L># *  #</L>
      <L># *# ##</L>
      <L># * @ #</L>
      <L># * # #</L>
      <L># * # #</L>
      <L># .   #</L>
      <L>#     #</L>
      <L>#######</L>
    </Level>
    <Level Id="Haunted house" Width="11" Height="10">
      <L>#######</L>
      <L>#  #  #</L>
      <L># $#$ ###</L>
      <L>#@$     #</L>
      <L># $## # #</L>
      <L># $     ###</L>
      <L># $##$#####</L>
      <L>##      ..#</L>
      <L> ### .....#</L>
      <L>  #########</L>
    </Level>
    <Level Id="Valley of the dolls" Width="11" Height="8">
      <L>###########</L>
      <L>#     #   #</L>
      <L># $#$$$$$ #</L>
      <L># ...   $ #</L>
      <L># *## #$$@#</L>
      <L># ...   ###</L>
      <L># ...###</L>
      <L>#####</L>
    </Level>
    <Level Id="Volcano" Width="11" Height="10">
      <L>###########</L>
      <L># ....... #</L>
      <L># # ####  #</L>
      <L># #      @#</L>
      <L># ## $ $  #</L>
      <L>#  $ # ####</L>
      <L>####$ $  ##</L>
      <L>   # $ $ ##</L>
      <L>   #     ##</L>
      <L>   ########</L>
    </Level>
    <Level Id="Excellence" Width="11" Height="10">
      <L>###########</L>
      <L>#         #</L>
      <L># #$$$$##.#</L>
      <L># # #   #.#</L>
      <L>#     $ #.#</L>
      <L>#  $# #$#.#</L>
      <L>##$@$ #...#</L>
      <L> # $$$$...#</L>
      <L> #     ...#</L>
      <L>  #########</L>
    </Level>
    <Level Id="Rebuild to the right" Width="21" Height="14">
      <L>#############</L>
      <L>#         #  ########</L>
      <L>#  $$$ $$$#  ... ...#</L>
      <L># $$ $ $@ # ..#. .###</L>
      <L># $  $ $  # .##. .###</L>
      <L># $  $ $$$# .##. ...#</L>
      <L># # $$$   #   ...####</L>
      <L># # $ $$# ### . ..#</L>
      <L>#         #### ####</L>
      <L>######### #### ####</L>
      <L>      #           #</L>
      <L>      #           #</L>
      <L>      ##########  #</L>
      <L>               ####</L>
    </Level>
    <Level Id="Fill it smartly" Width="22" Height="14">
      <L>######################</L>
      <L>#         #          #</L>
      <L># $$$ $ $ # $ $ $ $$ #</L>
      <L>#   $ $ $@# $ $ $ $  #</L>
      <L># $############# ##  #</L>
      <L>#  #              #$ #</L>
      <L># $# $ $ $  ###   #  #</L>
      <L>#  $$$$ ##....#$  $ ##</L>
      <L>#     $ ......#..##.#</L>
      <L>####### ###..##..##.#</L>
      <L>  # $ $ ..#.#.......#</L>
      <L>  # $ $ ###.###.....#</L>
      <L>  #     #############</L>
      <L>  #######</L>
    </Level>
    <Level Id="Titanic" Width="23" Height="14">
      <L>#######################</L>
      <L>#                     #</L>
      <L># $$ ###$$$$$  # # ## #</L>
      <L>#  ## # $ @ $$$$$$$$  #</L>
      <L># ... # $ #   .....$$ #</L>
      <L># $$. # $$$.... ##..$ #</L>
      <L>#  $. #  .$.#######.$ #</L>
      <L>#  $. ## .$.#..  ##.$ #</L>
      <L>#  $...##...#.    ..  #</L>
      <L>#  $$$..#####.$$ ##.  #</L>
      <L>#    $$......$$  ##.. #</L>
      <L>#     $$$$$$$$  ##... #</L>
      <L>#                     #</L>
      <L>#######################</L>
    </Level>
    <Level Id="Dazzle the dazzle" Width="19" Height="14">
      <L>###################</L>
      <L>#   #..........   #</L>
      <L># $ #.#.###.###$$ #</L>
      <L># $ #..........$  #</L>
      <L># $ #.........#$$ #</L>
      <L># $  ####   ##    #</L>
      <L># $ $  $   $ # $$ #</L>
      <L># $  # $ #   #  $ #</L>
      <L># $ #  $###   # $ #</L>
      <L>#  ##  $ #  $ ##  #</L>
      <L># $ #  $@# $  # $ #</L>
      <L>#  $ #  $$$  #  $ #</L>
      <L>#     #     #     #</L>
      <L>###################</L>
    </Level>
    <Level Id="Question Mark ?" Width="10" Height="13">
      <L>#########</L>
      <L>#   .*. #</L>
      <L># #.# #.#</L>
      <L>#  . $ .#</L>
      <L># #  $ .#</L>
      <L> ### $.##</L>
      <L>    #.$ #</L>
      <L> ### . $@#</L>
      <L> # $ . $ #</L>
      <L> # $ # $ #</L>
      <L> #  $*$  #</L>
      <L> #       #</L>
      <L>  #######</L>
    </Level>
    <Level Id="Reverse it ?" Width="11" Height="15">
      <L>#########</L>
      <L>#   .*. #</L>
      <L># #.###.##</L>
      <L># .  $  .#</L>
      <L># .  $  .#</L>
      <L>###  $  .#</L>
      <L>   ## $.##</L>
      <L>### # .$@ #</L>
      <L>#   #.# $ #</L>
      <L># $ #.# $ #</L>
      <L># $  .  $ #</L>
      <L>#  $ # $  #</L>
      <L>### $*$ ###</L>
      <L>  #     #</L>
      <L>   #####</L>
    </Level>
    <Level Id="Reverse more ?" Width="11" Height="15">
      <L>#########</L>
      <L>#   .*. #</L>
      <L># #.###.##</L>
      <L># .  $  .#</L>
      <L># .  $  .#</L>
      <L>###  $  .#</L>
      <L>#####$$.##</L>
      <L>###  ..$  #</L>
      <L>#   #.# $ #</L>
      <L># $ #.# $ #</L>
      <L># $ #.# $ #</L>
      <L>#  $   $  #</L>
      <L>####$*$####</L>
      <L>  #  @  #</L>
      <L>  #######</L>
    </Level>
    <Level Id="Four L's" Width="20" Height="14">
      <L>####################</L>
      <L>#   #@ #####   #   #</L>
      <L># $  $$......$ #$$ #</L>
      <L># $ # $ .... $ # $ #</L>
      <L># $ # $ .... $ # $ #</L>
      <L># $ # $ .... $ # $ #</L>
      <L># $ # $ .... $ # $ #</L>
      <L># $ # $ .... $ # $ #</L>
      <L># $ # $ .... $ # $ #</L>
      <L># $ # $ .... $ # $ #</L>
      <L># $ # $ .... $ # $ #</L>
      <L># $$# $......$$  $ #</L>
      <L>#   #          #   #</L>
      <L>####################</L>
    </Level>
    <Level Id="Four L's Part 2" Width="20" Height="14">
      <L>####################</L>
      <L>#   #@######   #   #</L>
      <L># $  $$......$ #$$ #</L>
      <L># $ # $ .... $ # $ #</L>
      <L># $ # $ .... $ # $ #</L>
      <L># $ # $ .... $ # $ #</L>
      <L># $ # $ .... $ # $ #</L>
      <L># $ # $ .... $ # $ #</L>
      <L># $ # $ .... $ # $ #</L>
      <L># $ # $ .... $ # $ #</L>
      <L># $ # $ .... $ # $ #</L>
      <L># $$# $......$$  $ #</L>
      <L>#   #          #   #</L>
      <L>####################</L>
    </Level>
    <Level Id="Two UFO's" Width="20" Height="14">
      <L>####################</L>
      <L>#    @########     #</L>
      <L># $ $ ##....## $ $ #</L>
      <L># $ $ ##....## $ $ #</L>
      <L># $ $ ##....## $ $ #</L>
      <L># $ $ ##....## $ $ #</L>
      <L># $ $ ##....## $ $ #</L>
      <L># $ $ ##....## $ $ #</L>
      <L># $ $ ##....## $ $ #</L>
      <L># $ $ ##....## $ $ #</L>
      <L># $ $  ......  $ $ #</L>
      <L># $$$$ ...... $$$$ #</L>
      <L>#   #          #   #</L>
      <L>####################</L>
    </Level>
    <Level Id="Big square" Width="20" Height="14">
      <L>####################</L>
      <L>#..................#</L>
      <L>#.$$$#   ##   # $ .#</L>
      <L>#.  $ #   #   $$$ .#</L>
      <L>#.$#$  #  # # $  $.#</L>
      <L>#.$ $$      $$$ $$.#</L>
      <L>#.$  $$$ #  $   $ .#</L>
      <L>#.$    $$@# $ # $#.#</L>
      <L>#.$$# # $$$$$   $ .#</L>
      <L>#. $        # # $ .#</L>
      <L>#. $$$##$$$    $$#.#</L>
      <L>#. #    $ $$$$$$  .#</L>
      <L>#..................#</L>
      <L>####################</L>
    </Level>
    <Level Id="Sweet duck's" Width="20" Height="13">
      <L>   #############</L>
      <L>   #...#...#...#</L>
      <L>####  .   .   .#####</L>
      <L>#     ..  ..  ..   #</L>
      <L># $$##$$##$$##$$####</L>
      <L>#  $...$...$...$   #</L>
      <L> # $$$.$$$.$$$.$$$ #</L>
      <L> #    ..  ..  ..   #</L>
      <L> #$$##$$##$$##$$####</L>
      <L>#@ $...$   $...$   #</L>
      <L> # $$$.$$$ $$$.$$$ #</L>
      <L> #    ..      ..   #</L>
      <L> ###################</L>
    </Level>
    <Level Id="Golden Suites" Width="21" Height="13">
      <L>#####################</L>
      <L>#...        ...#... #</L>
      <L>#...$$ $  $ ...#... #</L>
      <L>#... $  #  $...#... #</L>
      <L>######$ ###### ### ##</L>
      <L>#  ###  $ $    #   ##</L>
      <L># $  # $     #      #</L>
      <L>#  $ ####### ##$$$# #</L>
      <L>#   $            $  #</L>
      <L>#@ $ ####### ### $ ##</L>
      <L> # $ $ $ $ $ $ # $$##</L>
      <L> #                  #</L>
      <L> ####################</L>
    </Level>
    <Level Id="Dynamite" Width="21" Height="13">
      <L>#####################</L>
      <L>#.... .#            #</L>
      <L>#..   .#  $ $ $ ### #</L>
      <L>#... . ## # ###$### #</L>
      <L>####.#  # $ ###   # #</L>
      <L>#  #.## ### ### $ # #</L>
      <L>#  #.##         $ # #</L>
      <L># $# ## ##### #$  # #</L>
      <L>#  # ## #   # #   # #</L>
      <L>#@$# ## # $ # ##### #</L>
      <L># $       $    $ $  #</L>
      <L>#  #  ### # ##   ####</L>
      <L>#####################</L>
    </Level>
    <Level Id="Quick &amp; Smart fill" Width="21" Height="16">
      <L>########     ########</L>
      <L># .....#######..... #</L>
      <L># #....   #   ....# #</L>
      <L>#  #...   #   ...#  #</L>
      <L>#   #..   #   ..#   #</L>
      <L># $  #.   #   .#  $ #</L>
      <L># $   #.  .  .#   $ #</L>
      <L># $    #.   .#    $ #</L>
      <L># $     #   #     $ #</L>
      <L># $$$$$$ # # $$$$$$ #</L>
      <L>#                   #</L>
      <L>########## ##########</L>
      <L>#                   #</L>
      <L>#  $$$$$$$$$$$$$$$  #</L>
      <L>#@                  #</L>
      <L>#####################</L>
    </Level>
    <Level Id="Take a walk" Width="20" Height="14">
      <L>             #######</L>
      <L>             #  @  #</L>
      <L> ######      # $#$ #</L>
      <L> ##   ########  #  #</L>
      <L> #.        # # $#$ #</L>
      <L>## .####   # #  #  #</L>
      <L>#.  . ### #### $#$ #</L>
      <L>##. #   # #  #  #  #</L>
      <L> #.     # # $#$$#$ #</L>
      <L> ##.#...# #        #</L>
      <L>   ##...#$##$ ######</L>
      <L>    ##### $   #</L>
      <L>        #   ###</L>
      <L>         ####</L>
    </Level>
    <Level Id="Mexico city" Width="20" Height="14">
      <L>      #######</L>
      <L>      #      #######</L>
      <L>      # $    $     #</L>
      <L>     ####### # #$# #</L>
      <L> #####   ..# $ #   #</L>
      <L>#       ...# # #$# #</L>
      <L>#  ##.....## $ #   #</L>
      <L>#   ##....# $# #$# #</L>
      <L>##   ##...#  # # $ #</L>
      <L>##    ##### $# #   #</L>
      <L># $#$          # ###</L>
      <L>#  $ $###$$$  ####</L>
      <L>#@      #     #</L>
      <L>###############</L>
    </Level>
    <Level Id="Brain teaser" Width="20" Height="13">
      <L>             #######</L>
      <L>#############      #</L>
      <L>#     ##   #     $ #</L>
      <L>## ##  $$ $#  ##$  #</L>
      <L>#             # $$ #</L>
      <L>#  ##        #  $  #</L>
      <L>#    # $$$$$#  $ $ #</L>
      <L>##    #     #@$    #</L>
      <L>##    ##  ## $$ $$ #</L>
      <L>#.......#   $    ###</L>
      <L>#.......# ##  ####</L>
      <L>#.......#     #</L>
      <L>###############</L>
    </Level>
    <Level Id="Flipper" Width="14" Height="13">
      <L>    ##########</L>
      <L>   #         #</L>
      <L>  #     ## ###</L>
      <L> #   #    ...#</L>
      <L>#    #### ...#</L>
      <L>#   #    #...#</L>
      <L>#  #     #####</L>
      <L>#    #$  #</L>
      <L>#  $$$   #</L>
      <L># #$@$  ##</L>
      <L>#  $$$# #</L>
      <L># #     #</L>
      <L>#########</L>
    </Level>
    <Level Id="Clausterphobia" Width="16" Height="13">
      <L>      ########</L>
      <L>######       #</L>
      <L>#   $  ##### #</L>
      <L>#  ##$ $  $  ###</L>
      <L># $##  ## #....#</L>
      <L>#   ##  # #.*..#</L>
      <L># $  # $#@#.*.##</L>
      <L>#  $ #  #$#.*.#</L>
      <L># $ $$   $  #.#</L>
      <L># $  #  $$ $$.##</L>
      <L># $ $$$ #.. ...#</L>
      <L># #     ###....#</L>
      <L>#########  ####</L>
    </Level>
    <Level Id="Relax now !!!" Width="13" Height="9">
      <L>####</L>
      <L>#  ##########</L>
      <L>#  $ ##  #  #</L>
      <L>#        #..#</L>
      <L>#  ####$$ ..#</L>
      <L>#  $@     ..#</L>
      <L>#  $$$$###..#</L>
      <L>#           #</L>
      <L>#############</L>
    </Level>
    <Level Id="Killing me softly" Width="16" Height="13">
      <L>####</L>
      <L>#..#</L>
      <L>#..#########</L>
      <L>#..  $ $   #</L>
      <L>#.   # $  $#####</L>
      <L>#.## # $ $ #   #</L>
      <L>#.## #  $  # # #</L>
      <L>#.## # $     # #</L>
      <L>#### #######$# #</L>
      <L>   # $@        #</L>
      <L>   # ######### #</L>
      <L>   #           #</L>
      <L>   #############</L>
    </Level>
    <Level Id="Split the atoms" Width="16" Height="11">
      <L>################</L>
      <L>#   ...........#</L>
      <L># $ $#$ #$ $  #</L>
      <L># $  #  # $#  #</L>
      <L># $ $#$$#  $ ##</L>
      <L># $        $ #</L>
      <L>####..#####$$#</L>
      <L>   #...$ $@$ #</L>
      <L>   #...$ $ $ #</L>
      <L>   #...      #</L>
      <L>   ###########</L>
    </Level>
    <Level Id="Lift up" Width="15" Height="9">
      <L>#########</L>
      <L>#       #  ####</L>
      <L># $#$#$$###.. #</L>
      <L># $   @ #..#. #</L>
      <L># $#$$$$#.*$.##</L>
      <L>#     .....$ #</L>
      <L>###..*#####$$#</L>
      <L>  #          #</L>
      <L>  ############</L>
    </Level>
    <Level Id="Brian's castle" Width="13" Height="9">
      <L>#########</L>
      <L>#       #####</L>
      <L>#  $##$##...#</L>
      <L># $@#  $....#</L>
      <L>#  $#$ ##...#</L>
      <L>#   $       #</L>
      <L>### $$####$ #</L>
      <L>  #         #</L>
      <L>  ###########</L>
    </Level>
    <Level Id="Rattle snake" Width="13" Height="9">
      <L>#############</L>
      <L>#     #####.#</L>
      <L># #$$$ ...#.#</L>
      <L># $@$  ...#.#</L>
      <L>#  $$$#...#.#</L>
      <L>### $   #...#</L>
      <L>  # $$$$$$$ #</L>
      <L>  #         #</L>
      <L>  ###########</L>
    </Level>
    <Level Id="Throw dices" Width="18" Height="12">
      <L> #################</L>
      <L> #        #      #</L>
      <L> # $#$ $ $#  $ $ #</L>
      <L> #  $   $ #   $  #</L>
      <L>#  $ $ $ $#  $ $ #</L>
      <L># $@ # #  ## #####</L>
      <L># $$$# #        #</L>
      <L>#    #    ##.#  #</L>
      <L>######### ....  #</L>
      <L>   #.....  .... #</L>
      <L>   #.....       #</L>
      <L>   ##############</L>
    </Level>
    <Level Id="Tabernacle" Width="19" Height="13">
      <L>###################</L>
      <L>#                 #</L>
      <L>#.$$$$$$$$$$$$$$$.#</L>
      <L>#.# $.........$ #.#</L>
      <L>#.# $$$.....$$$ #.#</L>
      <L>#.#   $.....$   #.#</L>
      <L>#.##  $$$.$$$  ##.#</L>
      <L>#.##    $@$    ##.#</L>
      <L>#.## $$$$$$$$$ ##.#</L>
      <L>#.##           ##.#</L>
      <L>#.#######.#######.#</L>
      <L>#.       .       .#</L>
      <L>###################</L>
    </Level>
    <Level Id="Road runner" Width="23" Height="19">
      <L>  #####################</L>
      <L>  ##  #   #   #   #   #</L>
      <L>  ##$   $   $   $   @ #</L>
      <L>  ##  #   #   #   #   #</L>
      <L>  #   #################</L>
      <L>  #   #   #   #   #</L>
      <L>  ##$   $   $   $ #</L>
      <L>  #   #   #   #   #</L>
      <L>################ ##</L>
      <L># $ $ $ $ $ $ $   #</L>
      <L>#                 #</L>
      <L>## ################</L>
      <L>## $ $ $ ##########</L>
      <L>#        ####.....#</L>
      <L>#  ##### ####.....#</L>
      <L>#    $   ####  ...#</L>
      <L># #####        ...#</L>
      <L>#        ####  ...#</L>
      <L>###################</L>
    </Level>
    <Level Id="Visit the nightclub" Width="18" Height="11">
      <L>  ################</L>
      <L>  ###....#########</L>
      <L>  ##.....   ###  #</L>
      <L>  #..... $  ###$ #</L>
      <L>########.#$####  #</L>
      <L>#              $ #</L>
      <L># #$$$$###$##$$  #</L>
      <L># #            $ #</L>
      <L># #@##$#$###$##  #</L>
      <L>#             ####</L>
      <L>###############</L>
    </Level>
    <Level Id="Aruba One Happy Island" Width="34" Height="10">
      <L>#######################</L>
      <L>##   ########   ##   ####</L>
      <L>## $          $    $     #########</L>
      <L>##$ $#########$#  $ $            #</L>
      <L># $ $         $   $ $ #   .......#</L>
      <L># $$$#$$$#$ $ $$$ $$$ #..........#</L>
      <L># $ $ $   $ $ $@$ $ $ #..........#</L>
      <L># $ $ $   $$$ $$$ $ $ #..........#</L>
      <L>#                     #..........#</L>
      <L>##################################</L>
    </Level>
    <Level Id="Enjoy your visit in Aruba" Width="23" Height="10">
      <L>#######################</L>
      <L>#.....................#</L>
      <L>## $ .....    $    $  #</L>
      <L>##$ $#########$## $ $ #</L>
      <L># $ $         $   $ $ #</L>
      <L># $$$#$$$#$ $ $$$ $$$ #</L>
      <L># $ $ $   $ $ $@$ $ $ #</L>
      <L># $ $ $   $$$ $$$ $ $ #</L>
      <L>#.....................#</L>
      <L>#######################</L>
    </Level>
    <Level Id="End of this adventure" Width="14" Height="10">
      <L>##############</L>
      <L>#            #</L>
      <L># #$##$#.#.# #</L>
      <L># $  $   . # #</L>
      <L># #  $ ..  # #</L>
      <L># #@ $ .#### #</L>
      <L># ####  ...# #</L>
      <L># $ $ $##### #</L>
      <L>#            #</L>
      <L>##############</L>
    </Level>
  </LevelCollection>
</SokobanLevels>
