<?xml version="1.0" encoding="utf-8"?>
<SokobanLevels xmlns:xsi="http://www.w3.org/2001/XMLSchema-instance" xsi:schemaLocation="SokobanLev.xsd">
  <Title>Cubes &amp; Tubes</Title>
  <Description>
This is our second collection of Sokoban Levels. Have fun playing,
D&amp;R.
  </Description>
  <Email>lemming@digitaldream.de</Email>
  <Url>http://www.doreen-und-rainer.de</Url>
  <LevelCollection Copyright="Doreen Kaufmann, Rainer Kaufmann" MaxWidth="13" MaxHeight="13">
    <Level Id="01 Enter the Cube" Width="13" Height="13">
      <L>#############</L>
      <L>#############</L>
      <L>##         ##</L>
      <L>## ### ### ##</L>
      <L>## #   # # ##</L>
      <L>## # $.$ # ##</L>
      <L>##   .@.   ##</L>
      <L>## # $.$ # ##</L>
      <L>## # #   # ##</L>
      <L>## ### ### ##</L>
      <L>##         ##</L>
      <L>#############</L>
      <L>#############</L>
    </Level>
    <Level Id="02 Cross Cube" Width="13" Height="13">
      <L>#############</L>
      <L>#############</L>
      <L>##    #    ##</L>
      <L>## ## # ## ##</L>
      <L>## #  @  # ##</L>
      <L>## # .$. # ##</L>
      <L>##   $#$   ##</L>
      <L>## # .$. # ##</L>
      <L>## #     # ##</L>
      <L>## ## # ## ##</L>
      <L>##    #    ##</L>
      <L>#############</L>
      <L>#############</L>
    </Level>
    <Level Id="03 Ice Cube" Width="13" Height="13">
      <L>#############</L>
      <L>#           #</L>
      <L># #### #### #</L>
      <L># #       # #</L>
      <L># # $ . $ # #</L>
      <L># #  .$.  # #</L>
      <L>#   .$@$.   #</L>
      <L># #  .$.  # #</L>
      <L># # $ . $ # #</L>
      <L># #       # #</L>
      <L># #### #### #</L>
      <L>#           #</L>
      <L>#############</L>
    </Level>
    <Level Id="04 Cubicolor" Width="13" Height="13">
      <L>#############</L>
      <L>#  ######   #</L>
      <L>#           #</L>
      <L>#  ## $### ##</L>
      <L>## .#   #. ##</L>
      <L>#   # $ #   #</L>
      <L># #   #   # #</L>
      <L>#   # $ #   #</L>
      <L>## .# @ #. ##</L>
      <L>## ###$###  #</L>
      <L>#           #</L>
      <L>#   ######  #</L>
      <L>#############</L>
    </Level>
    <Level Id="05 Cubular Cells" Width="13" Height="13">
      <L>#############</L>
      <L>##. # # # .##</L>
      <L>#.  $   $  .#</L>
      <L>#  .#   #.  #</L>
      <L>##$###$###$##</L>
      <L>#   #   #   #</L>
      <L>##  $ @ $  ##</L>
      <L>#   #   #   #</L>
      <L>##$###$###$##</L>
      <L>#  .#   #.  #</L>
      <L>#.  $   $  .#</L>
      <L>##. # # # .##</L>
      <L>#############</L>
    </Level>
    <Level Id="06 Tubular Balls" Width="13" Height="13">
      <L>#############</L>
      <L>#  #     #  #</L>
      <L>#  # #$# #  #</L>
      <L>#           #</L>
      <L>## # # # # ##</L>
      <L>## # #.# # ##</L>
      <L>## # #.# # ##</L>
      <L>## # #.# # ##</L>
      <L>## # #.# # ##</L>
      <L>## # #.# # ##</L>
      <L>##$#$###$#$##</L>
      <L>##    @    ##</L>
      <L>#############</L>
    </Level>
    <Level Id="07 Tubular Balls II" Width="13" Height="13">
      <L>#############</L>
      <L>#           #</L>
      <L># $#$ # $#$ #</L>
      <L># $       $ #</L>
      <L>### # # # ###</L>
      <L># # #.#.# # #</L>
      <L># # #.#.# # #</L>
      <L># # #.#.# # #</L>
      <L># # #.#.# # #</L>
      <L># # #.#.# # #</L>
      <L># #$#$#$#$# #</L>
      <L>#     @     #</L>
      <L>#############</L>
    </Level>
    <Level Id="08 Tubular Balls III" Width="13" Height="13">
      <L>#############</L>
      <L>#           #</L>
      <L># $#$# #$#$ #</L>
      <L>#  $     $  #</L>
      <L>##$# $ $ #$##</L>
      <L>#  #.#.#.#  #</L>
      <L>#  #.#.#.#  #</L>
      <L>#  #.#.#.#  #</L>
      <L>#  #.#.#.#  #</L>
      <L>#  #.#.#.#  #</L>
      <L>##$#$#$#$#$##</L>
      <L>#     @     #</L>
      <L>#############</L>
    </Level>
    <Level Id="09 Tubular World" Width="13" Height="13">
      <L>#############</L>
      <L>#           #</L>
      <L># # # # # # #</L>
      <L># $ $ $ $ $ #</L>
      <L># # #.#.# # #</L>
      <L># # #.#.# # #</L>
      <L>###.# # #.###</L>
      <L># # #.#.# # #</L>
      <L># # #.#.# # #</L>
      <L># $ $ $ $ $ #</L>
      <L># # # # # # #</L>
      <L>#     @     #</L>
      <L>#############</L>
    </Level>
    <Level Id="10 Tubular World II" Width="13" Height="13">
      <L>#############</L>
      <L>#           #</L>
      <L># # # # # # #</L>
      <L># $ $ $ $ $ #</L>
      <L># #.#.#.#.# #</L>
      <L># $ #.#.# $ #</L>
      <L>### #.#.# ###</L>
      <L># $ #.#.# $ #</L>
      <L># #.#.#.#.# #</L>
      <L># $ $ $ $ $ #</L>
      <L># # # # # # #</L>
      <L>#     @     #</L>
      <L>#############</L>
    </Level>
    <Level Id="11 Tubular World III" Width="13" Height="13">
      <L>#############</L>
      <L>#           #</L>
      <L># # # # # # #</L>
      <L># $ $ $ $ $ #</L>
      <L># #.#.#.#.# #</L>
      <L># $.#.#.#.$ #</L>
      <L>### $ # $ ###</L>
      <L># $.#.#.#.$ #</L>
      <L># #.#.#.#.# #</L>
      <L># $ $ $ $ $ #</L>
      <L># # # # # # #</L>
      <L>#     @     #</L>
      <L>#############</L>
    </Level>
    <Level Id="12 Tube Or Not Tube" Width="13" Height="13">
      <L>#############</L>
      <L>#           #</L>
      <L># #$# # #$# #</L>
      <L># $       $ #</L>
      <L># # # # # # #</L>
      <L>#.# $ $ $ #.#</L>
      <L>#.# # # # #.#</L>
      <L>#.# $ $ $ #.#</L>
      <L>#.# # # # #.#</L>
      <L>#.# # # # #.#</L>
      <L>#.#$#$#$#$#.#</L>
      <L>#.#   @   #.#</L>
      <L>#############</L>
    </Level>
    <Level Id="13 Tube Up Your Life" Width="13" Height="13">
      <L>#############</L>
      <L>#.#   #   #.#</L>
      <L>#.# # $ # #.#</L>
      <L>#.# $ # $ #.#</L>
      <L>#.#$# # #$#.#</L>
      <L>#     #     #</L>
      <L>#$#$ $@$ $#$#</L>
      <L>#     #     #</L>
      <L>#.#$# # #$#.#</L>
      <L>#.# $ # $ #.#</L>
      <L>#.# # $ # #.#</L>
      <L>#.#   #   #.#</L>
      <L>#############</L>
    </Level>
    <Level Id="14 Cube De Loop" Width="13" Height="13">
      <L>#############</L>
      <L>#.  $   $  .#</L>
      <L>#.# # $   #.#</L>
      <L>#.# $ $ $ #.#</L>
      <L>#.# #######.#</L>
      <L>#    $ #    #</L>
      <L># #$ #@# $# #</L>
      <L>#    # $    #</L>
      <L>#.####### #.#</L>
      <L>#.# $ $ $ #.#</L>
      <L>#.#   $ # #.#</L>
      <L>#.  $   $  .#</L>
      <L>#############</L>
    </Level>
    <Level Id="15 Cross Cube II" Width="13" Height="13">
      <L>#############</L>
      <L># . .   . . #</L>
      <L>#.###$#$###.#</L>
      <L># #   #   # #</L>
      <L>#.# $ $ $ #.#</L>
      <L># $   #   $ #</L>
      <L># ##$###$## #</L>
      <L># $   #   $ #</L>
      <L>#.# $ $ $ #.#</L>
      <L># #   #   # #</L>
      <L>#.###$#$###.#</L>
      <L># . . @ . . #</L>
      <L>#############</L>
    </Level>
    <Level Id="16 Cross Cube III" Width="13" Height="13">
      <L>#############</L>
      <L># ...   ... #</L>
      <L>#.#$#$#$#$#.#</L>
      <L>#.$   #   $.#</L>
      <L>#.# $ $ $ #.#</L>
      <L># $   #   $ #</L>
      <L># ##$###$## #</L>
      <L># $   #   $ #</L>
      <L>#.# $ $ $ #.#</L>
      <L>#.$   #   $.#</L>
      <L>#.#$#$#$#$#.#</L>
      <L># ... @ ... #</L>
      <L>#############</L>
    </Level>
    <Level Id="17 Hyper Cube" Width="13" Height="13">
      <L>#############</L>
      <L>#    ...    #</L>
      <L># # ##### # #</L>
      <L>#   $ # $   #</L>
      <L># #$  $  $# #</L>
      <L>#.#   #   #.#</L>
      <L>#.##$###$##.#</L>
      <L>#.#   #   #.#</L>
      <L># #$  $@ $# #</L>
      <L>#   $ # $   #</L>
      <L># # ##### # #</L>
      <L>#    ...    #</L>
      <L>#############</L>
    </Level>
    <Level Id="18 Hyper Cube II" Width="13" Height="13">
      <L>#############</L>
      <L>#   ..$..   #</L>
      <L># # ##### # #</L>
      <L>#   $ # $   #</L>
      <L>#.#$  $  $#.#</L>
      <L>#.#   #   #.#</L>
      <L>#$##$###$##$#</L>
      <L>#.#   #   #.#</L>
      <L>#.#$  $@ $#.#</L>
      <L>#   $ # $   #</L>
      <L># # ##### # #</L>
      <L>#   ..$..   #</L>
      <L>#############</L>
    </Level>
    <Level Id="19 Flake Cube" Width="13" Height="13">
      <L>#############</L>
      <L>##... $ ...##</L>
      <L>#.### #$###.#</L>
      <L>#.#   $   #.#</L>
      <L>#.# $   $ #.#</L>
      <L># $  $$$    #</L>
      <L>#$#$ $@$ $#$#</L>
      <L>#    $$$  $ #</L>
      <L>#.# $   $ #.#</L>
      <L>#.#   $   #.#</L>
      <L>#.###$# ###.#</L>
      <L>##... $ ...##</L>
      <L>#############</L>
    </Level>
    <Level Id="20 Hell Cube" Width="13" Height="13">
      <L>#############</L>
      <L>###   #   ###</L>
      <L>#  $  #  $  #</L>
      <L>#  $  #  $  #</L>
      <L>##$#$###$#$##</L>
      <L>## $  #  $ ##</L>
      <L>## $  #  $ ##</L>
      <L>## ##   ## ##</L>
      <L>#  ### ### ##</L>
      <L>#  ..# #..  #</L>
      <L>#. .. @ .. .#</L>
      <L>#.   # #   .#</L>
      <L>#############</L>
    </Level>
  </LevelCollection>
</SokobanLevels>
