<?xml version="1.0" encoding="utf-8"?>
<SokobanLevels xmlns:xsi="http://www.w3.org/2001/XMLSchema-instance" xsi:schemaLocation="SokobanLev.xsd">
  <Title>Dushi 04</Title>
  <Description>
New 50 dushi levels from Aruba.
  </Description>
  <Email>serenata@setarnet.aw</Email>
  <LevelCollection Copyright="Eric F Tchong" MaxWidth="35" MaxHeight="23">
    <Level Id="serpentine" Width="16" Height="14">
      <L>           #####</L>
      <L>   #########   #</L>
      <L>   #           #</L>
      <L>   # ***$****  #</L>
      <L>####$*      * ##</L>
      <L>#   * #  $  * #</L>
      <L># ***@ ##**** #</L>
      <L># *  #   *   ##</L>
      <L># *  #   *   #</L>
      <L># **********$#</L>
      <L>#            #</L>
      <L>##..##########</L>
      <L> #..#</L>
      <L> ####</L>
    </Level>
    <Level Id="guyaba" Width="11" Height="15">
      <L>########</L>
      <L>#      #</L>
      <L># #### ###</L>
      <L># #   $  #</L>
      <L># # $$@  #</L>
      <L># ## ###$#</L>
      <L># #..... #</L>
      <L># ..  #. #</L>
      <L>#######.$##</L>
      <L>   #      #</L>
      <L>   # $# $ #</L>
      <L>   #  #  ##</L>
      <L>   # $# $#</L>
      <L>   #  #  #</L>
      <L>   #######</L>
    </Level>
    <Level Id="svengali" Width="15" Height="13">
      <L> #############</L>
      <L> #           #</L>
      <L> # ######### ##</L>
      <L> # #     $    #</L>
      <L> # # $ $      #</L>
      <L>## ## ###### ##</L>
      <L>#  #...$@ #   #</L>
      <L>#   ...#  # $ #</L>
      <L># $#...## # $ #</L>
      <L>##     ##   $ #</L>
      <L> ######## $   #</L>
      <L>        ###   #</L>
      <L>          #####</L>
    </Level>
    <Level Id="side walk" Width="18" Height="8">
      <L>##################</L>
      <L>#                #</L>
      <L>#   .# ......#   #</L>
      <L>###$###*##.#### ##</L>
      <L> # $   @$ $ $  $ #</L>
      <L> #   #  $ $ #    #</L>
      <L> ######     ######</L>
      <L>      #######</L>
    </Level>
    <Level Id="side walk 2" Width="18" Height="8">
      <L>##################</L>
      <L>#                #</L>
      <L>#   .# ......#   #</L>
      <L>###$###*###.### ##</L>
      <L> # $   @$ $ $  $ #</L>
      <L> #   #  $ $ #    #</L>
      <L> ######     ######</L>
      <L>      #######</L>
    </Level>
    <Level Id="trampoline" Width="17" Height="12">
      <L>#### ########</L>
      <L>#  ### @#   ####</L>
      <L>#    $  # . #  #</L>
      <L>#  ........... #</L>
      <L>## ### ###$#$#$##</L>
      <L>#  # $  #  #    #</L>
      <L>#  #    #  # $  #</L>
      <L>##$#$#$### ### ##</L>
      <L>#      # $   #  #</L>
      <L>#   $  #     $  #</L>
      <L>#   #####  ###  #</L>
      <L>#####   #### ####</L>
    </Level>
    <Level Id="alto vista" Width="15" Height="16">
      <L>#### ####</L>
      <L>#  ###  # ####</L>
      <L>#  $  $ ###@ #</L>
      <L>#  # $    $  #</L>
      <L>##.### ## # ###</L>
      <L>#..*.#  # $ $ #</L>
      <L>#....# $# # $ #</L>
      <L>#....*. $ $   #</L>
      <L>#......   ### #</L>
      <L>##.**.#$ ##   #</L>
      <L> #  $ #  #  $ #</L>
      <L> ## ### ##$$$ #</L>
      <L> #  # $    $  #</L>
      <L> # $$  $ ######</L>
      <L> #  ###  #</L>
      <L> #### ####</L>
    </Level>
    <Level Id="Current Competition (29th)MF8 - easy 01" Width="18" Height="20" Copyright="chzhy, rikitin">
      <L>          ########</L>
      <L>          #      #</L>
      <L>   #### ###  $   #</L>
      <L>   #  ###  #   $ #</L>
      <L>   #  $.   #     #</L>
      <L>   #  # #  #     #</L>
      <L>#####$# # ##  $$ #</L>
      <L>#  ##.# # ##     #</L>
      <L># $   # #. #  $  #</L>
      <L>#  #.#. .#$#     #</L>
      <L>## #.#.*...  $$  #</L>
      <L> # #.*.. ###     #</L>
      <L> # #.*..## $ $$$ #</L>
      <L>## ###.### $  $  #</L>
      <L>#   ##*.$      $ #</L>
      <L>#   ...## $   $  #</L>
      <L>##.#######@#     #</L>
      <L># $      $ #######</L>
      <L>#   ####   #</L>
      <L>#####  #####</L>
    </Level>
    <Level Id="Current Competition (29th)MF8 - easy 02" Width="18" Height="20" Copyright="chzhy, rikitin">
      <L>          ########</L>
      <L>          #      #</L>
      <L>   #### ###  $   #</L>
      <L>   #  ###  # ##$ #</L>
      <L>   #  $.   # #   #</L>
      <L>   #  # #  # #   #</L>
      <L>#####$# # ## #$$ #</L>
      <L>#  ##.# # ##   # #</L>
      <L># $   # #. # #$  #</L>
      <L>#  #.#. .#$#   # #</L>
      <L>## #.#.*...  $$# #</L>
      <L> # #.*.. ### #   #</L>
      <L> # #.*..## $ $$$ #</L>
      <L>## ###.### $# $  #</L>
      <L>#   ##*.$      $ #</L>
      <L>#   ...## $   $  #</L>
      <L>##.#######@##    #</L>
      <L># $      $ #######</L>
      <L>#   ####   #</L>
      <L>#####  #####</L>
    </Level>
    <Level Id="Current Competition (29th)MF8 - hard 01" Width="18" Height="20" Copyright="chzhy, rikitin">
      <L>          ########</L>
      <L>          #      #</L>
      <L>   #### ###  $   #</L>
      <L>   #  ###  # ##$##</L>
      <L>   #  $.   # ## ##</L>
      <L>   #  # #  # #   #</L>
      <L>#####$# # ## #$$ #</L>
      <L>#  ##.# # ##   # #</L>
      <L># $   # #. # #$  #</L>
      <L>#  #.#. .#$#   ###</L>
      <L>## #.#.*...  $$###</L>
      <L> # #.*.. ### #   #</L>
      <L> # #.*..## $ $$$ #</L>
      <L>## ###.### $# $  #</L>
      <L>#   ##*.$      $ #</L>
      <L>#   ...## $   $# #</L>
      <L>##.#######@##    #</L>
      <L># $      $ #######</L>
      <L>#   ####   #</L>
      <L>#####  #####</L>
    </Level>
    <Level Id="Aruba" Width="27" Height="17">
      <L> #####</L>
      <L> #...#####</L>
      <L> #. .#...#####</L>
      <L> #... .   . .#####</L>
      <L> #. . .   . .#.  #####</L>
      <L> #. . .   . . .    . ##</L>
      <L> ## ###   . . ... . . #</L>
      <L>### ######... . . ... #</L>
      <L>#     ########... . . #</L>
      <L># $$$$$ $ ########. . #</L>
      <L>#       $     #########</L>
      <L># $$$$$ $ $$$$$ $@#####</L>
      <L>#       $           $ #####</L>
      <L># $$$$$ $ $$$$$$$$$$$ $ $ #</L>
      <L># $ $ $ $ $ $ $ $ $       #</L>
      <L>#                       ###</L>
      <L>#########################</L>
    </Level>
    <Level Id="peter" Width="14" Height="16">
      <L> ####</L>
      <L> #  #</L>
      <L>## $#</L>
      <L>#   #</L>
      <L># $$########</L>
      <L>#     #    ##</L>
      <L># $$$$#.... #</L>
      <L>#  $  # .. .#</L>
      <L># $$ $#.....#</L>
      <L>#  $  ##+   ##</L>
      <L># $$ $##.....#</L>
      <L>#  $  ##.    #</L>
      <L># $$ $##...  #</L>
      <L>#  $ $ $     #</L>
      <L>#        #####</L>
      <L>##########</L>
    </Level>
    <Level Id="reshuffle" Width="15" Height="16">
      <L>###############</L>
      <L>#.##  . .    .#</L>
      <L># .$$$ $ $$$. #</L>
      <L>#.#. $ $ $ .#.#</L>
      <L># $ . $#$ . $ #</L>
      <L>#. $ . $ . $ .#</L>
      <L>#   $ .$. $   #</L>
      <L>#. #$ #.# $# .#</L>
      <L>#   $ . . $   #</L>
      <L>#. $ .#@#. $ .#</L>
      <L># $ .#   #. $ #</L>
      <L>#. .##$$$##. .#</L>
      <L># .# $   $ #. #</L>
      <L>#.# $ $ $ $  .#</L>
      <L>###          ##</L>
      <L>  ############</L>
    </Level>
    <Level Id="golge" Width="14" Height="11">
      <L>      ########</L>
      <L>      #  ....#</L>
      <L>    ###.#.####</L>
      <L>    #.*.#*. #</L>
      <L>#####  .# $ #</L>
      <L>#  $  $###  #</L>
      <L>#@ $   $  $ #</L>
      <L>### $$$ #$  #</L>
      <L>  #     #   #</L>
      <L>  #####   ###</L>
      <L>      #####</L>
    </Level>
    <Level Id="L net" Width="19" Height="12">
      <L>           #######</L>
      <L>          ##     ##</L>
      <L>          #  $ $  #</L>
      <L>###########$$ $ $ #</L>
      <L>#.#       $       #</L>
      <L>#.# $#   $   ######</L>
      <L>#.# $  $$   ##</L>
      <L>#.##****. ###</L>
      <L>#........$#</L>
      <L>#  #***** #</L>
      <L>#########@#</L>
      <L>        ###</L>
    </Level>
    <Level Id="barré" Width="10" Height="15">
      <L>  ########</L>
      <L> ##  ##  #</L>
      <L>## $...$ #</L>
      <L>#  $..*$ #</L>
      <L># $$###  #</L>
      <L>#  $...$ #</L>
      <L># $$...$ #</L>
      <L>#   ###  #</L>
      <L># $...$ ##</L>
      <L># $*..$  #</L>
      <L>#  ###$$ #</L>
      <L># $...$  #</L>
      <L># $...$$ #</L>
      <L>#@ ##    #</L>
      <L>##########</L>
    </Level>
    <Level Id="fun player" Width="17" Height="15">
      <L>#################</L>
      <L>#   . . #       #</L>
      <L># $ . . # $$ $$ #</L>
      <L># $ # $ #   # . #</L>
      <L>#  $.   # $#..  #</L>
      <L># **$*$ # ..$.$ #</L>
      <L>#             @ #</L>
      <L>###### # # ######</L>
      <L>    # . * $ #</L>
      <L>    # *$.   #</L>
      <L>    # $ #   #</L>
      <L>    # $ .   #</L>
      <L>    # $.$.. #</L>
      <L>    #.     .#</L>
      <L>    #########</L>
    </Level>
    <Level Id="internal affairs" Width="15" Height="16">
      <L>      ####</L>
      <L>     ##  #</L>
      <L> #####   #####</L>
      <L> #.         .#</L>
      <L> # ####$######</L>
      <L> # #.. $ ..#</L>
      <L>## #.$$  $.####</L>
      <L>#  #  ***  #  #</L>
      <L>#  $$$*@*$$$  #</L>
      <L>#  #  ***  #  #</L>
      <L>## #.$  $$.# ##</L>
      <L> # #.. $ ..# #</L>
      <L> # ####$#### #</L>
      <L> #.         .#</L>
      <L> #####   #####</L>
      <L>     #####</L>
    </Level>
    <Level Id="internal affairs 2" Width="15" Height="16">
      <L>     #####</L>
      <L> #####   #####</L>
      <L> #.         .#</L>
      <L> # ####$#### #</L>
      <L> # #.. $ ..# #</L>
      <L>## #.$$  $.# ##</L>
      <L>#  #  ***  #  #</L>
      <L>#  $$$*@*$$$  #</L>
      <L>#  #  ***  #  #</L>
      <L>## #.$  $$.# ##</L>
      <L> # #.. $ ..# #</L>
      <L> # ####$#### #</L>
      <L> #.         .#</L>
      <L> #####   #####</L>
      <L>     #   #</L>
      <L>     #####</L>
    </Level>
    <Level Id="albatros" Width="18" Height="11">
      <L>     ##########</L>
      <L>     #@ . .   #</L>
      <L>   ### ## # # #</L>
      <L>   #  .## # # #</L>
      <L>   # # ##$#$#$####</L>
      <L>#### #  .   $  $ #</L>
      <L>#  $ # $  ### .. #</L>
      <L># $$$#### ...... #</L>
      <L>#     .    $ $ $ #</L>
      <L>#######    #######</L>
      <L>      ######</L>
    </Level>
    <Level Id="O Wadirikiri" Width="21" Height="16">
      <L> ########### #####</L>
      <L> #         # #   #</L>
      <L> # $ #####$### # #</L>
      <L> #               #</L>
      <L>##   #  ###  #$#$####</L>
      <L>#  $$#$ $ ##   $  $ #</L>
      <L>#  $  $ $ @  ### .. #</L>
      <L>#  #.   ## $ ...... #</L>
      <L>####.###.. $  $ $ $ #</L>
      <L>  # ....***   #######</L>
      <L>  # .##. .  ###</L>
      <L>  ##.## ##  #</L>
      <L>   #  $     #</L>
      <L>   ######$  #</L>
      <L>        #   #</L>
      <L>        #####</L>
    </Level>
    <Level Id="mini 5" Width="10" Height="10">
      <L> #####</L>
      <L> #   #</L>
      <L> # $@#</L>
      <L> #  #####</L>
      <L>### $   #</L>
      <L># $  $  ##</L>
      <L>#   # $. #</L>
      <L>#######. #</L>
      <L>    #... #</L>
      <L>    ######</L>
    </Level>
    <Level Id="inside, outside" Width="25" Height="19">
      <L>    ######## ########</L>
      <L>    #      # #      #</L>
      <L>    # ### $### $$$$ #</L>
      <L>    #               #####</L>
      <L>    # $  .......        #</L>
      <L>    #  $ .#####.   $$$$ #</L>
      <L>##### $  .#   #.      $ #</L>
      <L>#      $ .# $@#.... # $ #</L>
      <L># $ $   ..#  #####. # $ #</L>
      <L># $ $   .### $...#..    #</L>
      <L># $ $   .# $  $..##. # ##</L>
      <L># $ $   .#   # $  #. $ #</L>
      <L># $ $$$$.#######  #. $ #</L>
      <L># $     .....#    #. $ #</L>
      <L># $$        .### ##. # #</L>
      <L>#  $$$$$$$$$........   #</L>
      <L>#                   ####</L>
      <L>###############   ###</L>
      <L>              #####</L>
    </Level>
    <Level Id="inside, outside 2" Width="25" Height="19">
      <L>    ######## ########</L>
      <L>    #      # #      #</L>
      <L>    # ###$$### $$$$ #</L>
      <L>    # $ $  $ $  # # #####</L>
      <L>    # $  .......        #</L>
      <L>    #  $ .#####.   $$$$ #</L>
      <L>##### $# .#   #.      $ #</L>
      <L>#      $ .# $@#.... # $ #</L>
      <L># $#$ $ ..#  #####. # $ #</L>
      <L># $ $  $.### $...#..    #</L>
      <L># $ $#  .# $  $..##. # ##</L>
      <L># $ $   .#   # *. #. $ #</L>
      <L># $ $$$$.#######. #. $ #</L>
      <L># $     .....#... #. $ #</L>
      <L># $$        .###.##. # #</L>
      <L>#  $$$$$$$$$........   #</L>
      <L>#                   ####</L>
      <L>###############   ###</L>
      <L>              #####</L>
    </Level>
    <Level Id="calister" Width="24" Height="15">
      <L>          #####</L>
      <L>          #   ########</L>
      <L>   ######## $ #      ###</L>
      <L>   #      # $ # $#$$ #.#</L>
      <L>####  $$$$  ..#    $ #.#</L>
      <L>#    $$  $$$.### $#@ #.#</L>
      <L># $$$$  $$  .#  $.####.#</L>
      <L>#          $.##*..#....#</L>
      <L>##########  ......#.$$.#</L>
      <L>         #  .#  ###.$ .#</L>
      <L>         ## .####...$ ##</L>
      <L>          #           #</L>
      <L>          #######$$$ ##</L>
      <L>                #    #</L>
      <L>                ######</L>
    </Level>
    <Level Id="Mazereeuw" Width="16" Height="16">
      <L>            ####</L>
      <L>       ######  #</L>
      <L> ##### #     $ #</L>
      <L> #   ###$$$ $  #</L>
      <L>##  $    @#$  ##</L>
      <L>#  $$  $ $   $#</L>
      <L># $ #$$ $$$#$ #</L>
      <L>#   #  $   $  #</L>
      <L># $$#   $ $   #</L>
      <L>#   #### $    #</L>
      <L>### ##...######</L>
      <L>  #.... .#...#</L>
      <L>  #.... .....#</L>
      <L>  ####...#   #</L>
      <L>     #...#####</L>
      <L>     #####</L>
    </Level>
    <Level Id="Souterrain" Width="11" Height="13">
      <L>  #######</L>
      <L> ##     #</L>
      <L>##  *** #</L>
      <L>#  **   #</L>
      <L># *$ ######</L>
      <L># *       #</L>
      <L># ******* #</L>
      <L>#     @ * #</L>
      <L>####* # * #</L>
      <L>  # *   * #</L>
      <L>  # ***** #</L>
      <L>  #      .#</L>
      <L>  #########</L>
    </Level>
    <Level Id="diamonds gallery" Width="17" Height="18">
      <L>        #######</L>
      <L>#########.....#</L>
      <L>#     # ......###</L>
      <L># $ $ # ...#... #</L>
      <L>#  $ $##....... #</L>
      <L># $ $  #.#####.##</L>
      <L>#  $ $         #</L>
      <L># $ $ $#$ $ $  #</L>
      <L>#  $ $ #   $  ##</L>
      <L># $ $ $###$ $ ##</L>
      <L>#@ $ $     $ $##</L>
      <L># $ $ $###$ $  #</L>
      <L>#  $ $ #.......#</L>
      <L># $ $ $#.......#</L>
      <L>#  $ $ #########</L>
      <L># $ $ ##</L>
      <L>#     #</L>
      <L>#######</L>
    </Level>
    <Level Id="duplo dives" Width="23" Height="11">
      <L> ####</L>
      <L>##  #################</L>
      <L>#                 $ #</L>
      <L># ****************.+#</L>
      <L>#                 $ ###</L>
      <L># ################  # #</L>
      <L>#                   $ #</L>
      <L>### ****************. #</L>
      <L>  ##                $.#</L>
      <L>   #   ################</L>
      <L>   #####</L>
    </Level>
    <Level Id="fusion" Width="23" Height="23">
      <L>#######################</L>
      <L>#                     #</L>
      <L># ###.#.#.###.$.$ ### #</L>
      <L># ## $ $ $    *$.  ## #</L>
      <L># #.* $.$.$. * . *$.# #</L>
      <L># .$ $.$* . #$. *$.$. #</L>
      <L># . $.$.$.$*$. *$.$.$ #</L>
      <L># # .$* .@.$. *$.$.$. #</L>
      <L># # $. .$#$.##$.$.$.$ #</L>
      <L># # * *$.#.###.$.$.$. #</L>
      <L># #$$. .$#####$.$.$.$ #</L>
      <L># .$. .$ ##.## $.$.$. #</L>
      <L># $*$.$.$## ##$.$.$.$ #</L>
      <L># .$.$.$.## ##.$.$.$. #</L>
      <L># #$$. .$##$#.$.$.$.$ #</L>
      <L># .$.$. * .$.$.$.$.$. #</L>
      <L># #$$ $. .$.$.$.$.$.$ #</L>
      <L># .$ $. * .$.$.$ $.$. #</L>
      <L># ###.$*$* .$.$.* $.# #</L>
      <L># # #$ $ $$. $ $ $ ## #</L>
      <L># ###.#.#.$#..*##.### #</L>
      <L>#                     #</L>
      <L>#######################</L>
    </Level>
    <Level Id="fusion too" Width="23" Height="23">
      <L>#######################</L>
      <L>#                     #</L>
      <L># ###.$.$.$.$.$.$.### #</L>
      <L># ##.$.$.$.$.$.$.$.## #</L>
      <L># # $               # #</L>
      <L>#   * ..#$$$$$$#.  $. #</L>
      <L># $.   . $    $ ..  # #</L>
      <L># .$.. . $   .     $# #</L>
      <L># $*   . $$  .....  * #</L>
      <L># . * ..  $$$   . .$. #</L>
      <L># #   .$   $   $.   . #</L>
      <L># # . . $$$$  $$.. .# #</L>
      <L># # $ . $     $  . $$ #</L>
      <L># .$. .. $$   $ .. $. #</L>
      <L># # $  .# $$$$$..#  # #</L>
      <L># .$.          .   $. #</L>
      <L># # $.$* * .$. .$.$ # #</L>
      <L># .$ $.$. . .$.$ $.$. #</L>
      <L># # * $.$*$.$.$.$ ### #</L>
      <L># ##.$    $$*$$$$$# # #</L>
      <L># ###..####.$.#.#.### #</L>
      <L>#@                    #</L>
      <L>#######################</L>
    </Level>
    <Level Id="jelly beans" Width="11" Height="13">
      <L>###########</L>
      <L>#      $. #</L>
      <L># #####   #</L>
      <L>#     # ###</L>
      <L># ### #  #</L>
      <L># . * #@$#</L>
      <L>##*#*    #</L>
      <L>#  #  **.##</L>
      <L># $# #*.. #</L>
      <L>#    #  $ #</L>
      <L>####$# ####</L>
      <L>   #   #</L>
      <L>   #####</L>
    </Level>
    <Level Id="bennekom" Width="15" Height="11">
      <L> #######</L>
      <L> #     #####</L>
      <L> # $ $ $ $ ##</L>
      <L> # # $ # #  #</L>
      <L> #.### $ # $##</L>
      <L>## .##     . #</L>
      <L>#.. .## $  # ##</L>
      <L>#.+$ .#### #  #</L>
      <L>### $ .# # ## #</L>
      <L>  #  ### #    #</L>
      <L>  ####   ######</L>
    </Level>
    <Level Id="bnn alibi" Width="13" Height="11">
      <L>#####   ####</L>
      <L>#   #####  #</L>
      <L>#   $  .   #</L>
      <L>## ##.###. #</L>
      <L> #@ # . $ ###</L>
      <L> #$ $ #.# $ #</L>
      <L>##  ### # # #</L>
      <L>#  ####*  . #</L>
      <L># $#   * .$ #</L>
      <L>#    #   ####</L>
      <L>##########</L>
    </Level>
    <Level Id="varia" Width="18" Height="14">
      <L> ####</L>
      <L> #  #####</L>
      <L> #  #   #####</L>
      <L>##    $   $ ######</L>
      <L>#@$ $ #*#   ##   #</L>
      <L>#   ###.###    # #</L>
      <L>## # *...$.# $.# #</L>
      <L> # # ..*. .. #$$ #</L>
      <L>##  #.### ##   ###</L>
      <L>#  $#.# # #### ##</L>
      <L># $   ###  ###  #</L>
      <L>### $   $$      #</L>
      <L>  #######  ######</L>
      <L>        ####</L>
    </Level>
    <Level Id="hellu" Width="23" Height="11">
      <L>#######################</L>
      <L>#                     #</L>
      <L># * * *** * # * # *$* #</L>
      <L># * * *   * # * # * * #</L>
      <L># * * *   * # * # * * #</L>
      <L># **. **  * # * # * * #</L>
      <L># * * *   * # * # * * #</L>
      <L># * * *   *   *   *@* #</L>
      <L># * * *** *** *** *** #</L>
      <L>#                     #</L>
      <L>#######################</L>
    </Level>
    <Level Id="hello" Width="23" Height="11">
      <L>#######################</L>
      <L>#                     #</L>
      <L># * * *** * # * # *.* #</L>
      <L># * * *   * # * # * * #</L>
      <L># * * *   * $ * # * * #</L>
      <L># *** **  * # * # * * #</L>
      <L># * * *   * # * # * * #</L>
      <L># * * *   *   *   *@* #</L>
      <L># * * *** *** *** *** #</L>
      <L>#                     #</L>
      <L>#######################</L>
    </Level>
    <Level Id="zip 1" Width="15" Height="10">
      <L>###############</L>
      <L>#             #</L>
      <L># $*** * ***. #</L>
      <L>#    * * *@ * #</L>
      <L>#   *  * *  * #</L>
      <L>#  *   * **** #</L>
      <L># *    * *    #</L>
      <L># **** * *    #</L>
      <L>#             #</L>
      <L>###############</L>
    </Level>
    <Level Id="zip 2" Width="15" Height="10">
      <L>###############</L>
      <L>#             #</L>
      <L># **** * ***. #</L>
      <L>#    * * *@ * #</L>
      <L>#   *  * *  * #</L>
      <L>#  *   * **** #</L>
      <L># *    * *    #</L>
      <L># $*** * *    #</L>
      <L>#             #</L>
      <L>###############</L>
    </Level>
    <Level Id="sargent" Width="22" Height="10">
      <L> ###########</L>
      <L> #   #     ###########</L>
      <L> # *.  $$$ #         #</L>
      <L> #$.* $  $ # # ### # #</L>
      <L>## ..*   $ # $.#.#.$ #</L>
      <L>#.$##* $ $   $.#.#.$ #</L>
      <L>#  ..* $.$ # $.*...$ #</L>
      <L>#  ###*.## ###$$$$$###</L>
      <L>#### #.. . # #  +  #</L>
      <L>     ####### #######</L>
    </Level>
    <Level Id="right on" Width="23" Height="17">
      <L>   ###           ###</L>
      <L>   # #           # #</L>
      <L>   # ############# #</L>
      <L>   #  $...   ...$  #</L>
      <L>   # .####$  ####. #</L>
      <L>   # $  ## $ ##  $$#</L>
      <L>####.$# ##  $## # .####</L>
      <L>#  * $.$ $. .$ $.  .  #</L>
      <L>#@## #    $.$ $  # ## #</L>
      <L>#  .  .$ $. .$ $.$ *  #</L>
      <L>####. # ##  $## #$.####</L>
      <L>   #$$  ## $ ##  $ #</L>
      <L>   # .####$  ####. #</L>
      <L>   #  $...   ...$  #</L>
      <L>   # ############# #</L>
      <L>   # #           # #</L>
      <L>   ###           ###</L>
    </Level>
    <Level Id="hero fruit" Width="19" Height="12">
      <L>########   ########</L>
      <L>#      #   #      #</L>
      <L># ##$# ##### #$## #</L>
      <L># #...$$   $$...# #</L>
      <L># ##.#  $ $ @#.## #</L>
      <L># #...$$$ $$$...# #</L>
      <L># ###  .....  ### #</L>
      <L>#     ###.###     #</L>
      <L>####### $ $ #######</L>
      <L>    # $ $ $ $ #</L>
      <L>    #         #</L>
      <L>    ###########</L>
    </Level>
    <Level Id="27 euro's" Width="21" Height="17">
      <L>     ######</L>
      <L>     #    ###########</L>
      <L>     #  ............#</L>
      <L> #######  ###########</L>
      <L> #   ###........... #</L>
      <L> # $ ###.#########  #</L>
      <L> # $ ###.#       # ##</L>
      <L> # $ #  .# $###$   #</L>
      <L>## $ # ###  $ #  # #</L>
      <L># $  # #   $  #$ # #</L>
      <L># $       $# $#  # #</L>
      <L>#  $ ###$$ #  #$$# #</L>
      <L># $   #  @ #  #  # #</L>
      <L>#  $  ####### $  # #</L>
      <L>## $$ $ # $ $  #   #</L>
      <L> ###    #         ##</L>
      <L>   ################</L>
    </Level>
    <Level Id="trio" Width="10" Height="10">
      <L>#######</L>
      <L>#   . #</L>
      <L>#   * #</L>
      <L># ##*###</L>
      <L># #.*  #</L>
      <L>#   @ $###</L>
      <L>### * * .#</L>
      <L>  # $*$ ##</L>
      <L>  #   ###</L>
      <L>  #####</L>
    </Level>
    <Level Id="floriade" Width="13" Height="13">
      <L>##########</L>
      <L>#        #</L>
      <L># #*$...$##</L>
      <L># $   $$  #</L>
      <L>##@$ *..$ #</L>
      <L>  #  ... $#</L>
      <L>  #$$...$ #</L>
      <L>  #  ...$ #</L>
      <L>  # $..* $ ##</L>
      <L>  #  $$   $ #</L>
      <L>  ##$...$*# #</L>
      <L>   #        #</L>
      <L>   ##########</L>
    </Level>
    <Level Id="entrapment" Width="17" Height="18">
      <L>#################</L>
      <L>#               #</L>
      <L># ####.......$$ #</L>
      <L># $  ..$$$$$$ $ #</L>
      <L># $ #........$$ #</L>
      <L># $ #........ $ #</L>
      <L># $ #.$$$$$ #$$ #</L>
      <L># $ #. ...$ #   #</L>
      <L>#   #. *$*$ # $ #</L>
      <L># * #.  $.$ # $ #</L>
      <L># * #..*..$ # $ #</L>
      <L># * #   $$$$# $ #</L>
      <L># .   $     # $ #</L>
      <L># *$####### # $ #</L>
      <L># *   $ $     # #</L>
      <L># .+*.*.*.*.### #</L>
      <L>#               #</L>
      <L>#################</L>
    </Level>
    <Level Id="3 lanes" Width="25" Height="20">
      <L>        ##########</L>
      <L>  #######        ####</L>
      <L>  #       $$$ $$    ##</L>
      <L>  # $$$$    $  $$    ##</L>
      <L>  # $  $$$  $$  $$    #</L>
      <L>  # $    $$  $ # $$...##</L>
      <L>  # $$$   $  $ #  $#...#</L>
      <L>  #       $  $ #  $ ...##</L>
      <L>  ###### $$  $ #  $#....#</L>
      <L>  #      $  $  #  $ ....#</L>
      <L>####$$$$$$ $  #  $ ##...#</L>
      <L>#   $     $    $$$##....#</L>
      <L># $$$#  $$  $$$$........#</L>
      <L># $  # $$  $$  #........#</L>
      <L># $    $   $  @#........#</L>
      <L># $$  $$   $####.......#</L>
      <L>#  $$$$    $.........###</L>
      <L>##..........*......###</L>
      <L> ###########..######</L>
      <L>       ########</L>
    </Level>
    <Level Id="spanish snake" Width="35" Height="20">
      <L>##########</L>
      <L>#        ###</L>
      <L>#@$*****   #</L>
      <L>#      *** ##</L>
      <L>######   *  #</L>
      <L>     ### ** #</L>
      <L>       #  * #</L>
      <L>       #  * #</L>
      <L>       ## * #</L>
      <L>        # * ##          ##########</L>
      <L>        # *  ###       ##        #</L>
      <L>        # **   ##     ##  ****** #</L>
      <L>        #  ***  #######  **    * ##</L>
      <L>        ##   **         **     *  #</L>
      <L>         ##   ***********  ### ** #</L>
      <L>          ##              ## #  * #</L>
      <L>           ################  ## * #</L>
      <L>                              # * #</L>
      <L>                              # . #</L>
      <L>                              #####</L>
    </Level>
    <Level Id="blue" Width="14" Height="13">
      <L>   #######</L>
      <L>####     ###</L>
      <L># $ $ $$...##</L>
      <L>#     # ....#</L>
      <L>####$ # .*.##</L>
      <L>   #  # *..#</L>
      <L>   #$##$# ##</L>
      <L>   #    # #</L>
      <L>   # #@ # ####</L>
      <L>   #  # #  $ #</L>
      <L>   #$$ $#    #</L>
      <L>   #      ####</L>
      <L>   ########</L>
    </Level>
    <Level Id="rubyred" Width="25" Height="14">
      <L>  #######################</L>
      <L> ##  #  #  ##    #   @###</L>
      <L> #  $##    $    # $###  #</L>
      <L> # $ $ $# $ ##$# $ $    #</L>
      <L> #  $    $#    $      ###</L>
      <L> #$  $ ##   $ ###  #....#</L>
      <L> #  $# # $# # # # #....##</L>
      <L>## $ #    $ $ #  #....###</L>
      <L># $ $##$ ###  $ .....###</L>
      <L>#    #  # $    .....###</L>
      <L>## $$$      # #....###</L>
      <L> # $ #########....###</L>
      <L> #   #            #</L>
      <L> ##################</L>
    </Level>
  </LevelCollection>
</SokobanLevels>
