<?xml version="1.0" encoding="utf-8"?>
<SokobanLevels xmlns:xsi="http://www.w3.org/2001/XMLSchema-instance" xsi:schemaLocation="SokobanLev.xsd">
  <Title>Dushi 01</Title>
  <Description>
Dushi=sweet. Enjoy new series from Aruba.
  </Description>
  <Email>serenata@setarnet.aw</Email>
  <LevelCollection Copyright="Eric F Tchong" MaxWidth="43" MaxHeight="31">
    <Level Id="moonlight trio" Width="13" Height="17">
      <L>    #####</L>
      <L>    #   #</L>
      <L>   ## # ###</L>
      <L>   #    # #</L>
      <L>   #$#$ # #</L>
      <L>####@# $# #</L>
      <L>#.. $#$   #</L>
      <L>#..$    # #</L>
      <L>#.. # $ $ #</L>
      <L>##$ # ### #</L>
      <L>#   $ $ # #</L>
      <L># $#### # ###</L>
      <L># $     # ..#</L>
      <L># $.*### $..#</L>
      <L># #.* $   ..#</L>
      <L>#  .. #######</L>
      <L>#######</L>
    </Level>
    <Level Id="rutselli" Width="17" Height="18">
      <L>      #####</L>
      <L>#######   #######</L>
      <L># $     $     $ #</L>
      <L>#  $ #$#.#$# $  #</L>
      <L>###.$   $   $.###</L>
      <L>  #. # #.# # .#</L>
      <L>  #.  $.$.$  .#</L>
      <L>  ###  .$.  ###</L>
      <L>    # #.$.# #</L>
      <L>    # ..$.. #</L>
      <L>  ### #.$.# ###</L>
      <L>  #.  $.$.$  .#</L>
      <L>  #. #$#.#$# .#</L>
      <L>###.$   $   $.###</L>
      <L>#  $ # #+# # $  #</L>
      <L># $     $     $ #</L>
      <L>#######   #######</L>
      <L>      #####</L>
    </Level>
    <Level Id="ramblers" Width="17" Height="13">
      <L>        #######</L>
      <L>        #@    #</L>
      <L>#########$$ # ###</L>
      <L>#           #   #</L>
      <L># $$#$#$#$$##$# #</L>
      <L>#     $     #   #</L>
      <L># #$# # $ ###*###</L>
      <L>#   # $ #   *...#</L>
      <L>##### #   $ ....#</L>
      <L>    # $ ####....#</L>
      <L>    # #$$ $ #...#</L>
      <L>    #       ....#</L>
      <L>    #############</L>
    </Level>
    <Level Id="ncc playground 1" Width="18" Height="17">
      <L>      ####</L>
      <L>      #  #</L>
      <L>      #$ #####</L>
      <L>      #  #   #</L>
      <L>#######$ #$#.####</L>
      <L>#   .        #  #</L>
      <L># * $ ###### #.$#</L>
      <L># .#.#######.#. #</L>
      <L># $#         #.$#</L>
      <L># .#$#.### # #. #</L>
      <L># $#@$ #   #  .$#</L>
      <L># .### # ###..  #</L>
      <L># $# # #  $ . # ##</L>
      <L># .###.### ##$$$ #</L>
      <L># $$     $    *. #</L>
      <L>#  ###  #######  #</L>
      <L>#### ####     ####</L>
    </Level>
    <Level Id="ncc playground 2" Width="18" Height="17">
      <L>      ####</L>
      <L>      #  #</L>
      <L>      #$ #####</L>
      <L>      #  #   #</L>
      <L>#######$ #$#.####</L>
      <L>#   .        #  #</L>
      <L># * $ ### ##.#.$#</L>
      <L># .#.#### ##.#. #</L>
      <L># $#    $    #.$#</L>
      <L># .#$#.### # #. #</L>
      <L># $#@$ #   #  .$#</L>
      <L># .### # ###..  #</L>
      <L># $# # #  $ . # ##</L>
      <L># .###.### ##$$$ #</L>
      <L># $$     $    *. #</L>
      <L>#  ###  #######  #</L>
      <L>#### ####     ####</L>
    </Level>
    <Level Id="aaaa_cross" Width="21" Height="21">
      <L>#######       #######</L>
      <L>#     #       #     #</L>
      <L># $$$ #       # $$$ #</L>
      <L># $    #     #    $ #</L>
      <L># $   * ##### *   $ #</L>
      <L># $# * * #.# * * #$ #</L>
      <L>#  # .*. # # .*. #  #</L>
      <L>#### . . $ $ . . ####</L>
      <L>   ##. .$ . $. .##</L>
      <L>   # # $ ... $ # #</L>
      <L>   #  $ ..... $  #</L>
      <L>   # # $ ... $ # #</L>
      <L>   ##. .$ . $. .##</L>
      <L>#### . . $ $ . . ####</L>
      <L>#  # .*. # # .*. #  #</L>
      <L># $# * * #@# * * #$ #</L>
      <L># $   * ##### *   $ #</L>
      <L># $    #     #    $ #</L>
      <L># $$$ #       # $$$ #</L>
      <L>#     #       #     #</L>
      <L>#######       #######</L>
    </Level>
    <Level Id="double z" Width="22" Height="17">
      <L>         #####</L>
      <L>        ##   ##</L>
      <L>       ##     ##</L>
      <L>       #  *.*  #</L>
      <L>       #    *  #</L>
      <L>       # #$*$# #</L>
      <L>       #  *    #</L>
      <L>       # #*.*###</L>
      <L>       ####@####</L>
      <L> ########## #########</L>
      <L>##                  ##</L>
      <L>#  ****************  #</L>
      <L>#                 *  #</L>
      <L>#  $**************   #</L>
      <L>#  *                 #</L>
      <L>#  ********.*******  #</L>
      <L>######################</L>
    </Level>
    <Level Id="mouth_full" Width="23" Height="8">
      <L>        #######</L>
      <L>######### ... #########</L>
      <L># ........ # ........ #</L>
      <L>#   ##### *$* #####   #</L>
      <L># $      $ @ $      $ #</L>
      <L>## $$$$$$ $ $ $$$$$$ ##</L>
      <L> #       #   #       #</L>
      <L> #####################</L>
    </Level>
    <Level Id="medium x" Width="17" Height="17">
      <L>#################</L>
      <L>#.     . .     .#</L>
      <L># .  $ $ $ $  . #</L>
      <L># $.#########.$ #</L>
      <L>#   . $   $ .   #</L>
      <L># $##. $ $ .# $ #</L>
      <L>#   # .   . ##  #</L>
      <L># $  #$.#.$#  $ #</L>
      <L>#  $    +    $  #</L>
      <L># $  #$.#.$#  $ #</L>
      <L>#  ## . $ . ##  #</L>
      <L># $  .  #  .  $ #</L>
      <L>#   .#######.   #</L>
      <L># $. $ $ $ $ .$ #</L>
      <L># .   $   $   . #</L>
      <L>#.     . .     .#</L>
      <L>#################</L>
    </Level>
    <Level Id="candle tree" Width="33" Height="23">
      <L>             ########</L>
      <L>             #  *   #</L>
      <L>            #  $@$  #</L>
      <L>           #  $ * $  #</L>
      <L>          #  $. . .$  #</L>
      <L>         #  $ $ $ $ $  #</L>
      <L>        #  $. . . . .$  #</L>
      <L>       #  $ $ $ $ $ $ $  #</L>
      <L>      #  $. . . . . . .$  #</L>
      <L>     #  $ $ $ $ $ $ $ $ $  #</L>
      <L>    #  $. . . . . . . . .$  #</L>
      <L>   #  $ $ $ $ $ $ $ $ $ $ $  #</L>
      <L>  #  $. . . . . . . . . . .$  #</L>
      <L> #  $ $ $ $ $ $ $ $ $ $ $ $ $  #</L>
      <L>#  $. . . . . . . . . . . . .$  #</L>
      <L># $.$.$.$.$.$.$.$.$.$.$.$.$.$.$ #</L>
      <L>#             $ . $             #</L>
      <L>############ $ ... $ ############</L>
      <L>           ##  ...  ##</L>
      <L>            #  ...  #</L>
      <L>            #  ...  #</L>
      <L>            # ..... #</L>
      <L>            #########</L>
    </Level>
    <Level Id="back seven" Width="14" Height="10">
      <L> #######</L>
      <L>##     #</L>
      <L>#  *** #####</L>
      <L># *+*  #...#</L>
      <L>#  **  ## .###</L>
      <L>##  $$ ##  ..#</L>
      <L> ##  $     ###</L>
      <L>  ### $$$$ #</L>
      <L>    #      #</L>
      <L>    ########</L>
    </Level>
    <Level Id="back one" Width="10" Height="10">
      <L>   #####</L>
      <L> ###   #</L>
      <L> #     ##</L>
      <L> # ***  #</L>
      <L>## *+*  #</L>
      <L>#  **** ##</L>
      <L># $   *  #</L>
      <L>#  ##  * #</L>
      <L>#  ###   #</L>
      <L>#### #####</L>
    </Level>
    <Level Id="easy 123" Width="19" Height="15">
      <L>###################</L>
      <L>#                 #</L>
      <L># $************** #</L>
      <L># *             * #</L>
      <L># * ***** ***** * #</L>
      <L># * *   * *   * * #</L>
      <L># * * * * * * * . #</L>
      <L># * * * * * * * * #</L>
      <L># * *** * * *** * #</L>
      <L># *     * *     * #</L>
      <L># *******@******* #</L>
      <L>#                 #</L>
      <L>########   ########</L>
      <L>       #   #</L>
      <L>       #####</L>
    </Level>
    <Level Id="easy 12345" Width="19" Height="14">
      <L>       #####</L>
      <L>########   ########</L>
      <L>#                 #</L>
      <L># $*************. #</L>
      <L># *             * #</L>
      <L># * ***** ***** * #</L>
      <L># * *   * *   * * #</L>
      <L># * * * * * * * * #</L>
      <L># * * * * * * * * #</L>
      <L># * *** * * *** * #</L>
      <L># *     * *     * #</L>
      <L># $******@******. #</L>
      <L>#                 #</L>
      <L>###################</L>
    </Level>
    <Level Id="single cone" Width="19" Height="14">
      <L>     #########</L>
      <L>######       ######</L>
      <L>#                 #</L>
      <L># *************** #</L>
      <L># *             * #</L>
      <L># * ***** ***** * #</L>
      <L># * *   * *   * * #</L>
      <L># * * $ * * * * * #</L>
      <L># * * * * * * * * #</L>
      <L># * *** * * *** . #</L>
      <L># *     * *     * #</L>
      <L># *******@******* #</L>
      <L>#                 #</L>
      <L>###################</L>
    </Level>
    <Level Id="double cone" Width="37" Height="14">
      <L>#####################################</L>
      <L>#                 #                 #</L>
      <L># ******* ******* # *******@******* #</L>
      <L># *     * *     * # *     * *     * #</L>
      <L># * *** * * *** .   . *** * * *** * #</L>
      <L># * * * * * * * * # * * * * * * * * #</L>
      <L># * * $ * * * * * # * * * * * $ * * #</L>
      <L># * *   * *   * * # * *   * *   * * #</L>
      <L># * ***** ***** * # * ***** ***** * #</L>
      <L># *             * # *             * #</L>
      <L># ******...****** # ******$$$****** #</L>
      <L>#                 #                 #</L>
      <L>######       ###########       ######</L>
      <L>     #########         #########</L>
    </Level>
    <Level Id="dance sparkle" Width="21" Height="14">
      <L>#####################</L>
      <L>#         #         #</L>
      <L># ******* . ******* #</L>
      <L># *     * + *     * #</L>
      <L># * *** . . . *** * #</L>
      <L># * * * * $ * * * * #</L>
      <L># * * * * $ * * * * #</L>
      <L># *   * * $ * *   * #</L>
      <L># ***** * $ * ***** #</L>
      <L>#       * $ *       #</L>
      <L># .****** $ ******* #</L>
      <L>#         #         #</L>
      <L>#    ###########    #</L>
      <L>######         ######</L>
    </Level>
    <Level Id="falling down" Width="13" Height="20">
      <L>#############</L>
      <L>#           #</L>
      <L># $$$$$$$ $ #</L>
      <L># $     $ $ #</L>
      <L># $ $$$ $ $ #</L>
      <L># $ $   $ $ #</L>
      <L># $ $$$$$ $ #</L>
      <L># $       $ #</L>
      <L># $$$$$$$$$ #</L>
      <L>#           #</L>
      <L>######@######</L>
      <L> #         #</L>
      <L> #. .......#</L>
      <L> #. .     .#</L>
      <L> #. . ... .#</L>
      <L> #.#.###.#.#</L>
      <L>##. ..... .##</L>
      <L># .#######. #</L>
      <L># ......... #</L>
      <L>#############</L>
    </Level>
    <Level Id="candy" Width="12" Height="11">
      <L>########</L>
      <L>#      #</L>
      <L># ##$#$####</L>
      <L># @  $ $  #</L>
      <L># $#   # $##</L>
      <L>#    $   $ #</L>
      <L>######.#.# #</L>
      <L>     #.#.$ #</L>
      <L>     #.#*#.#</L>
      <L>     #...  #</L>
      <L>     #######</L>
    </Level>
    <Level Id="sugar pop" Width="14" Height="14">
      <L> ########</L>
      <L> #....  #</L>
      <L> #.#.* @###</L>
      <L> #.##.#$  #</L>
      <L> #..* $   #</L>
      <L> # ## # $ #</L>
      <L> #  # ### ####</L>
      <L> ##$# $ $ $  #</L>
      <L>  # #   $ #  #</L>
      <L>### # # # #$ #</L>
      <L>#   $   #    #</L>
      <L># ##### ######</L>
      <L>#       #</L>
      <L>#########</L>
    </Level>
    <Level Id="crap 1" Width="12" Height="15">
      <L>#######</L>
      <L>#  #  #</L>
      <L>#   $ #####</L>
      <L># $## ##  #</L>
      <L>## #..##  #</L>
      <L> # #....$ #</L>
      <L> # #..##  #</L>
      <L> # #..## $##</L>
      <L> # $  ## $ #</L>
      <L> #  $ $    #</L>
      <L> #@  ####$ #</L>
      <L> ## $      #</L>
      <L>  # # ######</L>
      <L>  #   #</L>
      <L>  #####</L>
    </Level>
    <Level Id="crap 2" Width="12" Height="15">
      <L>#######</L>
      <L>#  #  #</L>
      <L>#   $ #####</L>
      <L># $## ##  #</L>
      <L>## #..##  #</L>
      <L> # #....$ #</L>
      <L> # #..### #</L>
      <L> # #..## $##</L>
      <L> # $  ## $ #</L>
      <L> #  $ $    #</L>
      <L> #@  ####$ #</L>
      <L> ## $      #</L>
      <L>  # # ######</L>
      <L>  #   #</L>
      <L>  #####</L>
    </Level>
    <Level Id="olympic" Width="16" Height="19">
      <L>       #####</L>
      <L>     ###   #</L>
      <L>     #.  #$#</L>
      <L>######.  $ ##</L>
      <L># ..... #  @#</L>
      <L># $###.  $$ #</L>
      <L># ...*. # $ #</L>
      <L># *.### $   #</L>
      <L>##*.##  ##$ #</L>
      <L> #.###    $ #</L>
      <L> #...# $$ $ #</L>
      <L> #...# $  $ #</L>
      <L> #.... $ #$ #</L>
      <L> ##  # $  $ ###</L>
      <L>  #### $$$$ $ ##</L>
      <L>     #       $ #</L>
      <L>     ##### $   #</L>
      <L>         #  ####</L>
      <L>         ####</L>
    </Level>
    <Level Id="good old times" Width="19" Height="11">
      <L> ####</L>
      <L> #  ##</L>
      <L> # $ #       ####</L>
      <L>##  $#########  #</L>
      <L># $           +.###</L>
      <L>#  $ # ####  #....#</L>
      <L>###  #       #....#</L>
      <L>  #$ # $ $ $ $.*..#</L>
      <L>  # $$$ $##########</L>
      <L>  #      #</L>
      <L>  ########</L>
    </Level>
    <Level Id="&gt; 3000 moves" Width="17" Height="17">
      <L>     ###########</L>
      <L>     #         #</L>
      <L>  ####  $ #$$$ #</L>
      <L>  #...# #  $   #</L>
      <L>  #...# # $### #</L>
      <L>###...# #  $ # #</L>
      <L># ....# # $$ # #</L>
      <L># ....# $  $ # #</L>
      <L># ..### ##   # #</L>
      <L>## ##@$  ##$ # #</L>
      <L> # # $  $    # #</L>
      <L> # #   $ #$### ##</L>
      <L> # #####     $  #</L>
      <L> # #######$#### #</L>
      <L> #              #</L>
      <L> #  #############</L>
      <L> ####</L>
    </Level>
    <Level Id="twin castle" Width="16" Height="16">
      <L>  ############</L>
      <L>  #      #   #</L>
      <L>  # ####$# # #</L>
      <L>  #  $     # ###</L>
      <L>  ## ###$# $   #</L>
      <L>   # #..  $  $ #</L>
      <L>   # #.*##  $@ #</L>
      <L>   # #.. ## ## #</L>
      <L>   # #.*  $    #</L>
      <L>#### #.*$ # #$ #</L>
      <L>#... #.*  # #  #</L>
      <L>#... ###$ # $  #</L>
      <L>#...   $  #   ##</L>
      <L>###  $$$# $ ###</L>
      <L>  ##        #</L>
      <L>   ##########</L>
    </Level>
    <Level Id="little twist" Width="17" Height="11">
      <L>      ######</L>
      <L>  ### #    ##</L>
      <L> ##.### $ $@#</L>
      <L> # ...#  #####</L>
      <L> #.. .# $#   ##</L>
      <L> ##...   # $  #</L>
      <L> #..##$  #$#$ ###</L>
      <L> #  $  #$$ $    #</L>
      <L>## $        #   #</L>
      <L>#    ############</L>
      <L>######</L>
    </Level>
    <Level Id="medium twist" Width="11" Height="17">
      <L>        ###</L>
      <L>  ####### #</L>
      <L> ## .#..  #</L>
      <L> #......$ #</L>
      <L> ##. .#*  #</L>
      <L>  #...#. ##</L>
      <L>##### $  #</L>
      <L>#      # #</L>
      <L># $ $  $ #</L>
      <L>#  $$$#$ #</L>
      <L># $$  $  #</L>
      <L>##@# $#$ #</L>
      <L> ###  $ ##</L>
      <L>   ##    #</L>
      <L>    ###  #</L>
      <L>      #  #</L>
      <L>      ####</L>
    </Level>
    <Level Id="desperado" Width="19" Height="12">
      <L>      ##########</L>
      <L>  #####        #</L>
      <L>  #  #  ****** #</L>
      <L> ## *****    * ####</L>
      <L> #  *     $  *    #</L>
      <L>##$ * $ * *  **** #</L>
      <L>#   *    *****  * #</L>
      <L>#   ******  *   * #</L>
      <L>####     * *@*  * #</L>
      <L>   ##### *  *#  * #</L>
      <L>       #     ##...#</L>
      <L>       ############</L>
    </Level>
    <Level Id="inca robot" Width="13" Height="22">
      <L> ###     ###</L>
      <L> #.#     #.#</L>
      <L> #.# ### #.#</L>
      <L> #.###.###.#</L>
      <L> #.##...##.#</L>
      <L> #.## . ##.#</L>
      <L> #.........#</L>
      <L> #    .    #</L>
      <L> #  #...#  #</L>
      <L> #  # . #  #</L>
      <L> # # .@. # #</L>
      <L> #   $ $   #</L>
      <L> #    $    #</L>
      <L> #$  $$$  $#</L>
      <L> #    $    #</L>
      <L>##$$$$$$$$$##</L>
      <L># $   $   $ #</L>
      <L># $  $$$  $ #</L>
      <L># $   $   $ #</L>
      <L># $       $ #</L>
      <L>#           #</L>
      <L>#############</L>
    </Level>
    <Level Id="sedan" Width="16" Height="17">
      <L>       ######</L>
      <L>   #####....#</L>
      <L>   #........#</L>
      <L>   #....#. ##</L>
      <L>   #...*#.##</L>
      <L>   #*...#.####</L>
      <L>   # $  $$ $ #</L>
      <L>  ##  #      #</L>
      <L>  #  # $ ##$ ###</L>
      <L>  #  $ #$#   $ #</L>
      <L>### $# # $$#$$ #</L>
      <L>#    $ $     $ #</L>
      <L>#   $# # $###$ #</L>
      <L>###  #@$       #</L>
      <L>  ####$##$ $$  #</L>
      <L>     #        ##</L>
      <L>     ##########</L>
    </Level>
    <Level Id="micro chip" Width="17" Height="13">
      <L>        ########</L>
      <L>        #@     ##</L>
      <L>   ######$$$$ $ #</L>
      <L>   #..    $ # $ #</L>
      <L>  ##..# $ # # $ #</L>
      <L>  #...# # $ # # #</L>
      <L>###...#$##$ $ $ #</L>
      <L>#.....   $    # #</L>
      <L>#  ...# $##$#$# #</L>
      <L>## ## #         #</L>
      <L>#     ###########</L>
      <L>#     #</L>
      <L>#######</L>
    </Level>
    <Level Id="smart moves" Width="9" Height="13">
      <L>#######</L>
      <L>#     #</L>
      <L># *** #</L>
      <L># * * #</L>
      <L># $.$ #</L>
      <L># *.* #</L>
      <L># $.$ #</L>
      <L># *.* ###</L>
      <L># *+*   #</L>
      <L># *** $ #</L>
      <L>#     ###</L>
      <L>###  ##</L>
      <L>  ####</L>
    </Level>
    <Level Id="blade" Width="12" Height="8">
      <L>############</L>
      <L>#    ..    #</L>
      <L># ******** #</L>
      <L># *@     * #</L>
      <L># $******$ #</L>
      <L>#          #</L>
      <L>#####  #####</L>
      <L>    ####</L>
    </Level>
    <Level Id="O Line" Width="21" Height="17">
      <L>              #######</L>
      <L>              #   # #</L>
      <L>############### #   #</L>
      <L>#                 # #</L>
      <L># ## #########   ## #</L>
      <L># ## #     ### ###  #</L>
      <L># ## # $*$ ### #   ##</L>
      <L># ## # *@* #.# # ###</L>
      <L># ## # * * #.# # #</L>
      <L># ## # * * #.# # #</L>
      <L># ## # * * #.# # #</L>
      <L># ## # * * # # # #</L>
      <L># ## # * * #     #</L>
      <L># ##   $*$ # ### #</L>
      <L>#          #     #</L>
      <L>######  ##########</L>
      <L>   ######</L>
    </Level>
    <Level Id="happy landings" Width="20" Height="25">
      <L>   #################</L>
      <L>####   # @ #       #</L>
      <L>#   $   $$   $ $ $ #</L>
      <L># ### ###  #### $  #</L>
      <L># # $ ##  #####$ $ #</L>
      <L># $    # ###### $  #</L>
      <L># ###  #$######$ $ #</L>
      <L>#          $  $    #</L>
      <L>##$$   $   $  $ ####</L>
      <L>#  $$$$$ $$$$ $ #</L>
      <L>#             $ #</L>
      <L>###  ########$$ #</L>
      <L>  ## #  $       #</L>
      <L>   # #  $  #### #</L>
      <L>   # # $$$ # .# #</L>
      <L>   # # $   # .# #</L>
      <L> ###$# $#### .# #</L>
      <L> # $ $  $  $ .# #</L>
      <L> # $         .# ###</L>
      <L> #   ########.. $ #</L>
      <L> #............. $ #</L>
      <L> ####..........   #</L>
      <L>    #..........####</L>
      <L>    #..........#</L>
      <L>    ############</L>
    </Level>
    <Level Id="dentine ice" Width="17" Height="18">
      <L>       #######</L>
      <L>       #     #</L>
      <L> #######$    #</L>
      <L> # $  $   $###</L>
      <L> #    ## $@#</L>
      <L> ####  #  $#</L>
      <L> # $  $# $ #####</L>
      <L> #  $ $ $      #</L>
      <L> ## $  $  $### ##</L>
      <L> #  $ ###$ .....#</L>
      <L> #   $     .....#</L>
      <L>## $# $    .....#</L>
      <L># $ ##     .....#</L>
      <L>#  $# .* ########</L>
      <L># $ # .* #</L>
      <L>#  $# .* #</L>
      <L>#     .* #</L>
      <L>##########</L>
    </Level>
    <Level Id="barricade pop" Width="11" Height="14">
      <L> #########</L>
      <L> #  . *  #</L>
      <L> # #* .# #</L>
      <L> # $. .$ #</L>
      <L>## #*$.# #</L>
      <L>#   . .$ #</L>
      <L># $#*$.# ##</L>
      <L>#  $. .$  #</L>
      <L>#  #* .#$ #</L>
      <L># $$. . $ #</L>
      <L>#  #* .#$ #</L>
      <L>##$ .$. $@#</L>
      <L> #   ######</L>
      <L> #####</L>
    </Level>
    <Level Id="cunucu" Width="13" Height="10">
      <L> #####</L>
      <L> #   # ####</L>
      <L>##$ $###@.#</L>
      <L>#  *   $  ###</L>
      <L># $.*.$ $   #</L>
      <L># #..* .##. #</L>
      <L># # $$ ..*$ #</L>
      <L># ##   **  ##</L>
      <L>#    ##    #</L>
      <L>############</L>
    </Level>
    <Level Id="bees" Width="14" Height="17">
      <L>   ##### ####</L>
      <L>  ##   ###  #</L>
      <L>  # $ $   $ #</L>
      <L>  #    $ $$ #</L>
      <L>  #$ $$ $   #</L>
      <L>  #     $ $ #</L>
      <L>###$ #$$#@$ #</L>
      <L>#   $#   #  #</L>
      <L>#  $ #$ $ # ##</L>
      <L>###          #</L>
      <L> #  ##.##### #</L>
      <L> # ## .....# #</L>
      <L> # #. .....# #</L>
      <L> # ........  #</L>
      <L> # ####### ###</L>
      <L> #         #</L>
      <L> ###########</L>
    </Level>
    <Level Id="O Line 2" Width="21" Height="17">
      <L>              #####</L>
      <L>              #   ###</L>
      <L>###############$#   #</L>
      <L>#                 # #</L>
      <L># ## ######### $ ## #</L>
      <L># ## #     ### ###  #</L>
      <L># ## # $*$ #.# #   ##</L>
      <L># ## # *@* #.# # ###</L>
      <L># ## # * *  .# # #</L>
      <L># ## # * * #.# # #</L>
      <L># ## # * * #.# # #</L>
      <L># ## # * * #.# # #</L>
      <L># ## # * * #..   #</L>
      <L># ## $ $*$ # ### #</L>
      <L>#  $       #     #</L>
      <L>######  ##########</L>
      <L>   ######</L>
    </Level>
    <Level Id="O Line 3" Width="21" Height="17">
      <L>              #####</L>
      <L>              #   ###</L>
      <L>###############$#   #</L>
      <L>#                 # #</L>
      <L># ## ######### $ ## #</L>
      <L># ## #     ### ###  #</L>
      <L># ## # $*$ #.# #   ##</L>
      <L># ## # *@* #.# # ###</L>
      <L># ## # * * #.# # #</L>
      <L># ## # * * #.# # #</L>
      <L># ## # * * #.# # #</L>
      <L># ## # * * #.# # #</L>
      <L># #  # * * #..   #</L>
      <L># #  $ $*$ # ### #</L>
      <L>#  $       #     #</L>
      <L>######  ##########</L>
      <L>   ######</L>
    </Level>
    <Level Id="bubble up" Width="17" Height="13">
      <L>            ####</L>
      <L>   ##########..#</L>
      <L>   #   ........#</L>
      <L>   # $ ######..##</L>
      <L>#####$ .........#</L>
      <L>#  $  $ $ $  $  #</L>
      <L># $$   ##$#$$ $ #</L>
      <L>#  @# $#    $ $ #</L>
      <L>##$##  # $#   ###</L>
      <L>#  $   $  #  ##</L>
      <L># $## ########</L>
      <L>#      #</L>
      <L>########</L>
    </Level>
    <Level Id="go fishing" Width="26" Height="19">
      <L>            #</L>
      <L>            ####</L>
      <L>            #  #</L>
      <L>            ####</L>
      <L>            #</L>
      <L>       ###  #  ###</L>
      <L>      #   # # #   #</L>
      <L>      #  @ ###    #</L>
      <L>     # $$$$   $$$$ #</L>
      <L>    #       $       #</L>
      <L>   # $$$$$$$$$$$$$$$ #</L>
      <L>  #                   #</L>
      <L> # $$$$$$$$$$$$$$$$$$$ ##</L>
      <L>##          $           ##</L>
      <L> ## #####$$$$$$$###### ##</L>
      <L>  #.........*..........#</L>
      <L>   #.......*.*........#</L>
      <L>    #................#</L>
      <L>     ################</L>
    </Level>
    <Level Id="planet a" Width="22" Height="15">
      <L>                #####</L>
      <L>######          #. .#</L>
      <L>#    ####   ##### . #</L>
      <L>#  $$$  #   #. . . .#</L>
      <L>#@$   $ #   # . . . #</L>
      <L>####    #   #. . . ##</L>
      <L>   # $$$##### . . .#</L>
      <L>   # $  $ $ #. . . #</L>
      <L>   # $  $ $ # . . .##</L>
      <L>   # $  $ $ #. . . .##</L>
      <L>   #  $$$            #</L>
      <L>   #      $ $ $ $ $ ##</L>
      <L>   #  $ #############</L>
      <L>   ##  ##</L>
      <L>    ####</L>
    </Level>
    <Level Id="planet b" Width="22" Height="15">
      <L>                #####</L>
      <L>######          #. .#</L>
      <L>#    ####   ##### . #</L>
      <L>#  $$$  #   #. . . .#</L>
      <L>#@$   $ #   # . . . #</L>
      <L>#### #  #   #. . . ##</L>
      <L>   # $$$##### . . .#</L>
      <L>   # $  $ $ #. . . #</L>
      <L>   # $  $ $ # . . .##</L>
      <L>   # $  $ $ #. . . .##</L>
      <L>   #  $$$            #</L>
      <L>   #      $ $ $ $ $ ##</L>
      <L>   #  $ #############</L>
      <L>   ##  ##</L>
      <L>    ####</L>
    </Level>
    <Level Id="bowling" Width="21" Height="17">
      <L>#####################</L>
      <L>#         @         #</L>
      <L># $ * * * * * * * $ #</L>
      <L># # # # # # # # # # #</L>
      <L># * # * # * # * # * #</L>
      <L># # * # * # * # * # #</L>
      <L># * # * # $ # * # * #</L>
      <L># # * # $ # $ # * # #</L>
      <L># * # * # $ # * # * #</L>
      <L># # * # * # * # * # #</L>
      <L># * # * # * # * # * #</L>
      <L># ### # # . # # ### #</L>
      <L># $ * * * * * * * $ #</L>
      <L>#         .         #</L>
      <L>########. . .########</L>
      <L>       # ... #</L>
      <L>       #######</L>
    </Level>
    <Level Id="snowflakes" Width="23" Height="31">
      <L>        #######</L>
      <L>       ##.....##</L>
      <L>      ##.  *  .##</L>
      <L>     ##.  *$*  .##</L>
      <L>    ##.    *    .##</L>
      <L>   ##.   *   *   .##</L>
      <L>  ##.   *$* *$*   .##</L>
      <L> ##.     *   *     .##</L>
      <L>##.    *   *   *    .##</L>
      <L>##    *$* *$* *$*    ##</L>
      <L>##     *   *   *     ##</L>
      <L>##   *   *   *   *   ##</L>
      <L>##  *$* *$* *$* *$*  ##</L>
      <L>##   *   *   *   *   ##</L>
      <L>#  *   *   *   *   *  #</L>
      <L># *$* *$* *@* *$* *$* #</L>
      <L>#  *   *   *   *   *  #</L>
      <L>##   *   *   *   *   ##</L>
      <L>##  *$* *$* *$* *$*  ##</L>
      <L>##   *   *   *   *   ##</L>
      <L>##     *   *   *     ##</L>
      <L>##    *$* *$* *$*    ##</L>
      <L>##     *   *   *     ##</L>
      <L> ##      *   *      ##</L>
      <L>  ##    *$* *$*    ##</L>
      <L>   ##    *   *    ##</L>
      <L>    ##     *     ##</L>
      <L>     ##   *$*   ##</L>
      <L>      ##   *   ##</L>
      <L>       ##.....##</L>
      <L>        #######</L>
    </Level>
    <Level Id="sos" Width="43" Height="23">
      <L>###########################################</L>
      <L>#             #             #             #</L>
      <L>#  *   *   *  #  *   *   *  #  *   *   *  #</L>
      <L># *$* *$* *$* # *$* *$* *$* # *$* *$* *$* #</L>
      <L>#  *   *   *  #  *   *   *  #  *   *   *  #</L>
      <L>#             #             #             #</L>
      <L>#  *   .      #  *   .   *  #  *   .      #</L>
      <L># *$* ...     # *$* ... *$* # *$* ...     #</L>
      <L>#  *   .      #  *   .   *  #  *   .      #</L>
      <L>#             #      .      #             #</L>
      <L>#  *   *   *  #  *   *   *  #  *   *   *  #</L>
      <L># *$* *$* *$*   *$* *@* *$*   *$* *$* *$* #</L>
      <L>#  *   *   *  #  *   *   *  #  *   *   *  #</L>
      <L>#             #      .      #             #</L>
      <L>#      .   *  #  *   .   *  #      .   *  #</L>
      <L>#  .  ... *$* # *$* ... *$* #  .  ... *$* #</L>
      <L>#      .   *  #  *   .   *  #      .   *  #</L>
      <L>#             #             #             #</L>
      <L>#  *   *   *  #  *   *   *  #  *   *   *  #</L>
      <L># *$* *$* *$* # *$* *$* *$* # *$* *$* *$* #</L>
      <L>#  *   *   *  #  *   *   *  #  *   *   *  #</L>
      <L>#             #             #             #</L>
      <L>###########################################</L>
    </Level>
    <Level Id="dushi = sweet" Width="27" Height="20">
      <L>###########################</L>
      <L>#@                        #</L>
      <L># $$$  $# $ $$$$ $  $ $$$ #</L>
      <L># $  $ $  $ $    $# $  $  #</L>
      <L># $  $ $# $ $ #  $  $ #$# #</L>
      <L># $ #$ $  $ $$$$ $$$$  $  #</L>
      <L># $  $ $# $ #  $ $  $ #$# #</L>
      <L># $  $ $  $    $ $ #$  $  #</L>
      <L># $$$  $$$$ $$$$ $  $ $$$ #</L>
      <L>#                         #</L>
      <L>############# #############</L>
      <L> #                       #</L>
      <L> #...  .# . .... .  . ...#</L>
      <L> #.  . .  . .    .# .  . #</L>
      <L> #.  . .# . . #  .  . #.##</L>
      <L> #. #. .  . .... ....  . #</L>
      <L> #.  . .# . #  . . #. #. #</L>
      <L> #.  . .  .    . .  .  . #</L>
      <L> #...##....#....#.##.#...#</L>
      <L> #########################</L>
    </Level>
  </LevelCollection>
</SokobanLevels>
