<?xml version="1.0" encoding="utf-8"?>
<SokobanLevels xmlns:xsi="http://www.w3.org/2001/XMLSchema-instance" xsi:schemaLocation="SokobanLev.xsd">
  <Title>Fibonacci Challenge</Title>
  <Description>
A wacky style of playing sokoban: by managing LURD solutions. You can
find the Golden Ratio (phi=1,618...) by dividing the number of moves
of a level by the moves of the previous level. The higher &quot;n&quot; can
reach, closer to &quot;phi&quot; the ratio comes. The same happens to pushes,
box lines, box changes, pushing sessions and player lines. See how
close to the 30-box level you can get solved!
  </Description>
  <Email>kevinccravo@hotmail.com</Email>
  <LevelCollection Copyright="Kevin Cassol" MaxWidth="7" MaxHeight="34">
    <Level Id="n=5" Width="7" Height="9">
      <L> #####</L>
      <L> # + #</L>
      <L> #$.$##</L>
      <L>## *  #</L>
      <L>#  *  #</L>
      <L>#  . ##</L>
      <L>##$# #</L>
      <L> #   #</L>
      <L> #####</L>
    </Level>
    <Level Id="n=6" Width="7" Height="10">
      <L> #####</L>
      <L> # + #</L>
      <L> #$.$#</L>
      <L> # * ##</L>
      <L>## *  #</L>
      <L>#  *  #</L>
      <L>#  . ##</L>
      <L>##$# #</L>
      <L> #   #</L>
      <L> #####</L>
    </Level>
    <Level Id="n=7" Width="7" Height="11">
      <L> #####</L>
      <L> # + #</L>
      <L> #$.$#</L>
      <L> # * #</L>
      <L> # * ##</L>
      <L>## *  #</L>
      <L>#  *  #</L>
      <L>#  . ##</L>
      <L>##$# #</L>
      <L> #   #</L>
      <L> #####</L>
    </Level>
    <Level Id="n=8" Width="7" Height="12">
      <L> #####</L>
      <L> # + #</L>
      <L> #$.$#</L>
      <L> # * #</L>
      <L> # * #</L>
      <L> # * ##</L>
      <L>## *  #</L>
      <L>#  *  #</L>
      <L>#  . ##</L>
      <L>##$# #</L>
      <L> #   #</L>
      <L> #####</L>
    </Level>
    <Level Id="n=9" Width="7" Height="13">
      <L> #####</L>
      <L> # + #</L>
      <L> #$.$#</L>
      <L> # * #</L>
      <L> # * #</L>
      <L> # * #</L>
      <L> # * ##</L>
      <L>## *  #</L>
      <L>#  *  #</L>
      <L>#  . ##</L>
      <L>##$# #</L>
      <L> #   #</L>
      <L> #####</L>
    </Level>
    <Level Id="n=10" Width="7" Height="14">
      <L> #####</L>
      <L> # + #</L>
      <L> #$.$#</L>
      <L> # * #</L>
      <L> # * #</L>
      <L> # * #</L>
      <L> # * #</L>
      <L> # * ##</L>
      <L>## *  #</L>
      <L>#  *  #</L>
      <L>#  . ##</L>
      <L>##$# #</L>
      <L> #   #</L>
      <L> #####</L>
    </Level>
    <Level Id="n=11" Width="7" Height="15">
      <L> #####</L>
      <L> # + #</L>
      <L> #$.$#</L>
      <L> # * #</L>
      <L> # * #</L>
      <L> # * #</L>
      <L> # * #</L>
      <L> # * #</L>
      <L> # * ##</L>
      <L>## *  #</L>
      <L>#  *  #</L>
      <L>#  . ##</L>
      <L>##$# #</L>
      <L> #   #</L>
      <L> #####</L>
    </Level>
    <Level Id="n=12" Width="7" Height="16">
      <L> #####</L>
      <L> # + #</L>
      <L> #$.$#</L>
      <L> # * #</L>
      <L> # * #</L>
      <L> # * #</L>
      <L> # * #</L>
      <L> # * #</L>
      <L> # * #</L>
      <L> # * ##</L>
      <L>## *  #</L>
      <L>#  *  #</L>
      <L>#  . ##</L>
      <L>##$# #</L>
      <L> #   #</L>
      <L> #####</L>
    </Level>
    <Level Id="n=13" Width="7" Height="17">
      <L> #####</L>
      <L> # + #</L>
      <L> #$.$#</L>
      <L> # * #</L>
      <L> # * #</L>
      <L> # * #</L>
      <L> # * #</L>
      <L> # * #</L>
      <L> # * #</L>
      <L> # * #</L>
      <L> # * ##</L>
      <L>## *  #</L>
      <L>#  *  #</L>
      <L>#  . ##</L>
      <L>##$# #</L>
      <L> #   #</L>
      <L> #####</L>
    </Level>
    <Level Id="n=14" Width="7" Height="18">
      <L> #####</L>
      <L> # + #</L>
      <L> #$.$#</L>
      <L> # * #</L>
      <L> # * #</L>
      <L> # * #</L>
      <L> # * #</L>
      <L> # * #</L>
      <L> # * #</L>
      <L> # * #</L>
      <L> # * #</L>
      <L> # * ##</L>
      <L>## *  #</L>
      <L>#  *  #</L>
      <L>#  . ##</L>
      <L>##$# #</L>
      <L> #   #</L>
      <L> #####</L>
    </Level>
    <Level Id="n=15" Width="7" Height="19">
      <L> #####</L>
      <L> # + #</L>
      <L> #$.$#</L>
      <L> # * #</L>
      <L> # * #</L>
      <L> # * #</L>
      <L> # * #</L>
      <L> # * #</L>
      <L> # * #</L>
      <L> # * #</L>
      <L> # * #</L>
      <L> # * #</L>
      <L> # * ##</L>
      <L>## *  #</L>
      <L>#  *  #</L>
      <L>#  . ##</L>
      <L>##$# #</L>
      <L> #   #</L>
      <L> #####</L>
    </Level>
    <Level Id="n=16" Width="7" Height="20">
      <L> #####</L>
      <L> # + #</L>
      <L> #$.$#</L>
      <L> # * #</L>
      <L> # * #</L>
      <L> # * #</L>
      <L> # * #</L>
      <L> # * #</L>
      <L> # * #</L>
      <L> # * #</L>
      <L> # * #</L>
      <L> # * #</L>
      <L> # * #</L>
      <L> # * ##</L>
      <L>## *  #</L>
      <L>#  *  #</L>
      <L>#  . ##</L>
      <L>##$# #</L>
      <L> #   #</L>
      <L> #####</L>
    </Level>
    <Level Id="n=17" Width="7" Height="21">
      <L> #####</L>
      <L> # + #</L>
      <L> #$.$#</L>
      <L> # * #</L>
      <L> # * #</L>
      <L> # * #</L>
      <L> # * #</L>
      <L> # * #</L>
      <L> # * #</L>
      <L> # * #</L>
      <L> # * #</L>
      <L> # * #</L>
      <L> # * #</L>
      <L> # * #</L>
      <L> # * ##</L>
      <L>## *  #</L>
      <L>#  *  #</L>
      <L>#  . ##</L>
      <L>##$# #</L>
      <L> #   #</L>
      <L> #####</L>
    </Level>
    <Level Id="n=18" Width="7" Height="22">
      <L> #####</L>
      <L> # + #</L>
      <L> #$.$#</L>
      <L> # * #</L>
      <L> # * #</L>
      <L> # * #</L>
      <L> # * #</L>
      <L> # * #</L>
      <L> # * #</L>
      <L> # * #</L>
      <L> # * #</L>
      <L> # * #</L>
      <L> # * #</L>
      <L> # * #</L>
      <L> # * #</L>
      <L> # * ##</L>
      <L>## *  #</L>
      <L>#  *  #</L>
      <L>#  . ##</L>
      <L>##$# #</L>
      <L> #   #</L>
      <L> #####</L>
    </Level>
    <Level Id="n=19" Width="7" Height="23">
      <L> #####</L>
      <L> # + #</L>
      <L> #$.$#</L>
      <L> # * #</L>
      <L> # * #</L>
      <L> # * #</L>
      <L> # * #</L>
      <L> # * #</L>
      <L> # * #</L>
      <L> # * #</L>
      <L> # * #</L>
      <L> # * #</L>
      <L> # * #</L>
      <L> # * #</L>
      <L> # * #</L>
      <L> # * #</L>
      <L> # * ##</L>
      <L>## *  #</L>
      <L>#  *  #</L>
      <L>#  . ##</L>
      <L>##$# #</L>
      <L> #   #</L>
      <L> #####</L>
    </Level>
    <Level Id="n=20" Width="7" Height="24">
      <L> #####</L>
      <L> # + #</L>
      <L> #$.$#</L>
      <L> # * #</L>
      <L> # * #</L>
      <L> # * #</L>
      <L> # * #</L>
      <L> # * #</L>
      <L> # * #</L>
      <L> # * #</L>
      <L> # * #</L>
      <L> # * #</L>
      <L> # * #</L>
      <L> # * #</L>
      <L> # * #</L>
      <L> # * #</L>
      <L> # * #</L>
      <L> # * ##</L>
      <L>## *  #</L>
      <L>#  *  #</L>
      <L>#  . ##</L>
      <L>##$# #</L>
      <L> #   #</L>
      <L> #####</L>
    </Level>
    <Level Id="n=21" Width="7" Height="25">
      <L> #####</L>
      <L> # + #</L>
      <L> #$.$#</L>
      <L> # * #</L>
      <L> # * #</L>
      <L> # * #</L>
      <L> # * #</L>
      <L> # * #</L>
      <L> # * #</L>
      <L> # * #</L>
      <L> # * #</L>
      <L> # * #</L>
      <L> # * #</L>
      <L> # * #</L>
      <L> # * #</L>
      <L> # * #</L>
      <L> # * #</L>
      <L> # * #</L>
      <L> # * ##</L>
      <L>## *  #</L>
      <L>#  *  #</L>
      <L>#  . ##</L>
      <L>##$# #</L>
      <L> #   #</L>
      <L> #####</L>
    </Level>
    <Level Id="n=22" Width="7" Height="26">
      <L> #####</L>
      <L> # + #</L>
      <L> #$.$#</L>
      <L> # * #</L>
      <L> # * #</L>
      <L> # * #</L>
      <L> # * #</L>
      <L> # * #</L>
      <L> # * #</L>
      <L> # * #</L>
      <L> # * #</L>
      <L> # * #</L>
      <L> # * #</L>
      <L> # * #</L>
      <L> # * #</L>
      <L> # * #</L>
      <L> # * #</L>
      <L> # * #</L>
      <L> # * #</L>
      <L> # * ##</L>
      <L>## *  #</L>
      <L>#  *  #</L>
      <L>#  . ##</L>
      <L>##$# #</L>
      <L> #   #</L>
      <L> #####</L>
    </Level>
    <Level Id="n=23" Width="7" Height="27">
      <L> #####</L>
      <L> # + #</L>
      <L> #$.$#</L>
      <L> # * #</L>
      <L> # * #</L>
      <L> # * #</L>
      <L> # * #</L>
      <L> # * #</L>
      <L> # * #</L>
      <L> # * #</L>
      <L> # * #</L>
      <L> # * #</L>
      <L> # * #</L>
      <L> # * #</L>
      <L> # * #</L>
      <L> # * #</L>
      <L> # * #</L>
      <L> # * #</L>
      <L> # * #</L>
      <L> # * #</L>
      <L> # * ##</L>
      <L>## *  #</L>
      <L>#  *  #</L>
      <L>#  . ##</L>
      <L>##$# #</L>
      <L> #   #</L>
      <L> #####</L>
    </Level>
    <Level Id="n=24" Width="7" Height="28">
      <L> #####</L>
      <L> # + #</L>
      <L> #$.$#</L>
      <L> # * #</L>
      <L> # * #</L>
      <L> # * #</L>
      <L> # * #</L>
      <L> # * #</L>
      <L> # * #</L>
      <L> # * #</L>
      <L> # * #</L>
      <L> # * #</L>
      <L> # * #</L>
      <L> # * #</L>
      <L> # * #</L>
      <L> # * #</L>
      <L> # * #</L>
      <L> # * #</L>
      <L> # * #</L>
      <L> # * #</L>
      <L> # * #</L>
      <L> # * ##</L>
      <L>## *  #</L>
      <L>#  *  #</L>
      <L>#  . ##</L>
      <L>##$# #</L>
      <L> #   #</L>
      <L> #####</L>
    </Level>
    <Level Id="n=25" Width="7" Height="29">
      <L> #####</L>
      <L> # + #</L>
      <L> #$.$#</L>
      <L> # * #</L>
      <L> # * #</L>
      <L> # * #</L>
      <L> # * #</L>
      <L> # * #</L>
      <L> # * #</L>
      <L> # * #</L>
      <L> # * #</L>
      <L> # * #</L>
      <L> # * #</L>
      <L> # * #</L>
      <L> # * #</L>
      <L> # * #</L>
      <L> # * #</L>
      <L> # * #</L>
      <L> # * #</L>
      <L> # * #</L>
      <L> # * #</L>
      <L> # * #</L>
      <L> # * ##</L>
      <L>## *  #</L>
      <L>#  *  #</L>
      <L>#  . ##</L>
      <L>##$# #</L>
      <L> #   #</L>
      <L> #####</L>
    </Level>
    <Level Id="n=26" Width="7" Height="30">
      <L> #####</L>
      <L> # + #</L>
      <L> #$.$#</L>
      <L> # * #</L>
      <L> # * #</L>
      <L> # * #</L>
      <L> # * #</L>
      <L> # * #</L>
      <L> # * #</L>
      <L> # * #</L>
      <L> # * #</L>
      <L> # * #</L>
      <L> # * #</L>
      <L> # * #</L>
      <L> # * #</L>
      <L> # * #</L>
      <L> # * #</L>
      <L> # * #</L>
      <L> # * #</L>
      <L> # * #</L>
      <L> # * #</L>
      <L> # * #</L>
      <L> # * #</L>
      <L> # * ##</L>
      <L>## *  #</L>
      <L>#  *  #</L>
      <L>#  . ##</L>
      <L>##$# #</L>
      <L> #   #</L>
      <L> #####</L>
    </Level>
    <Level Id="n=27" Width="7" Height="31">
      <L> #####</L>
      <L> # + #</L>
      <L> #$.$#</L>
      <L> # * #</L>
      <L> # * #</L>
      <L> # * #</L>
      <L> # * #</L>
      <L> # * #</L>
      <L> # * #</L>
      <L> # * #</L>
      <L> # * #</L>
      <L> # * #</L>
      <L> # * #</L>
      <L> # * #</L>
      <L> # * #</L>
      <L> # * #</L>
      <L> # * #</L>
      <L> # * #</L>
      <L> # * #</L>
      <L> # * #</L>
      <L> # * #</L>
      <L> # * #</L>
      <L> # * #</L>
      <L> # * #</L>
      <L> # * ##</L>
      <L>## *  #</L>
      <L>#  *  #</L>
      <L>#  . ##</L>
      <L>##$# #</L>
      <L> #   #</L>
      <L> #####</L>
    </Level>
    <Level Id="n=28" Width="7" Height="32">
      <L> #####</L>
      <L> # + #</L>
      <L> #$.$#</L>
      <L> # * #</L>
      <L> # * #</L>
      <L> # * #</L>
      <L> # * #</L>
      <L> # * #</L>
      <L> # * #</L>
      <L> # * #</L>
      <L> # * #</L>
      <L> # * #</L>
      <L> # * #</L>
      <L> # * #</L>
      <L> # * #</L>
      <L> # * #</L>
      <L> # * #</L>
      <L> # * #</L>
      <L> # * #</L>
      <L> # * #</L>
      <L> # * #</L>
      <L> # * #</L>
      <L> # * #</L>
      <L> # * #</L>
      <L> # * #</L>
      <L> # * ##</L>
      <L>## *  #</L>
      <L>#  *  #</L>
      <L>#  . ##</L>
      <L>##$# #</L>
      <L> #   #</L>
      <L> #####</L>
    </Level>
    <Level Id="n=29" Width="7" Height="33">
      <L> #####</L>
      <L> # + #</L>
      <L> #$.$#</L>
      <L> # * #</L>
      <L> # * #</L>
      <L> # * #</L>
      <L> # * #</L>
      <L> # * #</L>
      <L> # * #</L>
      <L> # * #</L>
      <L> # * #</L>
      <L> # * #</L>
      <L> # * #</L>
      <L> # * #</L>
      <L> # * #</L>
      <L> # * #</L>
      <L> # * #</L>
      <L> # * #</L>
      <L> # * #</L>
      <L> # * #</L>
      <L> # * #</L>
      <L> # * #</L>
      <L> # * #</L>
      <L> # * #</L>
      <L> # * #</L>
      <L> # * #</L>
      <L> # * ##</L>
      <L>## *  #</L>
      <L>#  *  #</L>
      <L>#  . ##</L>
      <L>##$# #</L>
      <L> #   #</L>
      <L> #####</L>
    </Level>
    <Level Id="n=30" Width="7" Height="34">
      <L> #####</L>
      <L> # + #</L>
      <L> #$.$#</L>
      <L> # * #</L>
      <L> # * #</L>
      <L> # * #</L>
      <L> # * #</L>
      <L> # * #</L>
      <L> # * #</L>
      <L> # * #</L>
      <L> # * #</L>
      <L> # * #</L>
      <L> # * #</L>
      <L> # * #</L>
      <L> # * #</L>
      <L> # * #</L>
      <L> # * #</L>
      <L> # * #</L>
      <L> # * #</L>
      <L> # * #</L>
      <L> # * #</L>
      <L> # * #</L>
      <L> # * #</L>
      <L> # * #</L>
      <L> # * #</L>
      <L> # * #</L>
      <L> # * #</L>
      <L> # * ##</L>
      <L>## *  #</L>
      <L>#  *  #</L>
      <L>#  . ##</L>
      <L>##$# #</L>
      <L> #   #</L>
      <L> #####</L>
    </Level>
  </LevelCollection>
</SokobanLevels>
