<?xml version="1.0" encoding="utf-8"?>
<SokobanLevels xmlns:xsi="http://www.w3.org/2001/XMLSchema-instance" xsi:schemaLocation="SokobanLev.xsd">
  <Title>Green Machine!</Title>
  <Description>

  </Description>
  <LevelCollection Copyright="Mike McKee, Joe Hitchens" MaxWidth="20" MaxHeight="16">
    <Level Id="Cascade" Width="14" Height="14">
      <L>      #####</L>
      <L>      #   ####</L>
      <L>      # .$   #</L>
      <L>   ##### ##  #</L>
      <L>   #   #$ # ##</L>
      <L>   # .$ . # #</L>
      <L> #### ##  # #</L>
      <L> #  #$ #### #</L>
      <L> #   . #    #</L>
      <L>## ##  #    #</L>
      <L>#  #####    #</L>
      <L>#         # #</L>
      <L>#########  @#</L>
      <L>        #####</L>
    </Level>
    <Level Id="Free-Speech" Width="18" Height="16">
      <L>##################</L>
      <L>#         ##.    #</L>
      <L># ####### $ $..  #</L>
      <L># #     # $  .$. #</L>
      <L># ############$  #</L>
      <L># ##     ### #  ##</L>
      <L># ## $...$ #### #</L>
      <L># ## $   $      #</L>
      <L># ## $...$ ######</L>
      <L># ####    ##</L>
      <L># #*#######</L>
      <L># .#.$    #</L>
      <L>#  ...  $ #</L>
      <L>## $  $$@##</L>
      <L> #   ##  #</L>
      <L> #########</L>
    </Level>
    <Level Id="Wan" Width="19" Height="16">
      <L>         ####</L>
      <L>         #  ######</L>
      <L>########## $##   #</L>
      <L>#              $ ##</L>
      <L># #### ####$$# #  #</L>
      <L># $   ...  ....$$ #</L>
      <L>#### #  .......$  #</L>
      <L>   # ## # # ###  ##</L>
      <L>   # ##$# # # #$##</L>
      <L>  ##    # #$### #</L>
      <L>  # $#### #  ## #</L>
      <L>  #       #   $ #</L>
      <L>  #####   #  ## #</L>
      <L>      ###$##### #</L>
      <L>        #@      #</L>
      <L>        #########</L>
    </Level>
    <Level Id="Yen" Width="19" Height="16">
      <L>#######     #######</L>
      <L>#     #  ####     #</L>
      <L># $ $ ## #.   $ # #</L>
      <L>#    $ # #. $$# # #</L>
      <L># $ $  # #$##@# # #</L>
      <L>#  $ $ ### ##$# # #</L>
      <L># $# ###.# ## # # #</L>
      <L>#    ###......  # #</L>
      <L># $ $ $ ......# # #</L>
      <L># ## $  ......# # #</L>
      <L>#    ###..$ $ $ $ #</L>
      <L># $ $ $ ...# ##   #</L>
      <L># ### ##. ## ## # #</L>
      <L># ### ##$$      $ #</L>
      <L>#           #######</L>
      <L>#############</L>
    </Level>
    <Level Id="Quid" Width="20" Height="16">
      <L>   #####</L>
      <L>   #   #############</L>
      <L>####$            $ #</L>
      <L>#  $..........$ ## #</L>
      <L>#   $#  .##  #  ## #</L>
      <L># ##..... # $# ### #</L>
      <L># #####$. $   $    #</L>
      <L># #  #  .## $  ### #</L>
      <L># #  # $. $  ##### #</L>
      <L># #  ## . $ $  $ $ #</L>
      <L># ##  ##$    ### ###</L>
      <L>#  #   # $    $@$  #</L>
      <L>## #   ##   ###### #</L>
      <L> # ############### #</L>
      <L> #                 #</L>
      <L> ###################</L>
    </Level>
    <Level Id="Sands" Width="13" Height="16">
      <L>#############</L>
      <L>#           #</L>
      <L>#           #</L>
      <L># $ $ $ $ $ #</L>
      <L>## $ $ $ $ ##</L>
      <L> ## $ $ $ ##</L>
      <L>  ## $ $ ##</L>
      <L>   ## $ ##</L>
      <L>    ##@##</L>
      <L>   ## $ ##</L>
      <L>  ##     ##</L>
      <L> ##   .   ##</L>
      <L>##   ...   ##</L>
      <L>#   .....   #</L>
      <L>#  .......  #</L>
      <L>#############</L>
    </Level>
    <Level Id="Halfmoon" Width="17" Height="14">
      <L>        ########</L>
      <L>####### #      #</L>
      <L>#..$..# # #$$  #</L>
      <L>#..#..# # ...# #</L>
      <L># $$$ # ##...$ ##</L>
      <L>#  $  #  # ## $ #</L>
      <L># $$$ ####$  $  #</L>
      <L>#  #  #..#  #   #</L>
      <L># ##### .###### #</L>
      <L># ####  $.# ### #</L>
      <L>#   ## $  ###   #</L>
      <L>### #  #$$ ## ###</L>
      <L>  #     @     #</L>
      <L>  #############</L>
    </Level>
    <Level Id="Pots O' Gold" Width="14" Height="12">
      <L>       #######</L>
      <L>       #   ..#</L>
      <L>      ##$# ..#</L>
      <L>  #####   #..#</L>
      <L>  #   #   $ ##</L>
      <L>###   ##$    #</L>
      <L>#... #@$   $ #</L>
      <L>#### #$# ##$ #</L>
      <L> #   $   #   #</L>
      <L> #   #$#######</L>
      <L> ###   #</L>
      <L>   #####</L>
    </Level>
    <Level Id="Nineball" Width="15" Height="12">
      <L>     ####</L>
      <L>######  #</L>
      <L>#    $$ #</L>
      <L># #$  $ #</L>
      <L># #  #$ ######</L>
      <L>#   #   ##...#</L>
      <L>###$ # ###...#</L>
      <L>###   $   ...##</L>
      <L>#   $ $ ###   #</L>
      <L># # ##### # # #</L>
      <L>#   #     #  @#</L>
      <L>#####     #####</L>
    </Level>
    <Level Id="Money-Bags" Width="19" Height="15">
      <L>          #######</L>
      <L>       #### @#  #</L>
      <L>     ### $  $   #</L>
      <L>   ### $  $#    #</L>
      <L>  ##   $$..$.$  ##</L>
      <L>  #  $...#.#.##  #</L>
      <L>  #$  .#...... $ ##</L>
      <L>###  $ $  $##.$ $ #</L>
      <L>#  .#   $ $... $  #</L>
      <L># ###. $ # ..#   ##</L>
      <L># # #.$ .. $..$ ##</L>
      <L># # # # $   #$  #</L>
      <L># ###$$   $   ###</L>
      <L>#     ##    ###</L>
      <L>#############</L>
    </Level>
    <Level Id="Cyclone" Width="16" Height="15">
      <L>          #####</L>
      <L>###########   #</L>
      <L>#       $   # #</L>
      <L># ###$### # # #</L>
      <L>#      $  # # #</L>
      <L># # ##### # $ #</L>
      <L># # #...# # # #</L>
      <L># #$#...# #$# #</L>
      <L># # #...$ # #$#</L>
      <L># $ #.... $ # #</L>
      <L># # ####$## # ##</L>
      <L># #  $         #</L>
      <L># # #####$#### #</L>
      <L>#@             #</L>
      <L>################</L>
    </Level>
    <Level Id="3-Way Bell" Width="19" Height="16">
      <L>        #########</L>
      <L>      ###       #</L>
      <L>     ##    $ $ $#</L>
      <L>    ##  ## #$## #</L>
      <L>  ###  ### .. ..##</L>
      <L>  #   ## ##.. .. #</L>
      <L>### ####### ##$# ##</L>
      <L>#    #    #$ $ $  #</L>
      <L># $ $$$$$ #      @#</L>
      <L>#         #########</L>
      <L>##### #############</L>
      <L>   #.             #</L>
      <L>   #.  ###   #$#$ #</L>
      <L>   #...# # $$  .$.#</L>
      <L>   #.  # #  ###...#</L>
      <L>   ##### #### #####</L>
    </Level>
    <Level Id="Cricket" Width="19" Height="16">
      <L>   ######</L>
      <L>####    #######</L>
      <L>#    $$ ##    #</L>
      <L># $ $  ##  ## ##</L>
      <L>#  ## $#@ #... ##</L>
      <L>#####  $  ..#.  ###</L>
      <L>   #   #  .#..    #</L>
      <L>   #   ## ...# #  #</L>
      <L>   ####### ##  # ##</L>
      <L>####  ####    ## #</L>
      <L>#    $$  ####### #</L>
      <L># #   $     $    #</L>
      <L># $$     ######  #</L>
      <L># # ######    ####</L>
      <L>#   #</L>
      <L>#####</L>
    </Level>
    <Level Id="Coinage" Width="18" Height="16">
      <L>################</L>
      <L># $.......     #</L>
      <L>#  . . .#.$ ##$##</L>
      <L># $.#. .#.###   ##</L>
      <L># $.......# #$   #</L>
      <L>###   ##  ##     #</L>
      <L>### # ##### $ $$##</L>
      <L>#   # ##         #</L>
      <L>#   # ## $ $   $ #</L>
      <L>## ## ###  ### $ #</L>
      <L> # ## #######   ##</L>
      <L> #        $@$ $ #</L>
      <L> #  #  #######  ##</L>
      <L> ####$ $ $ $ $$  #</L>
      <L>    #            #</L>
      <L>    ##############</L>
    </Level>
    <Level Id="Profits" Width="19" Height="16">
      <L>  #####</L>
      <L>  #   #</L>
      <L>###$.$#####</L>
      <L>#   . $   #######</L>
      <L># ##$##         #</L>
      <L>#   . ######### #</L>
      <L>### . #       # #</L>
      <L>  #   #   ##### #</L>
      <L>  #####   #  ## ##</L>
      <L>         ##$ ##  #</L>
      <L>         #  $@$  #</L>
      <L>         #   ##$ #</L>
      <L>         ###.## ###</L>
      <L>          #...$ $ #</L>
      <L>          ##..    #</L>
      <L>           ########</L>
    </Level>
    <Level Id="Pumpkin" Width="20" Height="16">
      <L>            #####</L>
      <L>   ####     #   #</L>
      <L> ###  ####  # #$##</L>
      <L> #       ####    #</L>
      <L> #$#$$#$ #  # ## #</L>
      <L>## #  #  # $$    #</L>
      <L>#  ##  # #  #$#####</L>
      <L>#        ##   #   #</L>
      <L>##$### #### ### $ #</L>
      <L> # ### ##....## ###</L>
      <L> #       ....##   #</L>
      <L> ### ####....     #</L>
      <L>   # ######### #####</L>
      <L>   #       @   $ $ #</L>
      <L>   ###########     #</L>
      <L>             #######</L>
    </Level>
    <Level Id="Gateway" Width="17" Height="13">
      <L>             ####</L>
      <L>        ######  #</L>
      <L>   ######       #</L>
      <L>   #   ##  ###  #</L>
      <L>####$# ### $ #$##</L>
      <L>#   $@$  #   # .#</L>
      <L>#   $#$#   $ # .#</L>
      <L>##   # # #   # .#</L>
      <L> #  #  # #$$ # .#</L>
      <L> ##$#  # # ### .#</L>
      <L>  # #... # #  $.#</L>
      <L>  #  ...##   #  #</L>
      <L>  ###############</L>
    </Level>
    <Level Id="Chester's-Bend-in-the-Road" Width="19" Height="16">
      <L>######    #########</L>
      <L>#    ##   #   #.  #</L>
      <L>#     #   #..  $  #</L>
      <L>#$$$$$#   # #$##$ #</L>
      <L>#     #   # $ #   #</L>
      <L>#     # ####  #$. #</L>
      <L>#$$$$$# #@### .  ##</L>
      <L>#.....### ##### ##</L>
      <L>#.....          #</L>
      <L>######### #######</L>
      <L>  #####    ######</L>
      <L>  #   #$$$$$ #  #</L>
      <L>  #  $........$ #</L>
      <L>  ####   $#  #  #</L>
      <L>     ##   #    ##</L>
      <L>      ##########</L>
    </Level>
    <Level Id="UFO" Width="20" Height="16">
      <L>#########  #########</L>
      <L>#       #  # . $   #</L>
      <L># $.$.$ #  # $.$ $ #</L>
      <L># .$.$. ####.......#</L>
      <L># $.#.$   ##$$$$.$$#</L>
      <L># .$.$. # ##   $ . #</L>
      <L># $.$.$ # #### #####</L>
      <L>#       #     @ ####</L>
      <L>######### $$ ##    #</L>
      <L>     ###...$ # .$$ #</L>
      <L>     # $...###.$$.##</L>
      <L>     # $$ ## #.   .#</L>
      <L>     #    #  ##.$$.#</L>
      <L>     ######  # $$. #</L>
      <L>             #    ##</L>
      <L>             ######</L>
    </Level>
    <Level Id="Split-Sunshine" Width="13" Height="11">
      <L> ####  ######</L>
      <L> #  ####    #</L>
      <L>##.$  .$..$ #</L>
      <L># $ . $ $.# #</L>
      <L># . $ ###   #</L>
      <L>######   #@##</L>
      <L># . . . $.. #</L>
      <L># $ #$$ # $ #</L>
      <L>##. $ . #$# #</L>
      <L> #  #####   #</L>
      <L> ####   #####</L>
    </Level>
    <Level Id="Rabbit" Width="20" Height="16">
      <L>     ####</L>
      <L>     #  ###</L>
      <L>     #    #</L>
      <L>     # #  ####</L>
      <L>     # $ ##  #</L>
      <L>     # #   $ #</L>
      <L>    ## #  ## #####</L>
      <L>    #  ## #  #   #</L>
      <L>    #     #@ # # #</L>
      <L>    ####  #  #   ###</L>
      <L> ########### ### $ #</L>
      <L> #   ##    ..### # #</L>
      <L>##$# # $  #..      #</L>
      <L>#     $  ##..#######</L>
      <L>#   ##  ######</L>
      <L>#########</L>
    </Level>
    <Level Id="Walnut" Width="15" Height="13">
      <L> ########</L>
      <L>##      #######</L>
      <L>#  $   $ #.  .#</L>
      <L># $ $   $ .  .#</L>
      <L>## $ $ $ #....#</L>
      <L> ####### ## ###</L>
      <L>  #           #</L>
      <L> ## ######### #</L>
      <L>##     $@#    #</L>
      <L>#  $$$$###$## #</L>
      <L>#        ...# #</L>
      <L>#########...  #</L>
      <L>        #######</L>
    </Level>
    <Level Id="Very-Painterly" Width="20" Height="16">
      <L>##### ##############</L>
      <L>#   ###..... ...#@ #</L>
      <L># $ # $... .....#$ #</L>
      <L>#   # $.....#...#  #</L>
      <L># $## $# ########$ #</L>
      <L>#  ##  # # $     $ #</L>
      <L>#        # $ #### ##</L>
      <L>#  ####  #         #</L>
      <L>##     ########$$$ #</L>
      <L>#   #  #      # #  #</L>
      <L>#  ## ## $$ $ # #$ #</L>
      <L># $ $ ####  $ # #  #</L>
      <L>#  #  ####$ ##   $ #</L>
      <L># $##        $   ###</L>
      <L>#   #  ###########</L>
      <L>########</L>
    </Level>
    <Level Id="Terra-Grapes" Width="20" Height="16">
      <L>    #####       ####</L>
      <L>#####   #########  #</L>
      <L>#     $    #  $ $$ #</L>
      <L># $  # #   # #.... #</L>
      <L>##$## $ # ## .$$$. #</L>
      <L>#  $ $ $   # #.... #</L>
      <L>#   # $ #  #  $ $$ #</L>
      <L>#####   # ####   ###</L>
      <L>###### ##$##### ##</L>
      <L>#....#  #@$     #</L>
      <L>#...    #$####  #</L>
      <L>#..   ### ##########</L>
      <L>########  $ ...    #</L>
      <L>       #    ###$$$ #</L>
      <L>       ## $ ...    #</L>
      <L>        ############</L>
    </Level>
    <Level Id="Cherries" Width="20" Height="16">
      <L>  ######### #######</L>
      <L>###   #   ### $.  #</L>
      <L>#  $. . $ #  $.$.$#</L>
      <L># #.#.#.# #  .$.$.#</L>
      <L># $$$ $$$ ## $.$. #</L>
      <L># #.#.#.# ##  $.  #</L>
      <L># $ . .$  ### #####</L>
      <L>#   # #####   #####</L>
      <L>#####    @  #  .$ ##</L>
      <L>   ### ##### .$. . #</L>
      <L>####    . ##$ $. $$#</L>
      <L>#  $ $ $. ##.$ .$$.#</L>
      <L>#  .####.### $ .$  #</L>
      <L># $.$ $  # # . .$. #</L>
      <L>#  .  #### ## $.  ##</L>
      <L>#######     #######</L>
    </Level>
    <Level Id="Wrench" Width="20" Height="16">
      <L>########</L>
      <L>#......# #####</L>
      <L>#  $ # ###   # #####</L>
      <L># $ # $    # ###...#</L>
      <L>##$ $ $ ###   $@ $##</L>
      <L> #      # #  $ # $ #</L>
      <L> ### #### #. $ #$  #</L>
      <L> #   #    # #### #.#</L>
      <L>## ###    #.     $.#</L>
      <L>#    ###############</L>
      <L># $$$##   #########</L>
      <L>#  #..# #   $ ..  #</L>
      <L>##  ..$ ### $$.. $##</L>
      <L> #      # # $ .. $ #</L>
      <L> ######## ######   #</L>
      <L>               #####</L>
    </Level>
    <Level Id="Handsaw" Width="20" Height="16">
      <L> #######    #####</L>
      <L> #.... #  ###   ###</L>
      <L>###...$####   $ $ #</L>
      <L>#  $#$ $ #  ##$## ##</L>
      <L># $$  #$ # $.#.$   #</L>
      <L>#    #     #.#.#   #</L>
      <L>####   ### $...  ###</L>
      <L>   # ### ###$# #####</L>
      <L>  ## ###   #   #   #</L>
      <L> ##    #   # $     #</L>
      <L> # $ $$ #####.### ##</L>
      <L> #......#   ...   #</L>
      <L> # $$ $   # #.###$##</L>
      <L> ###  ### $  $$    #</L>
      <L>   #### #####@ #   #</L>
      <L>            ########</L>
    </Level>
    <Level Id="Double-Hammer" Width="18" Height="13">
      <L>##################</L>
      <L>#  ..  #  #@ #   #</L>
      <L># $  $ #   $$$   #</L>
      <L># #..# #  ##.##$ #</L>
      <L># $$$$ ##$##.##  #</L>
      <L># #..# #  .....$ #</L>
      <L># $..$ # $##.#####</L>
      <L># #..# #   #.#   #</L>
      <L># $$$$ ##  $ $   #</L>
      <L>###.. ###  #   # #</L>
      <L>  ### ########## #</L>
      <L>    #            #</L>
      <L>    ##############</L>
    </Level>
    <Level Id="Wow! Cornered" Width="19" Height="15">
      <L>######### #########</L>
      <L>#  $  . # #    .$ #</L>
      <L># $$$.$$# #$$$. $ #</L>
      <L>#.......# #.......#</L>
      <L># $.$$$ # # $$.$$$#</L>
      <L># .  $  # #  $ .  #</L>
      <L>###### ##### ######</L>
      <L>     #   @   #</L>
      <L>###### ##### ######</L>
      <L>#   .$  # #   .$  #</L>
      <L>#$$. $$ # #$$$.$$ #</L>
      <L>#.......# #.......#</L>
      <L># $$$.$$# # $$.$$ #</L>
      <L># $ .   # #  $.   #</L>
      <L>######### #########</L>
    </Level>
    <Level Id="What?" Width="20" Height="16">
      <L>#######</L>
      <L># @#  #####</L>
      <L># $$  $   #</L>
      <L>#  #.##$# ######</L>
      <L>##$#...   #    #</L>
      <L>## ...##$## ## #</L>
      <L>#  ##.##  # ## #</L>
      <L>#  $  $     ## ##</L>
      <L>#  #   #  ###   #</L>
      <L>########### # $ #</L>
      <L>            #$.$#</L>
      <L>           ##.$.##</L>
      <L>         ###.$.$.###</L>
      <L>         #  $.$.$  #</L>
      <L>         #    .    #</L>
      <L>         ###########</L>
    </Level>
  </LevelCollection>
</SokobanLevels>
