<?xml version="1.0" encoding="utf-8"?>
<SokobanLevels xmlns:xsi="http://www.w3.org/2001/XMLSchema-instance" xsi:schemaLocation="SokobanLev.xsd">
  <Title>The Adventurer</Title>
  <Description>
My First Level Set, Second Edition
  </Description>
  <Email>ivo76_bg@yahoo.com</Email>
  <Url>http://free.hit.bg/easy/</Url>
  <LevelCollection Copyright="Ivelin Georgiev Ivanov" MaxWidth="25" MaxHeight="19">
    <Level Id="Lost Trinity" Width="21" Height="17">
      <L>#####################</L>
      <L>#         #         #</L>
      <L># @# ###  #  #### $ #</L>
      <L>## #     # #     # ##</L>
      <L>#   # #   #   #     #</L>
      <L># # # # # # # # # # #</L>
      <L># ##  #   # # #  ## #</L>
      <L>#     # # . # #     #</L>
      <L>## ##   #. .#   ## ##</L>
      <L>##    #  # #  #    ##</L>
      <L>#  # #   #     # #  #</L>
      <L># ## # #    ## # ## #</L>
      <L>#      #   # #      #</L>
      <L>## #  ## ##      # ##</L>
      <L># $ # #      ## # $ #</L>
      <L>#       #  #        #</L>
      <L>#####################</L>
    </Level>
    <Level Id="The Way Back" Width="17" Height="13">
      <L>#################</L>
      <L>#   # #   # #   #</L>
      <L>#        #      #</L>
      <L>## # ##     #  ##</L>
      <L>#   #  # ##  # ##</L>
      <L>#  # $@  # .    #</L>
      <L>## # $$ # ..## ##</L>
      <L>#  #  $$#..  #  #</L>
      <L>#    # $ . #   ##</L>
      <L>## ##  ## #  # ##</L>
      <L>#               #</L>
      <L>##  # #  #  #  ##</L>
      <L>#################</L>
    </Level>
    <Level Id="The Little Ancient Hall" Width="13" Height="13">
      <L>#############</L>
      <L>#           #</L>
      <L># #       # #</L>
      <L># # $# #$ # #</L>
      <L>#    # #    #</L>
      <L>#  ##..@##  #</L>
      <L>#  $ ... $  #</L>
      <L>#  ##*..##  #</L>
      <L>#    # #    #</L>
      <L># # $#$#$ # #</L>
      <L># #       # #</L>
      <L>#           #</L>
      <L>#############</L>
    </Level>
    <Level Id="Between Levels" Width="21" Height="17">
      <L>#########  ##########</L>
      <L>#@   #  #  #  #     #</L>
      <L>#    $  #  #  $     #</L>
      <L>##  ##  #  #  ## #. #</L>
      <L> #  ## ##  ## #  # .#</L>
      <L> #  ## #    # #  #. #</L>
      <L> #  ## ##  ## #  # .#</L>
      <L> #  ##  #  #  #  #. #</L>
      <L> #  ##  #  #  #  # .#</L>
      <L> #$$##$$#  #$$##$#.##</L>
      <L> #  ##  #  #  #  # .#</L>
      <L> #  ##  ####  #  #. #</L>
      <L> ##  $   ##   $ ## .#</L>
      <L>##  ##        #  #. #</L>
      <L>#    ##      ##     #</L>
      <L>#    ####  ####     #</L>
      <L>######  ####  #######</L>
    </Level>
    <Level Id="The Dungeon" Width="21" Height="17">
      <L>#####################</L>
      <L>##      ##  #     # #</L>
      <L>#  # ##   #   ###  ##</L>
      <L>##  #  # # ##    #  #</L>
      <L># # #$ # #   ### ## #</L>
      <L>#   #  #   #      ..#</L>
      <L>## #  # ### # #  # ##</L>
      <L>#  #   #    #  #  ..#</L>
      <L># #@$$$   $$ $## # ##</L>
      <L># #    #    #     ..#</L>
      <L>#  #  #  ###   # # ##</L>
      <L># #  ## #  # # #  ..#</L>
      <L># # $#    #   #  # ##</L>
      <L># #   ###  ##   # # #</L>
      <L>#  ###   #   ## ##  #</L>
      <L>##     #   #       ##</L>
      <L>#####################</L>
    </Level>
    <Level Id="The Old Mill" Width="21" Height="19">
      <L>             ###</L>
      <L>             #.#</L>
      <L>             #.#</L>
      <L>             #.#</L>
      <L>             #.#</L>
      <L>##############.#</L>
      <L>#.....    #    #</L>
      <L>######$ $$ $$#$#</L>
      <L>     #    $    #</L>
      <L>     ##$$$@$$$##</L>
      <L>     #    $    #</L>
      <L>     #$#$$ $$ $######</L>
      <L>     #    #    .....#</L>
      <L>     #.##############</L>
      <L>     #.#</L>
      <L>     #.#</L>
      <L>     #.#</L>
      <L>     #.#</L>
      <L>     ###</L>
    </Level>
    <Level Id="Twisted Corridors" Width="17" Height="13">
      <L>         ########</L>
      <L>         #      #</L>
      <L>  ####   # #### #</L>
      <L>###  #####$#  # #</L>
      <L>#   $.  .  .  # #</L>
      <L># #   ##### $ # #</L>
      <L># ## ##   ## ## #</L>
      <L># # $ #####   # #</L>
      <L># #  .  .  .$   #</L>
      <L># #  #$#####  ###</L>
      <L># #### #   ####</L>
      <L>#@     #</L>
      <L>########</L>
    </Level>
    <Level Id="The Crypt" Width="15" Height="15">
      <L>###############</L>
      <L>#    #   #   @#</L>
      <L># #    #   ## #</L>
      <L>#   # ####$$  #</L>
      <L># # #      $$ #</L>
      <L>###   # ##$$  #</L>
      <L>#    ##    $$##</L>
      <L># ## #   #$$  #</L>
      <L>#      #   $$ #</L>
      <L>## # # #  ##  #</L>
      <L> #... .# #    #</L>
      <L> #... .#     ##</L>
      <L> #  #..#  #   #</L>
      <L> ####..#####  #</L>
      <L>    ####   ####</L>
    </Level>
    <Level Id="The Mausoleum" Width="11" Height="9">
      <L>###########</L>
      <L>#.#  . $ .#</L>
      <L>#.#$#.#$# #</L>
      <L>#  $ .    #</L>
      <L>#$#$#@#$#$#</L>
      <L>#    . $  #</L>
      <L># #$#.#$#.#</L>
      <L>#. $ .  #.#</L>
      <L>###########</L>
    </Level>
    <Level Id="Underground Cave" Width="17" Height="15">
      <L>#################</L>
      <L>#    # # #  #..@#</L>
      <L># $$   $   $ ...#</L>
      <L>#  ## ##  # ##..#</L>
      <L>## #  ## ## # $##</L>
      <L>#   #   $   #   #</L>
      <L># $## ## # ##   #</L>
      <L>## ##  ###  ## ##</L>
      <L>#   ## # ## ##$ #</L>
      <L>#   #   $   #   #</L>
      <L>##$ # #  ##  # ##</L>
      <L>#..## ## ## ##  #</L>
      <L>#... $   $   $$ #</L>
      <L># ..#  # # #    #</L>
      <L>#################</L>
    </Level>
    <Level Id="The Broken Bridge" Width="13" Height="13">
      <L>#############</L>
      <L>#     #     #</L>
      <L>#@$$$ $  $$ #</L>
      <L>#  $  #$ $  #</L>
      <L>###$#   # ###</L>
      <L>#    # #   ##</L>
      <L>#. $# # #$ .#</L>
      <L>#..... .....#</L>
      <L>##   ###   ##</L>
      <L>#  ##   ##  #</L>
      <L>#      #    #</L>
      <L>##  # #    ##</L>
      <L> ###########</L>
    </Level>
    <Level Id="The Long Way To Surface" Width="19" Height="17">
      <L> ################</L>
      <L>##    #  #  #   ##</L>
      <L># .#$# #   #   #@##</L>
      <L>##..     #    #   #</L>
      <L># . ### # #$## $# #</L>
      <L>#  #  $ $  $  $  ##</L>
      <L>## # #  # #  #$ # #</L>
      <L># $  # #    #    ##</L>
      <L># #   #  $ #  # # #</L>
      <L># # # #  # #   $  #</L>
      <L>#   #  #  $#   # ##</L>
      <L>##    # ##    ##  #</L>
      <L># .#  ##   ###  . #</L>
      <L># ..     ##    ..##</L>
      <L>##. # #      #  .#</L>
      <L> ### #  # #   # ##</L>
      <L>   ##############</L>
    </Level>
    <Level Id="The Main Gates" Width="17" Height="17">
      <L>     #######</L>
      <L>   ###  #  ###</L>
      <L>  ## ...#... ##</L>
      <L>  #...#.#.#...#</L>
      <L>####  # # #  ####</L>
      <L>#     $   $     #</L>
      <L># $#   ###   #$ #</L>
      <L>#  ###$ # $###  #</L>
      <L>##  $   #   $  ##</L>
      <L>#  ## ##### ##  #</L>
      <L># #   $   $   # #</L>
      <L>#  #   #@#   #  #</L>
      <L>#    $  #  $    #</L>
      <L># ## #     # ## #</L>
      <L>##  $ ## ## $  ##</L>
      <L> ##           ##</L>
      <L>  #############</L>
    </Level>
    <Level Id="Critical Point" Width="17" Height="17">
      <L>       ###</L>
      <L> #######@#######</L>
      <L> #...... ......#</L>
      <L>#######   #######</L>
      <L>#  #   $  $ # # #</L>
      <L># $  #  # $     #</L>
      <L>#   ## ### ## # #</L>
      <L>##$ #  $    # # #</L>
      <L>#   ## #$ # $ ###</L>
      <L>#   #  #  ###   #</L>
      <L>## ### # $#   ###</L>
      <L>#   $  #  ### # #</L>
      <L>#  # # #### $   #</L>
      <L>## ###         ##</L>
      <L> #$    #########</L>
      <L> #  ####</L>
      <L> ####</L>
    </Level>
    <Level Id="The Surface" Width="9" Height="9">
      <L> #######</L>
      <L>##  @  ##</L>
      <L># $#$#  #</L>
      <L># $...# #</L>
      <L># $.$.$ #</L>
      <L># #...$ #</L>
      <L>#  # #$ #</L>
      <L>##     ##</L>
      <L> #######</L>
    </Level>
    <Level Id="The Inner Yard" Width="12" Height="11">
      <L>   #########</L>
      <L>   #.......#</L>
      <L>   #.......#</L>
      <L>  ###     ##</L>
      <L>  #  #   ##</L>
      <L>### $##$####</L>
      <L>#@   $ $ $ #</L>
      <L># $#   $   #</L>
      <L>#  $$$$$$$ #</L>
      <L>#          #</L>
      <L>############</L>
    </Level>
    <Level Id="Escape" Width="25" Height="9">
      <L>        #########     #</L>
      <L>       ##.#.#.#.##     #</L>
      <L>       #.$ $ $ $ # ######</L>
      <L>       ## # # # ##     #</L>
      <L>   #   #.$ $ $ $.#    #</L>
      <L>    #  ## # # # ##</L>
      <L>###### #@$ $ $ $.#</L>
      <L>    #  ##.#.#.#.##</L>
      <L>   #    #########</L>
    </Level>
  </LevelCollection>
</SokobanLevels>
