<?xml version="1.0" encoding="utf-8"?>
<SokobanLevels xmlns:xsi="http://www.w3.org/2001/XMLSchema-instance" xsi:schemaLocation="SokobanLev.xsd">
  <Title>jw2005</Title>
  <Description>

  </Description>
  <LevelCollection Copyright="Joris Wit" MaxWidth="14" MaxHeight="12">
    <Level Id="jw2005.1" Width="14" Height="12">
      <L>      #####</L>
      <L>      #   #</L>
      <L> ###### # ####</L>
      <L> #@ $ $  $$  #</L>
      <L> #$ # $$# $  #</L>
      <L> # $  $      #</L>
      <L>##  $# #####*#</L>
      <L>#  $ ###.....#</L>
      <L># $  #  .$...#</L>
      <L>## $    .....#</L>
      <L> ####### .####</L>
      <L>       ####</L>
    </Level>
    <Level Id="jw2005.2" Width="12" Height="11">
      <L>###########</L>
      <L>#   #     #</L>
      <L># $   $ $ #</L>
      <L>##$#.###  #</L>
      <L> # #....# #</L>
      <L> # #... #$#</L>
      <L>## #  @ # ##</L>
      <L>#  ###$##  #</L>
      <L>#       $$ #</L>
      <L>#####      #</L>
      <L>    ########</L>
    </Level>
    <Level Id="jw2005.3" Width="10" Height="9">
      <L>##########</L>
      <L># $ .*.$ #</L>
      <L># $ *..$ #</L>
      <L>#   +**  #</L>
      <L># $#**.$ #</L>
      <L># $ .*. ##</L>
      <L># $ ***$ #</L>
      <L># $ *..  #</L>
      <L>##########</L>
    </Level>
    <Level Id="jw2005.4" Width="13" Height="12">
      <L>############</L>
      <L>#          #</L>
      <L># ######## #</L>
      <L># #......# ##</L>
      <L># #  ....#  #</L>
      <L># #    $ @  #</L>
      <L># #  ##### ##</L>
      <L># #### $ $ #</L>
      <L>#   $ $ $  #</L>
      <L>#  $ $ $ $ #</L>
      <L>##      #  #</L>
      <L> ###########</L>
    </Level>
    <Level Id="jw2005.5" Width="13" Height="10">
      <L>############</L>
      <L>#          ##</L>
      <L># # ######  #</L>
      <L>#....... @  #</L>
      <L># # ###### ##</L>
      <L># #  $ $   #</L>
      <L>#     $ $  #</L>
      <L>#  # $ $ $ #</L>
      <L>#########  #</L>
      <L>        ####</L>
    </Level>
  </LevelCollection>
</SokobanLevels>
