<?xml version="1.0" encoding="utf-8"?>
<SokobanLevels xmlns:xsi="http://www.w3.org/2001/XMLSchema-instance" xsi:schemaLocation="SokobanLev.xsd">
  <Title>Kalle1</Title>
  <Description>
Kalle1 level collection.
  </Description>
  <Email>kalle.boehm@t-online.de</Email>
  <LevelCollection Copyright="Karl-Heinz Böhm" MaxWidth="35" MaxHeight="35">
    <Level Id="1" Width="22" Height="17">
      <L>######################</L>
      <L>#........... ........#</L>
      <L>#...........  .......#</L>
      <L>############  ######.#</L>
      <L>#@$ $ $ $        ....#</L>
      <L>#  $ $ $ $     #. ...#</L>
      <L># $ $ $ $ $#   ###.###</L>
      <L>#  $ $ $ $         #</L>
      <L># $ $ $ $ $#       #</L>
      <L>#  $ $ $ $      ####</L>
      <L># $ $ $ $ $#    #</L>
      <L>#  $ $ $ $      #</L>
      <L># $ $ $ $ $#    #</L>
      <L>#  $ $ $ $      #</L>
      <L># $ $ $         #</L>
      <L>############  ###</L>
      <L>           ####</L>
    </Level>
    <Level Id="2" Width="11" Height="10">
      <L>###########</L>
      <L>####   ##.#</L>
      <L>#    $  #.#</L>
      <L># $$ $$ #.#</L>
      <L>#  $  ###.#</L>
      <L># $$##   .#</L>
      <L>#      @$ #</L>
      <L># $$###...#</L>
      <L>#     #...#</L>
      <L>###########</L>
    </Level>
    <Level Id="3" Width="10" Height="10">
      <L>##########</L>
      <L>#        #</L>
      <L># $$ $ # #</L>
      <L># @$ # # #</L>
      <L>#  $ #   #</L>
      <L># $$ # # #</L>
      <L>#   ## # #</L>
      <L>#####  . #</L>
      <L> #..... .#</L>
      <L> #########</L>
    </Level>
    <Level Id="4" Width="20" Height="11">
      <L>#########  #########</L>
      <L>#    #  #  #       #</L>
      <L># $$$#  ##### # # ##</L>
      <L># $@$   $     $ $  #</L>
      <L>#    #  #######.# $#</L>
      <L>######        #.$..#</L>
      <L># $   $ $ $ $ #.#..#</L>
      <L># $## $ $######.#*.#</L>
      <L># *.*.*.*.   ####..#</L>
      <L>#          # .   ..#</L>
      <L>####################</L>
    </Level>
    <Level Id="5" Width="35" Height="14">
      <L>###################################</L>
      <L>#         #        #  *      *  # #</L>
      <L># ....$.$ . $ .$ $ .  $ $. $ $  . #</L>
      <L>##*#+.$.$ .$ $. $ $. $ $ .$ $ $ . #</L>
      <L>##.#.# .$ . $ .$ $ .$ $ $. $ $ $. #</L>
      <L>##*#.# . $.$ $. $ $.$ $ $.$ $ $ * #</L>
      <L>####.######...######.....##########</L>
      <L>##*#.# ...#####....#######.#....# #</L>
      <L>##.#.# . $.$ $. $ $.$ $ $.$$$$$$. #</L>
      <L>##*#.#$. $.$ $.$ $ . $ $ .$    $. #</L>
      <L>##.#..$.$$.$ $. $ $.$ $ $.$ $$ $. #</L>
      <L># .... . $.$  . $ $.$ $  .$  $ $. #</L>
      <L>#      #      #    *     #   *    #</L>
      <L>###################################</L>
    </Level>
    <Level Id="6" Width="26" Height="16">
      <L>            ##############</L>
      <L>            #     #      #</L>
      <L>            # $$$@# $    #</L>
      <L>            #   ###$$$$$ #</L>
      <L>############## $$ $      #</L>
      <L>#         ###    $ $$$$$ #</L>
      <L>#         ###  ##  $     #</L>
      <L>#         ###.. ## $ $   #</L>
      <L># # #     ###.#. ## $$$$ #</L>
      <L>########  ###.#.. ##  $  #</L>
      <L>       #  ###.#. . ##  $ #</L>
      <L>       #  ###.#. .. ##   #</L>
      <L>       #  ###.#.#. . ##  #</L>
      <L>       #     . . .#..  $ #</L>
      <L>       #     . . .# ..#  #</L>
      <L>       ###################</L>
    </Level>
    <Level Id="7" Width="35" Height="27">
      <L>###################################</L>
      <L>#                                 #</L>
      <L># ## # # # # # # #@# # $ #  # # #$#</L>
      <L># $  $ $ $ $ . . $   #  $ $ $ $ $ #</L>
      <L># #$ $$$$# ###### #$.$ #...$##### #</L>
      <L># #......# #    # #.*  # $  #. .$ #</L>
      <L># # $ $ #  #.**.# #$.$ #...$# .$  #</L>
      <L># #....#.$ # .  # #.*  # $  #.$.$ #</L>
      <L># # $$ # $ #  *$# #$.$ #...$#$.$  #</L>
      <L># #...#.$  # *  # #.* .# $  #.$.$ #</L>
      <L># # $#.  $ #  * # #$.$ #...$# .$  #</L>
      <L># #. #  $. #$.  # #.*  # $  #.$.$ #</L>
      <L># # #..$.  #  * #$#$.$ #...$# .$  #</L>
      <L>#.## $$.$*.##.###.#.* .# $  #####.#</L>
      <L># # #..$.  #  * # #$.$ #...$# .$  #</L>
      <L># #. #  $. # *  # #.*  # $  #.$.$ #</L>
      <L># # $#.  $ #  **# #$.$ #...$# .$  #</L>
      <L># #.*.#.$  #$*  # #.*  # $  #.$.$ #</L>
      <L># # $  # $ #  * # #$.$.#...$#$.$  #</L>
      <L># #.*..#.$ # * $# #.*  # $  #.$.$ #</L>
      <L># # $ $ #  #  * # #$.$ #...$# .$  #</L>
      <L># #.*.*..# #**  # # .  #    #.$.  #</L>
      <L># # $$$ $# # $* # #### #### ##### #</L>
      <L>#$ $ $ $    .#    $ $   $ $ $ $ $ #</L>
      <L># ## # # #  # $  $.$. # # # # # # #</L>
      <L>#             #                   #</L>
      <L>###################################</L>
    </Level>
    <Level Id="8" Width="35" Height="13">
      <L>###################################</L>
      <L># . . . . #.#  #.          .    . #</L>
      <L>#.$$$ $$$.# #$ #########$####  ## #</L>
      <L># $ $ $ $ #.#    $     # ....*.$  #</L>
      <L>#. $ $ $ .# $ #####$$$   .#  $$$  #</L>
      <L># $ $@$ $ #.#.....#   ## . # $ $# #</L>
      <L>#. $ $ $ .# $  . .### # $.$ $. $  #</L>
      <L># $ $ $ $ #. .....  #.#  . $..  # #</L>
      <L>#. $ $ $ .# ######    #.#.$   ### #</L>
      <L># $ $ $ $ #.. . $ .$#$#  $ $ $ $  #</L>
      <L>#. $ $ $ .  # $.$.$ # # $ $ $ $ $ #</L>
      <L>#.*.*.*.*. .  .$. . . . . . . . . #</L>
      <L>###################################</L>
    </Level>
    <Level Id="9" Width="35" Height="35">
      <L>###################################</L>
      <L>#                                 #</L>
      <L>#       ######$$$$$ $$$$$ $$$$$   #</L>
      <L>#       #    # $ $   $ $   $ $ ## #</L>
      <L>#       # $$$#  $  #  $  #  $   # #</L>
      <L>#       # ...   $  #  $  #  $   # #</L>
      <L>#       #    # $ $   $ $   $ $ ## #</L>
      <L>#       ######$$$$$ $$$$$ $$$$$   #</L>
      <L>#                                 #</L>
      <L>################################  #</L>
      <L># . . . . . . .# . . . . . . . .  #</L>
      <L>#                                 #</L>
      <L># .################################</L>
      <L>#  . . . . . . . . . . . . . . .  #</L>
      <L>#                                 #</L>
      <L>################################  #</L>
      <L>#  $ $ $ $ $ $ $ $ $ $ $ $ $ $ $  #</L>
      <L>#                                 #</L>
      <L>#  ################################</L>
      <L>#            #  #  #  #... .$. . .#</L>
      <L>## $ $ $ $ $    #  #  #..##########</L>
      <L>#  .....  $$ # $ $ $$ #.$#.. .. $ #</L>
      <L># $####.$ $  #   $  $ $$ #.###.## #</L>
      <L># $   #....  # #         # # # #  #</L>
      <L># $.. #.### #######$######.# #.# ##</L>
      <L># $.. #. ...#..#  # ..   ..# # #  #</L>
      <L># $@$     $.#..#  #$.#$### # #.## #</L>
      <L>######### #.#..####  #.. $ $ # #  #</L>
      <L># $ . * # #.#$$ $ #$ #..$ .  #.# ##</L>
      <L># ..... # #.....$ #  ####$#### #  #</L>
      <L>#..$ $.$# #####.$ #$ #       #.## #</L>
      <L>#$. $ . # $   #.$ # .#  $ $  #.#  #</L>
      <L># ...*.$ $$$$ #......  $###  $ # ##</L>
      <L># .$.   #         #        #      #</L>
      <L>###################################</L>
    </Level>
    <Level Id="10" Width="35" Height="35">
      <L>###################################</L>
      <L>##   .#                          ##</L>
      <L># #  .##.$.$ #.$.$ #.$ $. #.$.$ # #</L>
      <L>#  # ..... . . . . . . . .  .  #  #</L>
      <L># * #   ##### #####$######$#### . #</L>
      <L># .* #   $         $         # .  #</L>
      <L># $ * #  $$$$$$$$$$$ $$$$$$ # . . #</L>
      <L>#  $ * # $           $     # .    #</L>
      <L># $ $ * #   #######  $    # .   . #</L>
      <L>#  $ $ . #  #     #  $   # .      #</L>
      <L># $ $ $ . # ##   ##  $  # .   ##. #</L>
      <L>#  $ $ . . # ## ##   $ # .   ###  #</L>
      <L># $ $ $ . . # ###     # .   ## #. #</L>
      <L>#  $ $ . . . # #     # .   ##  #  #</L>
      <L># $ $ $ . . . #     # .   ## . #. #</L>
      <L>#  $ $ . . . . #   # .   ##    #  #</L>
      <L># $ $ $ . . . . #$  .   ##  .. #. #</L>
      <L>#  $ $.. . . . ...#..  ##         #</L>
      <L># $ $ $ . . . . #+# .   ##  .. #. #</L>
      <L>#  $ $ . . . . # . # .   ##    #  #</L>
      <L># $ $ $ . . . #  .  # .   ## . #. #</L>
      <L>#  $ $ . . . #   .   # .   ##  #  #</L>
      <L># $ $ $ . . #    .    # .   ## #. #</L>
      <L>#  $ $ . . #  $$$.$$$  # .   ###  #</L>
      <L># $ $ $ . #             # .   ##. #</L>
      <L>#  $ $ . # $ $$$$$$$$ $  # .      #</L>
      <L># $ $ * #    $      $     # .   . #</L>
      <L>#  $ * #   $ $ #### $ $    # .    #</L>
      <L># $ * #  $.  $ #### $  .$   # . . #</L>
      <L># .* #  $ .$ $ #### $ $. $   # .  #</L>
      <L># * #  $ $.  $      $  .$ $   # . #</L>
      <L>#  #   ....  $$$$$$$$  ....    #  #</L>
      <L># #    $ $ $ $      $ $ $ $     # #</L>
      <L>##                               ##</L>
      <L>###################################</L>
    </Level>
    <Level Id="11" Width="35" Height="18">
      <L>###################################</L>
      <L>#.              #.     .       . .#</L>
      <L># ####### ############ ####### $.$#</L>
      <L># # $ $ $ $ $ $ $ $ $ $ $ $  #$@$.#</L>
      <L># . . . . . . . . . . . . . .#.$.$#</L>
      <L># #.$.$.$.$.$.$.$.$.$.$.$.$. #    #</L>
      <L>#  #### . . . . . . . . . .  #.$.$#</L>
      <L>#  #  # $ $ $ $ $ $ $ $ $ ####$ $.#</L>
      <L>#  #  #           #          .  . #</L>
      <L>####  ############  #######.#######</L>
      <L>#        #         ##   .$.$.$.$. #</L>
      <L>#      $ $       #  ### $.$.$.$.$ #</L>
      <L>###### #### #### #    # .$.$.$.$. #</L>
      <L>#.. . . . . . . .#  $   $ $       #</L>
      <L>#$$$$$$$$$$$$$$$$######    ########</L>
      <L>#.. . . . . . . .#  $ $ $ $ $ $ $ #</L>
      <L>#                                 #</L>
      <L>###################################</L>
    </Level>
    <Level Id="12" Width="20" Height="20">
      <L>      #######</L>
      <L>      #     #</L>
      <L>      #     #####</L>
      <L>      # $$$     #</L>
      <L>      # $ $ # # #</L>
      <L>      # $ $ # # #</L>
      <L>      # $ $ ### ####</L>
      <L>      ### ####     #</L>
      <L>      #......#$$$$ #</L>
      <L>#######.+....    $ #</L>
      <L>#     #......#$$$$ #</L>
      <L># $ $  ......#     #</L>
      <L>#     #......###   #</L>
      <L>########## ### #   #</L>
      <L>       # $ $ # ##  #</L>
      <L>       # $ $ #  #$ #</L>
      <L>       # $ $ #  #  #</L>
      <L>       # $$$       #</L>
      <L>       #     #     #</L>
      <L>       #############</L>
    </Level>
  </LevelCollection>
</SokobanLevels>
