<?xml version="1.0" encoding="utf-8"?>
<SokobanLevels xmlns:xsi="http://www.w3.org/2001/XMLSchema-instance" xsi:schemaLocation="SokobanLev.xsd">
  <Title>Kevin 13</Title>
  <Description>
Kevin 13 collection by Kevin B Reilly
  </Description>
  <Email>kreilly1@bellsouth.net</Email>
  <LevelCollection Copyright="Kevin B Reilly" MaxWidth="16" MaxHeight="16">
    <Level Id="Kevin 1201" Width="10" Height="9">
      <L>  #######</L>
      <L>### ... ##</L>
      <L>#   $#$  #</L>
      <L># #$$+$  #</L>
      <L>#   $#$# #</L>
      <L>####...  #</L>
      <L>   ### # #</L>
      <L>     #   #</L>
      <L>     #####</L>
    </Level>
    <Level Id="Kevin 1202" Width="10" Height="9">
      <L>  ######</L>
      <L>###    #</L>
      <L>#  $ . ###</L>
      <L># #@$*$  #</L>
      <L>#  $#. # #</L>
      <L>###  .#  #</L>
      <L>  #  .# ##</L>
      <L>  ###   #</L>
      <L>    #####</L>
    </Level>
    <Level Id="Kevin 1203" Width="11" Height="10">
      <L>   #####</L>
      <L>   #   ##</L>
      <L>#### #  #</L>
      <L>#  *+## #</L>
      <L># #$*.# #</L>
      <L># # ..# ###</L>
      <L># ## $    #</L>
      <L>#    #$$# #</L>
      <L>####      #</L>
      <L>   ########</L>
    </Level>
    <Level Id="Kevin 1204" Width="11" Height="9">
      <L>   ####</L>
      <L>   #  #</L>
      <L>  ##  #####</L>
      <L>###       #</L>
      <L># ..**.**.#</L>
      <L># #  $$$  #</L>
      <L># ### $@###</L>
      <L>#     ###</L>
      <L>#######</L>
    </Level>
    <Level Id="Kevin 1205" Width="13" Height="13">
      <L> ####</L>
      <L> #  #</L>
      <L> #  #######</L>
      <L> #        #</L>
      <L>##$##$# # #</L>
      <L>#   #...  ###</L>
      <L>#   $.@.##  #</L>
      <L>##$##...$   #</L>
      <L> #  ###$##  #</L>
      <L> #  ##  ##$##</L>
      <L> #  ##  $   #</L>
      <L> #####  #   #</L>
      <L>     ########</L>
    </Level>
    <Level Id="Kevin 1206" Width="11" Height="11">
      <L>#####</L>
      <L>#   #####</L>
      <L># #.   .###</L>
      <L># $*$$$*$ #</L>
      <L>#  .# #.  #</L>
      <L># #. @ .# #</L>
      <L>#  .# #.  #</L>
      <L># $*$$$*$ #</L>
      <L>###.   .# #</L>
      <L>  #####   #</L>
      <L>      #####</L>
    </Level>
    <Level Id="Kevin 1207" Width="14" Height="12">
      <L>     ####</L>
      <L>   ###  ##</L>
      <L> ###  $  #####</L>
      <L> #   # #     #</L>
      <L>## ##. .## # #</L>
      <L>#  #.#$$. $  #</L>
      <L># $$*   *  ###</L>
      <L>#   .$ #.###</L>
      <L>#####. .##</L>
      <L>    ##$##</L>
      <L>     #@#</L>
      <L>     ###</L>
    </Level>
    <Level Id="Kevin 1208" Width="8" Height="12">
      <L>   ###</L>
      <L>   #.#</L>
      <L>  ##.##</L>
      <L>### . #</L>
      <L>#  $.$#</L>
      <L># # . ##</L>
      <L>#  $*$ #</L>
      <L>## #+# #</L>
      <L> #  $  #</L>
      <L> ## $ ##</L>
      <L>  #   #</L>
      <L>  #####</L>
    </Level>
    <Level Id="Kevin 1209" Width="10" Height="12">
      <L>##########</L>
      <L>#  #     #</L>
      <L>#  $ # # #</L>
      <L># $###*. #</L>
      <L>#  .*@.*##</L>
      <L># #.#**. #</L>
      <L>#   # #$ #</L>
      <L>### $ $  #</L>
      <L>  #     ##</L>
      <L>  ## # ##</L>
      <L>   #   #</L>
      <L>   #####</L>
    </Level>
    <Level Id="Kevin 1210" Width="11" Height="8">
      <L> #### ####</L>
      <L> #  ###  #</L>
      <L> #       #</L>
      <L>## #$$$# ##</L>
      <L># ...#... #</L>
      <L>#  #$$$#  #</L>
      <L>##   @   ##</L>
      <L> #########</L>
    </Level>
    <Level Id="Kevin 1211" Width="11" Height="11">
      <L>#####</L>
      <L>#   #######</L>
      <L># $$....  #</L>
      <L>#  #.# ## #</L>
      <L># $#.#@## #</L>
      <L>#  #.# ## #</L>
      <L># $$ $$ # #</L>
      <L>#       # #</L>
      <L>#### #### #</L>
      <L>   #      #</L>
      <L>   ########</L>
    </Level>
    <Level Id="Kevin 1212" Width="8" Height="13">
      <L> #####</L>
      <L> #   ###</L>
      <L> # $   #</L>
      <L> # ..$ #</L>
      <L> ##.*  #</L>
      <L>###**###</L>
      <L>#  ..  #</L>
      <L># $..  #</L>
      <L>#  #$# #</L>
      <L>##$$   #</L>
      <L># $ ####</L>
      <L># @ #</L>
      <L>#####</L>
    </Level>
    <Level Id="Kevin 1213" Width="12" Height="13">
      <L> ###########</L>
      <L> #         #</L>
      <L>## ### ### #</L>
      <L>#   #   ## #</L>
      <L>#   ..$..# #</L>
      <L>####$$$$$# #</L>
      <L>   #..@..# #</L>
      <L>   #$$$$$# #</L>
      <L>   #..$..# #</L>
      <L>   ### ### #</L>
      <L>     # ### #</L>
      <L>     #     #</L>
      <L>     #######</L>
    </Level>
    <Level Id="Kevin 1214" Width="11" Height="10">
      <L> ####</L>
      <L> #  #######</L>
      <L> #   $    #</L>
      <L> #  ##$   #</L>
      <L>### #.. ###</L>
      <L>#  $...##</L>
      <L>#   *$. #</L>
      <L>###$$ # #</L>
      <L>  #@#   #</L>
      <L>  #######</L>
    </Level>
    <Level Id="Kevin 1215" Width="10" Height="7">
      <L>    ######</L>
      <L>#####    #</L>
      <L>#    ..# #</L>
      <L># #$ *.$ #</L>
      <L>#   $** ##</L>
      <L>#####@ ##</L>
      <L>    ####</L>
    </Level>
    <Level Id="Kevin 1216" Width="16" Height="16">
      <L>   ######</L>
      <L>   #    #</L>
      <L>   # ## ##</L>
      <L>   #   $ #</L>
      <L>   # # $ ###</L>
      <L>   # # $ ..#</L>
      <L>####  #.##.###</L>
      <L>#  $$$..##   ###</L>
      <L># #   @#..$$$  #</L>
      <L># ###.##.#   # #</L>
      <L>#    .. $ # ## #</L>
      <L>##### # $ # ## #</L>
      <L>    # # $      #</L>
      <L>    # ## #######</L>
      <L>    #    #</L>
      <L>    ######</L>
    </Level>
    <Level Id="Kevin 1217" Width="10" Height="9">
      <L> #####</L>
      <L> #   #</L>
      <L>## # ####</L>
      <L># *.    #</L>
      <L># .*### ##</L>
      <L># *+$    #</L>
      <L># #$$#   #</L>
      <L>#    #####</L>
      <L>######</L>
    </Level>
    <Level Id="Kevin 1218" Width="14" Height="11">
      <L>   #####</L>
      <L> ###   ###</L>
      <L> #   #   #####</L>
      <L>## #$$$# #...#</L>
      <L>#  $   $  ...#</L>
      <L># #$ #@$# ...#</L>
      <L>#  $ # $  ...#</L>
      <L>## #$$$  ##  #</L>
      <L> #   #   #####</L>
      <L> ###   ###</L>
      <L>   #####</L>
    </Level>
    <Level Id="Kevin 1219" Width="7" Height="10">
      <L>   ####</L>
      <L>  ##  #</L>
      <L>###.$ #</L>
      <L># .** #</L>
      <L># *.. #</L>
      <L># *#$ #</L>
      <L># $ @ #</L>
      <L>## $  #</L>
      <L> #  ###</L>
      <L> ####</L>
    </Level>
    <Level Id="Kevin 1220" Width="10" Height="11">
      <L>##########</L>
      <L>#        #</L>
      <L># ###### #</L>
      <L># #    # #</L>
      <L># # .$$  #</L>
      <L># # .* ###</L>
      <L>#   ** #</L>
      <L>### *.@#</L>
      <L>  #$$. #</L>
      <L>  #   ##</L>
      <L>  #####</L>
    </Level>
    <Level Id="Kevin 1221" Width="11" Height="10">
      <L> #####</L>
      <L> #   ######</L>
      <L> # # #    #</L>
      <L> # $$$ $$ #</L>
      <L>##.#@$    #</L>
      <L>#...# ##$ #</L>
      <L>##.$ .  $ #</L>
      <L> #  ...#$ #</L>
      <L> ####.##  #</L>
      <L>    #######</L>
    </Level>
    <Level Id="Kevin 1222" Width="9" Height="11">
      <L>#########</L>
      <L>#       #</L>
      <L># ##*## #</L>
      <L># # + # #</L>
      <L># #$*$# #</L>
      <L>#    $  #</L>
      <L>###$.   #</L>
      <L>  # . # #</L>
      <L>  ##.## #</L>
      <L>   #    #</L>
      <L>   ######</L>
    </Level>
    <Level Id="Kevin 1223" Width="9" Height="11">
      <L>  ####</L>
      <L> ##  #</L>
      <L> # $ #</L>
      <L> # $ #</L>
      <L>## # ####</L>
      <L># $ . $ #</L>
      <L># # . # #</L>
      <L># ##.## #</L>
      <L>#   *   #</L>
      <L>#   +####</L>
      <L>######</L>
    </Level>
    <Level Id="Kevin 1224" Width="11" Height="11">
      <L>#######</L>
      <L>#     #</L>
      <L># ### ##</L>
      <L>#      #</L>
      <L># # # $##</L>
      <L># $$$**.###</L>
      <L>###  .+.$ #</L>
      <L>  #$#...# #</L>
      <L>  # #$#   #</L>
      <L>  #     ###</L>
      <L>  #######</L>
    </Level>
    <Level Id="Kevin 1225" Width="10" Height="11">
      <L>  ########</L>
      <L>  #      #</L>
      <L> ##$#### #</L>
      <L> #   $ # #</L>
      <L>## $$# # #</L>
      <L>#..*+*.. #</L>
      <L>## #$# # #</L>
      <L> #     # #</L>
      <L> #### ## #</L>
      <L>    #    #</L>
      <L>    ######</L>
    </Level>
    <Level Id="Kevin 1226" Width="10" Height="7">
      <L>  #######</L>
      <L>###     ##</L>
      <L># $ #$$  #</L>
      <L>#@$...*. #</L>
      <L>#####  # #</L>
      <L>    ##   #</L>
      <L>     #####</L>
    </Level>
    <Level Id="Kevin 1227" Width="7" Height="8">
      <L>   ####</L>
      <L>####  #</L>
      <L>#     #</L>
      <L># $ #.#</L>
      <L># @$ .#</L>
      <L># $$#.#</L>
      <L>###  .#</L>
      <L>  #####</L>
    </Level>
    <Level Id="Kevin 1228" Width="9" Height="10">
      <L>######</L>
      <L>#    #</L>
      <L># # $##</L>
      <L>#  **.###</L>
      <L>#  .$.  #</L>
      <L>###*+*  #</L>
      <L>  # $ # #</L>
      <L>  # $   #</L>
      <L>  #  ####</L>
      <L>  ####</L>
    </Level>
    <Level Id="Kevin 1229" Width="9" Height="9">
      <L>  #####</L>
      <L>###.#.###</L>
      <L>#  .#.  #</L>
      <L># $*$*$ #</L>
      <L>## *@*  #</L>
      <L> # *$* ##</L>
      <L> #     #</L>
      <L> ###  ##</L>
      <L>   ####</L>
    </Level>
    <Level Id="Kevin 1230" Width="8" Height="11">
      <L> #####</L>
      <L> #   #</L>
      <L> # * ###</L>
      <L> # .   #</L>
      <L>###*$  #</L>
      <L>#@$. ###</L>
      <L>###*$  #</L>
      <L> # .   #</L>
      <L> # * ###</L>
      <L> #   #</L>
      <L> #####</L>
    </Level>
    <Level Id="Kevin 1231" Width="8" Height="8">
      <L>  #####</L>
      <L>  #   #</L>
      <L>  #$$ #</L>
      <L>###@# #</L>
      <L>#  $$ ##</L>
      <L># # $  #</L>
      <L># .....#</L>
      <L>########</L>
    </Level>
    <Level Id="Kevin 1232" Width="9" Height="9">
      <L> #######</L>
      <L> #  .  #</L>
      <L> # $.$ #</L>
      <L>##$$.$$##</L>
      <L>#...@...#</L>
      <L>##$$.$$##</L>
      <L> # $.$ #</L>
      <L> #  .  #</L>
      <L> #######</L>
    </Level>
    <Level Id="Kevin 1233" Width="13" Height="10">
      <L>    #####</L>
      <L>    #   #</L>
      <L>   ## # ##</L>
      <L>  ##     ##</L>
      <L> ##  .*.  ##</L>
      <L>##  #*.*#  ##</L>
      <L># $$$...$$$ #</L>
      <L>#    #*#    #</L>
      <L>#    *@*    #</L>
      <L>#############</L>
    </Level>
    <Level Id="Kevin 1234" Width="10" Height="9">
      <L> #########</L>
      <L>##...... #</L>
      <L>#   $ $$ #</L>
      <L># #$#$# ##</L>
      <L>#   #@# #</L>
      <L>#####$  #</L>
      <L>    #  ##</L>
      <L>    #  #</L>
      <L>    ####</L>
    </Level>
    <Level Id="Kevin 1235" Width="10" Height="14">
      <L>     #####</L>
      <L>     #   #</L>
      <L>###### # #</L>
      <L>#   # *  #</L>
      <L>#   $ .###</L>
      <L>## ## .#</L>
      <L>#   ##.#</L>
      <L># #  $.#</L>
      <L>#  $$ *#</L>
      <L>##$$ #.#</L>
      <L> #@#  .#</L>
      <L> ###  ##</L>
      <L>   #  #</L>
      <L>   ####</L>
    </Level>
    <Level Id="Kevin 1236" Width="9" Height="10">
      <L>#########</L>
      <L>#       #</L>
      <L># # # # #</L>
      <L>#+**.$$ #</L>
      <L>##... # #</L>
      <L> # # $$ #</L>
      <L> # #  $ #</L>
      <L> # ### ##</L>
      <L> #     #</L>
      <L> #######</L>
    </Level>
    <Level Id="Kevin 1237" Width="13" Height="10">
      <L>    #####</L>
      <L>    #   #</L>
      <L>##### # #####</L>
      <L>#   #...#   #</L>
      <L>#   $*.*$   #</L>
      <L>####$.+.$####</L>
      <L>   #  #  #</L>
      <L>   # $$$ #</L>
      <L>   #  #  #</L>
      <L>   #######</L>
    </Level>
    <Level Id="Kevin 1238" Width="8" Height="10">
      <L>#####</L>
      <L>#   #</L>
      <L># # ####</L>
      <L>#    $ #</L>
      <L>##...# #</L>
      <L> # #   #</L>
      <L> #  $###</L>
      <L> ##$ #</L>
      <L>  #@##</L>
      <L>  ###</L>
    </Level>
    <Level Id="Kevin 1239" Width="10" Height="10">
      <L>  #######</L>
      <L>###     #</L>
      <L>#   # # ##</L>
      <L># #**+*. #</L>
      <L>#  $  $# #</L>
      <L>##.*..*. #</L>
      <L> ##$$$$# #</L>
      <L>  #  #   #</L>
      <L>  ##   ###</L>
      <L>   #####</L>
    </Level>
    <Level Id="Kevin 1240" Width="10" Height="10">
      <L>  #######</L>
      <L>###     #</L>
      <L>#  $# # ##</L>
      <L># #+***. #</L>
      <L># $$$  # #</L>
      <L>##..**.. #</L>
      <L> ##  $ # #</L>
      <L>  # $#   #</L>
      <L>  ##   ###</L>
      <L>   #####</L>
    </Level>
    <Level Id="Kevin 1241" Width="8" Height="9">
      <L>  #####</L>
      <L>###   #</L>
      <L># $$# ##</L>
      <L>#  $ $ #</L>
      <L># #..# #</L>
      <L># $**  #</L>
      <L>#  ..# #</L>
      <L>#  ..$@#</L>
      <L>########</L>
    </Level>
    <Level Id="Kevin 1242" Width="9" Height="9">
      <L>    #####</L>
      <L>#####   #</L>
      <L># $ . # #</L>
      <L># $...$ #</L>
      <L># $#.#$##</L>
      <L>#  *+*  #</L>
      <L>#   $ # #</L>
      <L>#####   #</L>
      <L>    #####</L>
    </Level>
    <Level Id="Kevin 1243" Width="9" Height="9">
      <L>    #####</L>
      <L>#####   #</L>
      <L>#   *$# #</L>
      <L>#  ...$@#</L>
      <L>#  #*#$##</L>
      <L># $...  #</L>
      <L># $ $ # #</L>
      <L>#####   #</L>
      <L>    #####</L>
    </Level>
    <Level Id="Kevin 1244" Width="8" Height="11">
      <L>   ####</L>
      <L>####  #</L>
      <L>#  $$ ##</L>
      <L># **.  #</L>
      <L>#@*..# #</L>
      <L># **.  #</L>
      <L>#  $$# #</L>
      <L>####   #</L>
      <L>   #  ##</L>
      <L>   #  #</L>
      <L>   ####</L>
    </Level>
    <Level Id="Kevin 1245" Width="9" Height="8">
      <L>  #####</L>
      <L>  #   ##</L>
      <L> ##  $ ##</L>
      <L>## $#...#</L>
      <L># $@$.*.#</L>
      <L># #$ # ##</L>
      <L>#      #</L>
      <L>########</L>
    </Level>
    <Level Id="Kevin 1246" Width="8" Height="11">
      <L>   ####</L>
      <L>####  #</L>
      <L>#     #</L>
      <L>#   $ #</L>
      <L>##$## ##</L>
      <L># *..  #</L>
      <L>#@*.*# #</L>
      <L># $#   #</L>
      <L>#  #  ##</L>
      <L>####  #</L>
      <L>   ####</L>
    </Level>
    <Level Id="Kevin 1247" Width="10" Height="10">
      <L>    #####</L>
      <L>    #@  ##</L>
      <L> ####$#  #</L>
      <L>##..  ## #</L>
      <L># ..*  $ #</L>
      <L># . .*$# #</L>
      <L># # $  $ #</L>
      <L># #$ #####</L>
      <L>#   ##</L>
      <L>#####</L>
    </Level>
    <Level Id="Kevin 1248" Width="7" Height="8">
      <L>  #####</L>
      <L>  #   #</L>
      <L>### $ #</L>
      <L># $ $ #</L>
      <L>#@#.* #</L>
      <L># $..##</L>
      <L>####.#</L>
      <L>   ###</L>
    </Level>
    <Level Id="Kevin 1249" Width="11" Height="11">
      <L>#####</L>
      <L>#   #</L>
      <L># # #####</L>
      <L>#   #   #</L>
      <L>##  .*..#</L>
      <L>##$#.**.#</L>
      <L>#   #@# ###</L>
      <L>#   $$#   #</L>
      <L>####   $$ #</L>
      <L>   #  #   #</L>
      <L>   ########</L>
    </Level>
    <Level Id="Kevin 1250" Width="10" Height="13">
      <L>#########</L>
      <L>#       ##</L>
      <L># #####  #</L>
      <L># ##  ## #</L>
      <L>#   $  # #</L>
      <L># # $$ # #</L>
      <L># ...*.# #</L>
      <L>###$#  # #</L>
      <L> #...*.# #</L>
      <L> ## $$ # #</L>
      <L>  #$$  # #</L>
      <L>  #@##   #</L>
      <L>  ########</L>
    </Level>
    <Level Id="Kevin 1251" Width="11" Height="9">
      <L>#########</L>
      <L>#       ###</L>
      <L># $.$.$.$ #</L>
      <L># #.#.#.# #</L>
      <L># $$ $@$  #</L>
      <L># #.#.#.  #</L>
      <L># $.$.$.$ #</L>
      <L>###       #</L>
      <L>  #########</L>
    </Level>
    <Level Id="Kevin 1252" Width="9" Height="11">
      <L>    #####</L>
      <L>#####   #</L>
      <L>#   # # #</L>
      <L># #$$   #</L>
      <L>#@$ .* ##</L>
      <L>####.*  #</L>
      <L>  # *.# #</L>
      <L>  # $.# #</L>
      <L>  # #   #</L>
      <L>  #   ###</L>
      <L>  #####</L>
    </Level>
    <Level Id="Kevin 1253" Width="7" Height="10">
      <L> #####</L>
      <L> # @ #</L>
      <L> #$*$##</L>
      <L>## *  #</L>
      <L># $.$ #</L>
      <L># #.# #</L>
      <L>#  .  #</L>
      <L>## . ##</L>
      <L> #   #</L>
      <L> #####</L>
    </Level>
    <Level Id="Kevin 1254" Width="7" Height="11">
      <L>  ####</L>
      <L>  #  #</L>
      <L> ##  #</L>
      <L> # $ #</L>
      <L> # . ##</L>
      <L>##$.$@#</L>
      <L>#  .$ #</L>
      <L># #.# #</L>
      <L># $.$ #</L>
      <L>###. ##</L>
      <L>  ####</L>
    </Level>
    <Level Id="Kevin 1255" Width="9" Height="9">
      <L> ######</L>
      <L>##    ###</L>
      <L>#     $ #</L>
      <L>#  #$ # #</L>
      <L># $..*  #</L>
      <L>##$...###</L>
      <L> # #$##</L>
      <L> #  @#</L>
      <L> #####</L>
    </Level>
    <Level Id="Kevin 1256" Width="16" Height="9">
      <L> ########</L>
      <L> #   #  ########</L>
      <L> # # #  $......#</L>
      <L>##  $   ########</L>
      <L>#  # ## #</L>
      <L>#  $$$  ##</L>
      <L>#  #@# $ #</L>
      <L>######   #</L>
      <L>     #####</L>
    </Level>
    <Level Id="Kevin 1257" Width="10" Height="9">
      <L>  ########</L>
      <L>###  .   #</L>
      <L># $$#*## #</L>
      <L># # #. $ #</L>
      <L>#@$  .$  #</L>
      <L>###  * # #</L>
      <L>  # #.## #</L>
      <L>  #  .   #</L>
      <L>  ########</L>
    </Level>
    <Level Id="Kevin 1258" Width="11" Height="9">
      <L>   #####</L>
      <L>   #   ##</L>
      <L>####  $@##</L>
      <L>#   #$ $ #</L>
      <L># #   ## ##</L>
      <L>#.*.*.*.. #</L>
      <L>### $ $ # #</L>
      <L>  ##      #</L>
      <L>   ########</L>
    </Level>
    <Level Id="Kevin 1259" Width="8" Height="7">
      <L>########</L>
      <L>#      #</L>
      <L>#.* $# #</L>
      <L>#*.$@$ #</L>
      <L>#  #$###</L>
      <L>#..  #</L>
      <L>######</L>
    </Level>
    <Level Id="Kevin 1260" Width="9" Height="10">
      <L>  #####</L>
      <L>###   ###</L>
      <L>#   #   #</L>
      <L># #.. # #</L>
      <L># $**   #</L>
      <L>##$+*# ##</L>
      <L># $**  #</L>
      <L># # # ##</L>
      <L>#     #</L>
      <L>#######</L>
    </Level>
    <Level Id="Kevin 1261" Width="12" Height="9">
      <L>  #######</L>
      <L>###     ##</L>
      <L>#  .# # .#</L>
      <L># #*$$$$.###</L>
      <L>#  .$@$ .  #</L>
      <L>###.$$$$*# #</L>
      <L>  #. # #.  #</L>
      <L>  #.    .###</L>
      <L>  ########</L>
    </Level>
    <Level Id="Kevin 1262" Width="13" Height="11">
      <L>   #####</L>
      <L>   #   ####</L>
      <L>####      #</L>
      <L>#   $$#$$ #</L>
      <L># #..*.*..#</L>
      <L>#    #@#  #</L>
      <L>####.*.*.####</L>
      <L>  # $$#$$   #</L>
      <L>  # # # #   #</L>
      <L>  #       ###</L>
      <L>  #########</L>
    </Level>
    <Level Id="Kevin 1263" Width="11" Height="9">
      <L>   #####</L>
      <L> ###   #</L>
      <L> #   $ #</L>
      <L> # #...###</L>
      <L>##  *#*  ##</L>
      <L>#  #...#  #</L>
      <L># $ $$$ $ #</L>
      <L>#  # @ #  #</L>
      <L>###########</L>
    </Level>
    <Level Id="Kevin 1264" Width="9" Height="9">
      <L> ######</L>
      <L> #    #</L>
      <L>## #$ ###</L>
      <L>#..*....#</L>
      <L># #$$$$$#</L>
      <L>#   #@  #</L>
      <L>### ##  #</L>
      <L>  #    ##</L>
      <L>  ######</L>
    </Level>
    <Level Id="Kevin 1265" Width="9" Height="11">
      <L>      ###</L>
      <L>    ###.#</L>
      <L>  ###  .#</L>
      <L>  #   #.#</L>
      <L>### #$#.#</L>
      <L>#@$   $.#</L>
      <L># $$# $.#</L>
      <L>###   $.#</L>
      <L>  # # ###</L>
      <L>  #   #</L>
      <L>  #####</L>
    </Level>
    <Level Id="Kevin 1266" Width="12" Height="11">
      <L>   #####</L>
      <L>   #  .#</L>
      <L>   # #.#</L>
      <L>   # $.#####</L>
      <L>   #  .#   #</L>
      <L>  ### $    #</L>
      <L>### $ ######</L>
      <L>#      #</L>
      <L># $# # #</L>
      <L>##@#   #</L>
      <L> #######</L>
    </Level>
    <Level Id="Kevin 1267" Width="10" Height="8">
      <L>########</L>
      <L>#@...  ###</L>
      <L># #*#$$  #</L>
      <L># $    $ #</L>
      <L>##$$ $#.##</L>
      <L> # #  ...#</L>
      <L> #   #####</L>
      <L> #####</L>
    </Level>
    <Level Id="Kevin 1268" Width="9" Height="13">
      <L>  #####</L>
      <L>###   #</L>
      <L>#   # #</L>
      <L># # $ #</L>
      <L>#  $ $##</L>
      <L>###.*..#</L>
      <L> ###@####</L>
      <L> #..*.  #</L>
      <L> ##$ $# #</L>
      <L>  # $   #</L>
      <L>  # # ###</L>
      <L>  #   #</L>
      <L>  #####</L>
    </Level>
    <Level Id="Kevin 1269" Width="8" Height="11">
      <L> #####</L>
      <L> #   #</L>
      <L>##.# #</L>
      <L># .  #</L>
      <L># *#$###</L>
      <L># *@$  #</L>
      <L># *#$# #</L>
      <L># .    #</L>
      <L>##  # ##</L>
      <L> ##   #</L>
      <L>  #####</L>
    </Level>
    <Level Id="Kevin 1270" Width="10" Height="10">
      <L>  ####</L>
      <L>  #  #####</L>
      <L> ##$     #</L>
      <L>##   # # #</L>
      <L>#  $#.*  #</L>
      <L># #@$.. ##</L>
      <L>#  $#.. #</L>
      <L>##   $# #</L>
      <L> ####   #</L>
      <L>    #####</L>
    </Level>
    <Level Id="Kevin 1271" Width="11" Height="9">
      <L>   #####</L>
      <L>   #   #</L>
      <L> ### # ###</L>
      <L>## $. .  #</L>
      <L>#  #.#.#$##</L>
      <L>#  $.#. $@#</L>
      <L>#  $* *$$ #</L>
      <L>##  . . $ #</L>
      <L> ##########</L>
    </Level>
    <Level Id="Kevin 1272" Width="11" Height="9">
      <L> ########</L>
      <L> #      #</L>
      <L>## #### ###</L>
      <L>#  . #    #</L>
      <L># #* $ *# #</L>
      <L>#  . # .  #</L>
      <L>###*$$$*###</L>
      <L>  #   @.#</L>
      <L>  #######</L>
    </Level>
    <Level Id="Kevin 1273" Width="7" Height="9">
      <L> ######</L>
      <L> #    #</L>
      <L>## $# #</L>
      <L>#+*...#</L>
      <L>## $# #</L>
      <L> # $  #</L>
      <L> ##$# #</L>
      <L>  #   #</L>
      <L>  #####</L>
    </Level>
    <Level Id="Kevin 1274" Width="10" Height="9">
      <L>  #####</L>
      <L>###   ###</L>
      <L>#   #   #</L>
      <L># #. .# ##</L>
      <L>#  $*$   #</L>
      <L>## *@* # #</L>
      <L> ##$#$   #</L>
      <L>  #.#.####</L>
      <L>  #####</L>
    </Level>
    <Level Id="Kevin 1275" Width="10" Height="8">
      <L> #######</L>
      <L> #     #</L>
      <L>## # # ###</L>
      <L># ...... #</L>
      <L># $$$$$$ #</L>
      <L>### #@# ##</L>
      <L>  #     #</L>
      <L>  #######</L>
    </Level>
    <Level Id="Kevin 1276" Width="9" Height="9">
      <L>  #####</L>
      <L>###   ###</L>
      <L># $$# $ #</L>
      <L># #.. $@#</L>
      <L>#  ..#$##</L>
      <L># #..  #</L>
      <L># # #$##</L>
      <L>#     #</L>
      <L>#######</L>
    </Level>
    <Level Id="Kevin 1277" Width="9" Height="8">
      <L>   ######</L>
      <L>####    #</L>
      <L># $+$ # #</L>
      <L># #*# # #</L>
      <L># $.$ # #</L>
      <L># #.    #</L>
      <L>#  . ####</L>
      <L>######</L>
    </Level>
    <Level Id="Kevin 1278" Width="11" Height="8">
      <L>   #####</L>
      <L>####.#.####</L>
      <L># $ .#. $ #</L>
      <L>#  $*$.$$ #</L>
      <L>#   . . $@#</L>
      <L>##$#.#.#$##</L>
      <L> #   #   #</L>
      <L> #########</L>
    </Level>
    <Level Id="Kevin 1279" Width="8" Height="12">
      <L> #####</L>
      <L> #   #</L>
      <L> # # #</L>
      <L>##   ##</L>
      <L>#  .  #</L>
      <L># #*# #</L>
      <L># $+$ ##</L>
      <L>###*#  #</L>
      <L>  # #  #</L>
      <L>  #    #</L>
      <L>  #  ###</L>
      <L>  ####</L>
    </Level>
    <Level Id="Kevin 1280" Width="8" Height="9">
      <L>####</L>
      <L>#  ###</L>
      <L>#    ###</L>
      <L># ..*. #</L>
      <L>## #@# #</L>
      <L> #  $$ #</L>
      <L> # $ # #</L>
      <L> ###   #</L>
      <L>   #####</L>
    </Level>
    <Level Id="Kevin 1281" Width="11" Height="9">
      <L>  ########</L>
      <L>###      #</L>
      <L>#  $ $ $ #</L>
      <L># #$#@#$###</L>
      <L>#   ***   #</L>
      <L>## #... # #</L>
      <L> # #.*.   #</L>
      <L> #   ######</L>
      <L> #####</L>
    </Level>
    <Level Id="Kevin 1282" Width="11" Height="9">
      <L>    #####</L>
      <L>    #   #</L>
      <L>    # # #</L>
      <L>  ###  $##</L>
      <L>###.*....##</L>
      <L>#   # # $ #</L>
      <L># $@$  $  #</L>
      <L>########  #</L>
      <L>       ####</L>
    </Level>
    <Level Id="Kevin 1283" Width="10" Height="10">
      <L>#######</L>
      <L>#     #</L>
      <L># ### ##</L>
      <L># ###$ ###</L>
      <L># #    $ #</L>
      <L># # #$ $ #</L>
      <L># # .....#</L>
      <L># ## ##$ #</L>
      <L>#    ##@##</L>
      <L>#########</L>
    </Level>
    <Level Id="Kevin 1284" Width="8" Height="8">
      <L>   #####</L>
      <L>   # @ #</L>
      <L> ###$$$#</L>
      <L> #   $ #</L>
      <L>##  #..#</L>
      <L>#  $#..#</L>
      <L>#    *.#</L>
      <L>########</L>
    </Level>
    <Level Id="Kevin 1285" Width="9" Height="10">
      <L>  ######</L>
      <L>###  . #</L>
      <L>#  . # #</L>
      <L># #  .$##</L>
      <L>#  .    #</L>
      <L>### $*# #</L>
      <L>  ###@$ #</L>
      <L>    #$# #</L>
      <L>    #   #</L>
      <L>    #####</L>
    </Level>
    <Level Id="Kevin 1286" Width="8" Height="13">
      <L>  ####</L>
      <L> ## @##</L>
      <L>## $$ #</L>
      <L>#...  #</L>
      <L>#...# #</L>
      <L>#.*#  #</L>
      <L>##  $##</L>
      <L>#  $$ ##</L>
      <L>#  $   #</L>
      <L># $  # #</L>
      <L>#### # #</L>
      <L>   #   #</L>
      <L>   #####</L>
    </Level>
    <Level Id="Kevin 1287" Width="9" Height="10">
      <L> ######</L>
      <L> #@   #</L>
      <L> #.## #</L>
      <L>## .# #</L>
      <L># $$*$#</L>
      <L>#    .##</L>
      <L>## $ $.##</L>
      <L> ###   .#</L>
      <L>   #  ###</L>
      <L>   ####</L>
    </Level>
    <Level Id="Kevin 1288" Width="11" Height="9">
      <L>   #######</L>
      <L>   #     #</L>
      <L>#### ### ##</L>
      <L>#  ..#    #</L>
      <L># # ##$$# #</L>
      <L>#  $ .*@$ #</L>
      <L># # # #$###</L>
      <L>#  ..   #</L>
      <L>#########</L>
    </Level>
    <Level Id="Kevin 1289" Width="9" Height="12">
      <L>  #######</L>
      <L>  #     #</L>
      <L>### ### #</L>
      <L>#  $$ # #</L>
      <L># $$  # #</L>
      <L>#     # #</L>
      <L># .$. # #</L>
      <L>##*#.## #</L>
      <L> #+#.## #</L>
      <L> ### #  #</L>
      <L>   #   ##</L>
      <L>   #####</L>
    </Level>
    <Level Id="Kevin 1290" Width="13" Height="7">
      <L>#############</L>
      <L>#   . . .   #</L>
      <L># #$#$#$# # #</L>
      <L>#  $+$  .   #</L>
      <L># #$#$#$#####</L>
      <L>#   . . .#</L>
      <L>##########</L>
    </Level>
    <Level Id="Kevin 1291" Width="9" Height="9">
      <L>#####</L>
      <L>#   #####</L>
      <L>#  .    #</L>
      <L># ##$#  #</L>
      <L># #@ # ##</L>
      <L>#  *$# #</L>
      <L>###.   #</L>
      <L>  ###  #</L>
      <L>    ####</L>
    </Level>
    <Level Id="Kevin 1292" Width="10" Height="10">
      <L> #######</L>
      <L> #    @#</L>
      <L>## $ #$#</L>
      <L># $ $  #</L>
      <L># ## # ###</L>
      <L># #  # $ #</L>
      <L># # $..# #</L>
      <L>#  ##..  #</L>
      <L>##   ..###</L>
      <L> #######</L>
    </Level>
    <Level Id="Kevin 1293" Width="9" Height="11">
      <L> #####</L>
      <L> #  @#</L>
      <L>## #$#</L>
      <L># $  ##</L>
      <L># ##  #</L>
      <L>#   .$#</L>
      <L>## *..###</L>
      <L> ## . $ #</L>
      <L>  #  ## #</L>
      <L>  ##    #</L>
      <L>   ######</L>
    </Level>
    <Level Id="Kevin 1294" Width="9" Height="7">
      <L>    #####</L>
      <L>   ##.  #</L>
      <L>#### *  #</L>
      <L>#  $.*  #</L>
      <L>#@$ .$$ #</L>
      <L>### .  ##</L>
      <L>  ######</L>
    </Level>
    <Level Id="Kevin 1295" Width="13" Height="12">
      <L>  ########</L>
      <L>###      #</L>
      <L>#   #### #</L>
      <L># #  $@# ####</L>
      <L>#   ##.$    #</L>
      <L>###$# . #$# #</L>
      <L>#   #.#.$ $ #</L>
      <L>#   $*#.# ###</L>
      <L>### # . # #</L>
      <L>  #   .#  #</L>
      <L>  ####   ##</L>
      <L>     #####</L>
    </Level>
    <Level Id="Kevin 1296" Width="9" Height="10">
      <L> #######</L>
      <L>##     ##</L>
      <L>#  .$.$ #</L>
      <L># *# #. #</L>
      <L># $ @ $ #</L>
      <L>##.# #. #</L>
      <L> # *$*  #</L>
      <L> ##    ##</L>
      <L>  #  ###</L>
      <L>  ####</L>
    </Level>
    <Level Id="Kevin 1297" Width="11" Height="9">
      <L> ####</L>
      <L> #  ###</L>
      <L>##$ $ ####</L>
      <L># $  $...##</L>
      <L>#@$  #... #</L>
      <L># $  $... #</L>
      <L>##$ $ ##  #</L>
      <L> #  #######</L>
      <L> ####</L>
    </Level>
    <Level Id="Kevin 1298" Width="9" Height="8">
      <L>  #######</L>
      <L>###.. $ #</L>
      <L># $ # # #</L>
      <L># #  .. #</L>
      <L>#  $# # #</L>
      <L>###.*$$ #</L>
      <L>  #  @###</L>
      <L>  #####</L>
    </Level>
    <Level Id="Kevin 1299" Width="8" Height="11">
      <L>  ######</L>
      <L>  #    #</L>
      <L>  #  # #</L>
      <L> ## $  #</L>
      <L> #+*.$##</L>
      <L>##**. #</L>
      <L>#  # ##</L>
      <L>#    #</L>
      <L>## $ #</L>
      <L> ##  #</L>
      <L>  ####</L>
    </Level>
    <Level Id="Kevin 1300" Width="8" Height="9">
      <L>  #####</L>
      <L>  #  @#</L>
      <L>### #$##</L>
      <L>#..*...#</L>
      <L># $$# ##</L>
      <L>#   $ #</L>
      <L>#$#   #</L>
      <L>#     #</L>
      <L>#######</L>
    </Level>
  </LevelCollection>
</SokobanLevels>
