<?xml version="1.0" encoding="utf-8"?>
<SokobanLevels xmlns:xsi="http://www.w3.org/2001/XMLSchema-instance" xsi:schemaLocation="SokobanLev.xsd">
  <Title>Kos</Title>
  <Description>

  </Description>
  <LevelCollection Copyright="Konstantinos Bozeberg" MaxWidth="16" MaxHeight="14">
    <Level Id="Level 1" Width="15" Height="12">
      <L>          ####</L>
      <L>          #  #</L>
      <L>     ######  #</L>
      <L>    ## $ $  $#</L>
      <L>    #@$      ##</L>
      <L>  ##### # $   #</L>
      <L>### ..#$####  #</L>
      <L>#   .#  #  #  #</L>
      <L># ...#  $$ #$ #</L>
      <L>#.#.    #  $  #</L>
      <L>#. .    #     #</L>
      <L>###############</L>
    </Level>
    <Level Id="Level 2" Width="16" Height="14">
      <L>  ##############</L>
      <L>  #      .. #  #</L>
      <L>  #    $ ......#</L>
      <L>  ####### ##.#.#</L>
      <L>   #  #   ##...#</L>
      <L>   #  # $ ##  ##</L>
      <L>   #$ #   #    #</L>
      <L>  ##  $  $$ $ ##</L>
      <L>  #   # $ #  ##</L>
      <L>###   # $@#  #</L>
      <L>#     $  $$ ##</L>
      <L># $## #   ###</L>
      <L>#     #   #</L>
      <L>###########</L>
    </Level>
    <Level Id="Level 3" Width="14" Height="11">
      <L> #############</L>
      <L> # .      $  #</L>
      <L> #..         #</L>
      <L> #.##### $   #</L>
      <L>##.#  @###$###</L>
      <L>#  #$ $ $    #</L>
      <L>#     $ $ $$ #</L>
      <L>#  #.##   $  #</L>
      <L>#. . .#   ####</L>
      <L>##.###.  ##</L>
      <L> ### #####</L>
    </Level>
    <Level Id="Level 4" Width="9" Height="13">
      <L>  #####</L>
      <L> ##   ##</L>
      <L>## .#. ##</L>
      <L>#  $$$  #</L>
      <L>##  $  ##</L>
      <L> ## . ##</L>
      <L>  ##+##</L>
      <L> ## $ ##</L>
      <L>##  .  ##</L>
      <L># .$.$. #</L>
      <L>##  $  ##</L>
      <L> ##   ##</L>
      <L>  #####</L>
    </Level>
    <Level Id="Level 5" Width="16" Height="11">
      <L>########</L>
      <L>#.#.##.##</L>
      <L>#. .....#</L>
      <L>#... #  #</L>
      <L>###  # #########</L>
      <L>#  $   $     $ #</L>
      <L># $ $#$@$#$    #</L>
      <L>## $   $ # $$  #</L>
      <L>#    #   #     #</L>
      <L>#######  #######</L>
      <L>      ####</L>
    </Level>
    <Level Id="Level 6" Width="11" Height="12">
      <L> #########</L>
      <L> #   #   #</L>
      <L> #  $#$$ #</L>
      <L>##       ##</L>
      <L>#   #$#   #</L>
      <L># #  .. # #</L>
      <L># . ..  . #</L>
      <L># # #.# # #</L>
      <L>##       ##</L>
      <L> # $$#$  #</L>
      <L> #  @#   #</L>
      <L> #########</L>
    </Level>
    <Level Id="Level 7" Width="8" Height="7">
      <L> #######</L>
      <L>##     #</L>
      <L>#  .## #</L>
      <L># $$$ .#</L>
      <L>#@$.   #</L>
      <L>#   #.##</L>
      <L>#######</L>
    </Level>
    <Level Id="Level 8" Width="12" Height="12">
      <L>   #######</L>
      <L>  ##  #  ##</L>
      <L>  #  $ $  #</L>
      <L>###  $    #</L>
      <L>#    #.#  #</L>
      <L>#  #  .  ###</L>
      <L>#  . .*. *@#</L>
      <L>#  # #.# ###</L>
      <L>#      $ ##</L>
      <L>###  $#$  #</L>
      <L>  ##  #  ##</L>
      <L>   #######</L>
    </Level>
    <Level Id="Level 9" Width="13" Height="12">
      <L>    #####</L>
      <L>    #   #</L>
      <L>    # # #</L>
      <L>  ###$# ####</L>
      <L>###     $  #</L>
      <L>#    ## ## #</L>
      <L>#  $.$ .#. ##</L>
      <L>####$##..*  #</L>
      <L>   #  #.#.  #</L>
      <L>   #@$   $ ##</L>
      <L>   ######  #</L>
      <L>        ####</L>
    </Level>
    <Level Id="Level 10" Width="8" Height="8">
      <L>########</L>
      <L>#  .#  #</L>
      <L>#      #</L>
      <L>#  $$#.#</L>
      <L>####   #</L>
      <L> # $.###</L>
      <L> #@  #</L>
      <L> #####</L>
    </Level>
    <Level Id="Level 11" Width="16" Height="12">
      <L> ###############</L>
      <L>##  #          #</L>
      <L>#  $  $  # # # #</L>
      <L>#  ## $  $ $  ##</L>
      <L>#   # #  $  # #</L>
      <L># # # # # # # #</L>
      <L>#...#   # #   #</L>
      <L>##.##   # #   #</L>
      <L>#.$.## ##$## ##</L>
      <L>#...  $     $@#</L>
      <L>#.  #   ###   #</L>
      <L>######### #####</L>
    </Level>
    <Level Id="Level 12" Width="10" Height="14">
      <L>      ####</L>
      <L>      #  #</L>
      <L>   ####  #</L>
      <L>   #    $#</L>
      <L>####  #..#</L>
      <L>#   $  ..#</L>
      <L># $#  #..#</L>
      <L>#     @ .#</L>
      <L>###$ # #.#</L>
      <L>#  $   $ #</L>
      <L>#  $##$###</L>
      <L>##       #</L>
      <L> #       #</L>
      <L> #########</L>
    </Level>
    <Level Id="Level 13" Width="7" Height="9">
      <L> ######</L>
      <L> #    #</L>
      <L>##$   #</L>
      <L># . * #</L>
      <L># $$#.#</L>
      <L># #@.##</L>
      <L>##   #</L>
      <L> #   #</L>
      <L> #####</L>
    </Level>
    <Level Id="Level 14" Width="13" Height="11">
      <L>##########</L>
      <L>#    #.#.####</L>
      <L>#   #.....  #</L>
      <L>#     . .#  #</L>
      <L>##### ###   #</L>
      <L>#           #</L>
      <L># $#  $ $   #</L>
      <L>#  # #$#$#$##</L>
      <L># $#  $ $  #</L>
      <L># @#       #</L>
      <L>############</L>
    </Level>
    <Level Id="Level 15" Width="9" Height="8">
      <L>  #######</L>
      <L> ##  #  #</L>
      <L> #   #$ #</L>
      <L> #$@$   #</L>
      <L> # $#   #</L>
      <L>## $ # ##</L>
      <L>#..... #</L>
      <L>########</L>
    </Level>
    <Level Id="Level 16" Width="7" Height="9">
      <L>#######</L>
      <L>#     #</L>
      <L># $.$ #</L>
      <L># .+. #</L>
      <L># $#$ #</L>
      <L># .$. #</L>
      <L># $.$ #</L>
      <L>#     #</L>
      <L>#######</L>
    </Level>
  </LevelCollection>
</SokobanLevels>
