<?xml version="1.0" encoding="utf-8"?>
<SokobanLevels xmlns:xsi="http://www.w3.org/2001/XMLSchema-instance" xsi:schemaLocation="SokobanLev.xsd">
  <Title>Learning Sokoban</Title>
  <Description>
38 levels from very easy to hard. I'm a 30 years-old boy from Spain.
Enjoy my levels!
  </Description>
  <Email>zararaul@yahoo.es</Email>
  <LevelCollection Copyright="Draku" MaxWidth="20" MaxHeight="19">
    <Level Id="1" Width="11" Height="11">
      <L>    ###</L>
      <L>    #.#</L>
      <L>    # #</L>
      <L>    # #</L>
      <L>#####$#####</L>
      <L>#.  $@$  .#</L>
      <L>#####$#####</L>
      <L>    # #</L>
      <L>    # #</L>
      <L>    #.#</L>
      <L>    ###</L>
    </Level>
    <Level Id="2" Width="20" Height="19">
      <L>####################</L>
      <L>#@$.#.$           .#</L>
      <L>## ###$######## # ##</L>
      <L> # #.$ # .... #   ##</L>
      <L> # #   # $$$$ ###$##</L>
      <L> # # #.#       .# ##</L>
      <L> # # ###      $## ##</L>
      <L> # # ##       $.# ##</L>
      <L> # # #. #     $## ##</L>
      <L> # # #$ #      .#  #</L>
      <L> # # # #  ######## #</L>
      <L> # # # .# #    #.$ #</L>
      <L> # # # $#   #  #.$ #</L>
      <L> # # #  ##$# $##.$ #</L>
      <L> # # $ .#.    .#.$ #</L>
      <L> # ############### #</L>
      <L> #$  $ $        .. #</L>
      <L> #.#               #</L>
      <L> ###################</L>
    </Level>
    <Level Id="3" Width="20" Height="17">
      <L>####################</L>
      <L>#     .###  ####*.##</L>
      <L>#     $#.$$ .### $##</L>
      <L>#.##  .##.$ .###  ##</L>
      <L>#     $ #    ###  ##</L>
      <L>##$                #</L>
      <L>#       #    #     #</L>
      <L># #######$######## #</L>
      <L># ..$   $@     $.# #</L>
      <L># ###   #$######## #</L>
      <L># ####### #        #</L>
      <L>#     #   # $.#  $ #</L>
      <L># $ $ # # ## #     #</L>
      <L>#  $  #   .#     ###</L>
      <L># $ $ ######    ####</L>
      <L>#     .....#. ######</L>
      <L>####################</L>
    </Level>
    <Level Id="4" Width="20" Height="19">
      <L>####################</L>
      <L>## ##############  #</L>
      <L>##@$.              #</L>
      <L>##$# #$###########.#</L>
      <L>## # # #############</L>
      <L>## # # #         ..#</L>
      <L>## # # # #### ######</L>
      <L>## # # #       $   #</L>
      <L>## # # ###### #### #</L>
      <L>## # # #  $        #</L>
      <L>## # # # #### ######</L>
      <L>## # # #           #</L>
      <L>## #$# ##########  #</L>
      <L>## #   .#.....  #  #</L>
      <L>## # #  #$$$$$#   $#</L>
      <L>#  # ## #.....  #  #</L>
      <L>#    .# #$$$$$# #  #</L>
      <L>#######         $..#</L>
      <L>      ##############</L>
    </Level>
    <Level Id="5" Width="20" Height="19">
      <L>####################</L>
      <L># ...           ...#</L>
      <L># $  # $ $ $       #</L>
      <L>#  $ #             #</L>
      <L>#   $# #############</L>
      <L>#    # #   # #   # #</L>
      <L># #### # # # $ $ $ #</L>
      <L>#    # # # # . . . #</L>
      <L>#### #   # # # . . #</L>
      <L>#### ##### # # # . #</L>
      <L>#.      .# # # # # #</L>
      <L>#   $    # #   # # #</L>
      <L># ## ##  # #     # #</L>
      <L># ## ##  # #       #</L>
      <L>#$  $  $ # #       #</L>
      <L># ## ##  # # $ $ $ #</L>
      <L># ## ##  # ## # ####</L>
      <L>#.  @   .#         #</L>
      <L>####################</L>
    </Level>
    <Level Id="6" Width="19" Height="17">
      <L>###################</L>
      <L>###################</L>
      <L>######  ####  #####</L>
      <L>####            ###</L>
      <L>#### .        . ###</L>
      <L>####.#$######$#.###</L>
      <L>#### $   .    $ ###</L>
      <L>#### #   $  $ # ###</L>
      <L>#### # .$@$.. # ###</L>
      <L>#### #   $    # ###</L>
      <L>#### $   .    $ ###</L>
      <L>####.#$######$#.###</L>
      <L>#### .        . ###</L>
      <L>####            ###</L>
      <L>######  ####  #####</L>
      <L>###################</L>
      <L>###################</L>
    </Level>
    <Level Id="7" Width="19" Height="17">
      <L>###################</L>
      <L>#                 #</L>
      <L>#  ######.  ####  #</L>
      <L>#  #.    #    .#  #</L>
      <L>#  #           #  #</L>
      <L>#  #  ### ###  #  #</L>
      <L>#  #  #  $  #  #  #</L>
      <L>#     # $ $ #     #</L>
      <L>#  .#  $ @ $  #.  #</L>
      <L>#  ## # $ $ # ##  #</L>
      <L>#  #  #  $  #  #  #</L>
      <L>#  #  ### ###  #  #</L>
      <L>#  #           #  #</L>
      <L>#  #.    #    .#  #</L>
      <L>#  ####  .######  #</L>
      <L>#                 #</L>
      <L>###################</L>
    </Level>
    <Level Id="8" Width="19" Height="17">
      <L>###################</L>
      <L>###################</L>
      <L>##### ###### ######</L>
      <L>#### #      # #####</L>
      <L>### #  $   $ # ####</L>
      <L>####  $ ### $ # ###</L>
      <L>#### $  ...  $ ####</L>
      <L>####    ... #  ####</L>
      <L>####  # ...    ####</L>
      <L>#### $  .+.  $ ####</L>
      <L>### # $ ### $  ####</L>
      <L>#### # $   $  # ###</L>
      <L>##### #      # ####</L>
      <L>###### ###### #####</L>
      <L>###################</L>
      <L>###################</L>
      <L>###################</L>
    </Level>
    <Level Id="9" Width="19" Height="17">
      <L>###################</L>
      <L>###################</L>
      <L>###################</L>
      <L>###################</L>
      <L>########      #####</L>
      <L>######## #### #####</L>
      <L>#######. .#.# #####</L>
      <L>########$$$   #####</L>
      <L>#####  .$@$.#######</L>
      <L>##### ##$$$   #####</L>
      <L>##### #. . .# #####</L>
      <L>#####    # ## #####</L>
      <L>##########    #####</L>
      <L>###################</L>
      <L>###################</L>
      <L>###################</L>
      <L>###################</L>
    </Level>
    <Level Id="10" Width="19" Height="17">
      <L>###################</L>
      <L>###################</L>
      <L>###################</L>
      <L>###################</L>
      <L>###            ####</L>
      <L>###  ########  ####</L>
      <L>###  #.    .#  ####</L>
      <L>### .# $ *  #. ####</L>
      <L>##@  *  * $ $  ####</L>
      <L>###  # * $  #  ####</L>
      <L>###  #  * $ #  ####</L>
      <L>###  # $ *  #  ####</L>
      <L>###  #  $ * #  ####</L>
      <L>###  # $ *  #  ####</L>
      <L>### .#.    .#. ####</L>
      <L>###  ########  ####</L>
      <L>###################</L>
    </Level>
    <Level Id="11" Width="20" Height="19">
      <L>####################</L>
      <L>#.#        #  #    #</L>
      <L># ##  #    #       #</L>
      <L># #     # ## # #   #</L>
      <L># #  #   # #     # #</L>
      <L># #    #   # ### # #</L>
      <L># #  #   # # #   # #</L>
      <L># # #      # # # ###</L>
      <L># #    #   # #     #</L>
      <L># #  #   #     #   #</L>
      <L># # #      # # ##  #</L>
      <L># #   ## # # #     #</L>
      <L># #    #     # #   #</L>
      <L># # # #    # ### # #</L>
      <L># #      #     #   #</L>
      <L># #  ##### #  ## $ #</L>
      <L>#    #     #  ##   #</L>
      <L>#    # # # ##### @ #</L>
      <L>####################</L>
    </Level>
    <Level Id="12" Width="20" Height="19">
      <L>####################</L>
      <L>## $     .##########</L>
      <L>## ## ##############</L>
      <L>## #.     #        #</L>
      <L>## #  #   #    # # #</L>
      <L>## #  #   #   $#.# #</L>
      <L>##.$  #   #    # # #</L>
      <L>## #  #        # # #</L>
      <L>## #  # ###### # # #</L>
      <L>#  #  #          # #</L>
      <L>#  #  # $@$  # # # #</L>
      <L>##.$  #      #   # #</L>
      <L>## #  #      ## $# #</L>
      <L>#  #  ###### #   # #</L>
      <L>#.* $ #   #     #  #</L>
      <L>## #.        # .$  #</L>
      <L>##  ##### ## ### .##</L>
      <L>###       ##########</L>
      <L>####################</L>
    </Level>
    <Level Id="13" Width="19" Height="18">
      <L>###################</L>
      <L>######### .########</L>
      <L>#########$ ########</L>
      <L>#######     #######</L>
      <L>####### $#. #######</L>
      <L>####### . $ #######</L>
      <L>####### $#. #######</L>
      <L>####### . $ #######</L>
      <L>##### $ $@. $ #####</L>
      <L>#####.  . $  .#####</L>
      <L>####### $#. #######</L>
      <L>####### . $ #######</L>
      <L>####### $#. #######</L>
      <L>####### . $ #######</L>
      <L>###################</L>
      <L>###################</L>
      <L>###################</L>
      <L>###################</L>
    </Level>
    <Level Id="14" Width="19" Height="17">
      <L>###################</L>
      <L>##       .       ##</L>
      <L>## #### $ $ #### ##</L>
      <L>##$#### ### ####$##</L>
      <L>## #### ### #### ##</L>
      <L>## ###       ### ##</L>
      <L>#      . # .      #</L>
      <L>#  ###  $ $  ###  #</L>
      <L>#  ### # @ # ###  #</L>
      <L>#       $ $       #</L>
      <L>## ### . # . ### ##</L>
      <L>## ###       ### ##</L>
      <L>## #### # # #### ##</L>
      <L>##$#### # # ####$##</L>
      <L>## ####     #### ##</L>
      <L>##     .....     ##</L>
      <L>###################</L>
    </Level>
    <Level Id="15" Width="20" Height="17">
      <L>####################</L>
      <L>####################</L>
      <L>####################</L>
      <L>#..# #   #   #    .#</L>
      <L>#..$ # # #         #</L>
      <L># $# # # #### ## # #</L>
      <L>## $ $  $## # ## #$#</L>
      <L>#   .#   ##   #.   #</L>
      <L># ####  $@ $  #### #</L>
      <L>#   .#   ##  ##.   #</L>
      <L>#$# ## # ##$  $ $ ##</L>
      <L># # ## #### # # #$ #</L>
      <L>#         # # # $..#</L>
      <L>#.    #   #   # #..#</L>
      <L>####################</L>
      <L>####################</L>
      <L>####################</L>
    </Level>
    <Level Id="16" Width="19" Height="17">
      <L>###################</L>
      <L>#####   ####  #####</L>
      <L>##### .  $   .   ##</L>
      <L>#####  #.####  # ##</L>
      <L>###### # .###.## ##</L>
      <L>######$#  .##    ##</L>
      <L>###### #$$$.#$ # ##</L>
      <L>###### #  $ . #  ##</L>
      <L>###### ##@$$$.  ###</L>
      <L>###### ##   $ .####</L>
      <L>###  # ## #.$$$####</L>
      <L>##     ## ##.  ####</L>
      <L>#   #$       . ####</L>
      <L>#  .  ########.####</L>
      <L>###################</L>
      <L>###################</L>
      <L>###################</L>
    </Level>
    <Level Id="17" Width="20" Height="19">
      <L>####################</L>
      <L>##.$   $         ..#</L>
      <L>#.  $   #########  #</L>
      <L>## ### #.######### #</L>
      <L>#  #     ######### #</L>
      <L># ##$### ######### #</L>
      <L># ## ###     .#### #</L>
      <L>#    #.#$# ## #### #</L>
      <L>## #. $    ## $ ## #</L>
      <L>##  ## ### #. $ ## #</L>
      <L>#.#        ##.$  $.#</L>
      <L># ####$$ #   .## # #</L>
      <L>#$##     # ##    # #</L>
      <L>#.   . .## ####### #</L>
      <L># # # # ## ##### $ #</L>
      <L># $    .## ##### # #</L>
      <L>#$#$# ####         #</L>
      <L>#@$  .$.############</L>
      <L>####################</L>
    </Level>
    <Level Id="18" Width="20" Height="19">
      <L>####################</L>
      <L>#.#..   $   $      #</L>
      <L>#.# #     ### #### #</L>
      <L># ###  #         # #</L>
      <L># #.#  ## ### ##$#$#</L>
      <L># # #   #  #   # # #</L>
      <L>#      #    #      #</L>
      <L>#$# #  .#  # # # # #</L>
      <L># # # #$# ## . # # #</L>
      <L># #$# #  @.#   # # #</L>
      <L># # ##  ####   ###$#</L>
      <L># # # # .  #   #.# #</L>
      <L>#   $   $  .#$     #</L>
      <L># # #    #     # # #</L>
      <L>#$# ## ###### ##$# #</L>
      <L># # .    $       # #</L>
      <L># #### ###### ####.#</L>
      <L>#       $        ..#</L>
      <L>####################</L>
    </Level>
    <Level Id="20" Width="19" Height="17">
      <L>###################</L>
      <L>###################</L>
      <L>###################</L>
      <L>####### # #   #####</L>
      <L>###### # # #  #####</L>
      <L>##### #     $ .####</L>
      <L>#### #  $ $  # ####</L>
      <L>###  ..# $ # $ ####</L>
      <L>##  ...  @#  # ####</L>
      <L>###  .###$ # $ ####</L>
      <L>## # #  $ $  #.####</L>
      <L>### #.$   #   #####</L>
      <L>#####.$$$$ $$$#####</L>
      <L>##### ....#...#####</L>
      <L>###################</L>
      <L>###################</L>
      <L>###################</L>
    </Level>
    <Level Id="21" Width="19" Height="17">
      <L>###################</L>
      <L>###################</L>
      <L>###################</L>
      <L>######.##.##.######</L>
      <L>######$##$##$######</L>
      <L>####.$.  .  .$.####</L>
      <L>###### #   # ######</L>
      <L>######  $$$  ######</L>
      <L>####.$.#$@$#.$.####</L>
      <L>######  $$$  ######</L>
      <L>###### #   # ######</L>
      <L>####.$.  .  .$.####</L>
      <L>######$##$##$######</L>
      <L>######.##.##.######</L>
      <L>###################</L>
      <L>###################</L>
      <L>###################</L>
    </Level>
    <Level Id="22" Width="20" Height="19">
      <L>####################</L>
      <L># ##### .. ######..#</L>
      <L># #...#  $ #. $ # .#</L>
      <L>#     .$ .      # $#</L>
      <L>#$#  ##  $ #$   #  #</L>
      <L># #   ### ##    #  #</L>
      <L># #.#    $  $ $ #$ #</L>
      <L># #    ## ##    #  #</L>
      <L># #   #.  .##   #$ #</L>
      <L>#.## ##  @ ### ##  #</L>
      <L>#   $    .    $    #</L>
      <L># ## ###   ### ##  #</L>
      <L>#      #$ $#    #  #</L>
      <L># # $  # $ #   .#  #</L>
      <L># #..$ #$ $#   $   #</L>
      <L># # $. #   #. $.#  #</L>
      <L># ######. .###### $#</L>
      <L>#   $    .        .#</L>
      <L>####################</L>
    </Level>
    <Level Id="23" Width="20" Height="19">
      <L>####################</L>
      <L>#######  #.$.$.$.$ #</L>
      <L>##.$. $  #.$.$.$.$ #</L>
      <L>##    #   # .$.$.$ #</L>
      <L>##.$.$#   ##.$.$.$ #</L>
      <L>##$.$.  ####  .$.$ #</L>
      <L>##  # # #### #.$.$ #</L>
      <L>####### ##   ## .$ #</L>
      <L># .####         .$ #</L>
      <L>#.$ #############  #</L>
      <L>#$   ############# #</L>
      <L>#.$.  #####        #</L>
      <L>#$.$.  #### ########</L>
      <L>#. .$.  #    $ ..###</L>
      <L>#$.$.$.   # ###$..##</L>
      <L>#.$.$.$. ##   # $.##</L>
      <L>#$ $ $ $      # $$##</L>
      <L>#.     $ @         #</L>
      <L>####################</L>
    </Level>
    <Level Id="24" Width="19" Height="18">
      <L>###################</L>
      <L>######          ###</L>
      <L>#   $    $..### ###</L>
      <L># $ #####$..  # ###</L>
      <L>#   $  $  ..    ###</L>
      <L>##### #### ### ####</L>
      <L>####  .$.......####</L>
      <L>##   # #$$#$#  ####</L>
      <L>## #$#  $ @  $ ####</L>
      <L>##   # # # ##  ####</L>
      <L>#### # #$# ###$####</L>
      <L>#### #$#.# ### ####</L>
      <L>#. $ # ## $ ## ####</L>
      <L>#.   .  $     .####</L>
      <L>###################</L>
      <L>###################</L>
      <L>###################</L>
      <L>###################</L>
    </Level>
    <Level Id="25" Width="20" Height="19">
      <L>####################</L>
      <L>########. ##########</L>
      <L># $              $ #</L>
      <L># .  #     #     . #</L>
      <L>#  ##### ##### ##  #</L>
      <L>#  ##### ##### ##  #</L>
      <L>#  #####$##### ### #</L>
      <L>#  ##### ##### ##  #</L>
      <L>#  ##### ###   ##  #</L>
      <L>#.   $    ## # ##  #</L>
      <L>#  ######@  $     .#</L>
      <L>#  #####  # ## ##  #</L>
      <L>#  ##### $  ## ##  #</L>
      <L>#  ###### #    ### #</L>
      <L>#  ###### #### ##  #</L>
      <L># .   #     #    . #</L>
      <L># $              $ #</L>
      <L>#########. #########</L>
      <L>####################</L>
    </Level>
    <Level Id="26" Width="20" Height="19">
      <L>####################</L>
      <L>#..      $      $..#</L>
      <L>## ####### ###### ##</L>
      <L># $ #   #   #   #  #</L>
      <L># $       $        #</L>
      <L>#  .#   #   #   #  #</L>
      <L>## ############## $#</L>
      <L>#    $.$.  $.$.  $.#</L>
      <L>#   $. $. $. $. $. #</L>
      <L>#  $.  $.$.  $.$.  #</L>
      <L>## ############### #</L>
      <L># $ . . . . . .. . #</L>
      <L># $$$$$$$$$$$$$.  .#</L>
      <L>#  . .$. . . . .   #</L>
      <L># ###############$##</L>
      <L>#  .#  .#  .#  .#  #</L>
      <L># $$ .$$ .$$ .$$ . #</L>
      <L>#@  #   #   #   #  #</L>
      <L>####################</L>
    </Level>
    <Level Id="27" Width="20" Height="19">
      <L>####################</L>
      <L>#.$               .#</L>
      <L>#  ####### ##### #$#</L>
      <L># #.$           .# #</L>
      <L># # ############$# #</L>
      <L># # #.$       .# # #</L>
      <L># # # #.# # ##$# # #</L>
      <L># # # # #   ## # # #</L>
      <L># # # # ###### # # #</L>
      <L>#     # #####  #   #</L>
      <L># # # #$      .# # #</L>
      <L># # #   ######## # #</L>
      <L># # # #.       $ # #</L>
      <L>#   #$########## # #</L>
      <L># #  .         $.  #</L>
      <L># #$############## #</L>
      <L>#$#.             $.#</L>
      <L>#@#                #</L>
      <L>####################</L>
    </Level>
    <Level Id="28" Width="19" Height="18">
      <L>###################</L>
      <L>#                ##</L>
      <L>#    $ $....$ $  ##</L>
      <L># #              ##</L>
      <L># #  ##########  ##</L>
      <L># #  .        .  ##</L>
      <L># # ###$###$#### ##</L>
      <L># #..   $ $    ..##</L>
      <L># ### ### #########</L>
      <L># $  .  $@$  .  $ #</L>
      <L># ####### ### ### #</L>
      <L># #               #</L>
      <L># # ######### ## ##</L>
      <L>#           $.$. ##</L>
      <L>#   $.$.$.$.$.$.###</L>
      <L># #$.$.$.$.$.$.$.##</L>
      <L>#   ###############</L>
      <L>###################</L>
    </Level>
    <Level Id="29" Width="20" Height="19">
      <L>####################</L>
      <L>#  $          ..# .#</L>
      <L>#    # #######  # $#</L>
      <L>#  @ #.        $#  #</L>
      <L>## # # #  $ $...#. #</L>
      <L>##$# # #$##### $# ##</L>
      <L>## # # #.    $ .#$.#</L>
      <L>## # #$# # $ ...# .#</L>
      <L>## # # #$# ######$$#</L>
      <L>#    # # #$#       #</L>
      <L># ## # # # #       #</L>
      <L># .# #   # # ####. #</L>
      <L>#  # # $.# # ####$ #</L>
      <L>#  # #     # ####  #</L>
      <L># $# ####### ####  #</L>
      <L>#            ####  #</L>
      <L>#.$ #            . #</L>
      <L>#     $     .      #</L>
      <L>####################</L>
    </Level>
    <Level Id="30" Width="19" Height="18">
      <L>###################</L>
      <L>#...$..  .   ##   #</L>
      <L># # . $ . ## ##  $#</L>
      <L># $$#$.  $## ## $.#</L>
      <L>#     #   ## ## # #</L>
      <L># $$$$$$ @      $.#</L>
      <L>#     #   ##      #</L>
      <L># $ # .  $##$ # $.#</L>
      <L># #$.$$ . ## $# # #</L>
      <L>#...$..  .##$.# $.#</L>
      <L># ###### ###. ###.#</L>
      <L># $       ##$.  # #</L>
      <L>## # # #   #.$# # #</L>
      <L>## #.# # # # .  # #</L>
      <L>## # # # # # #### #</L>
      <L>## $ $ $ $    ....#</L>
      <L>####  #############</L>
      <L>###################</L>
    </Level>
    <Level Id="31" Width="19" Height="17">
      <L>###################</L>
      <L>###################</L>
      <L>###################</L>
      <L>########   ########</L>
      <L>#######.. ..#######</L>
      <L>#######$ $ $#######</L>
      <L>#####   . .   #####</L>
      <L>##### ## # ## #####</L>
      <L>#####   $ $   #####</L>
      <L>##### #$ . $# #####</L>
      <L>#####  .$#$.  #####</L>
      <L>########   ########</L>
      <L>#########@#########</L>
      <L>###################</L>
      <L>###################</L>
      <L>###################</L>
      <L>###################</L>
    </Level>
    <Level Id="32" Width="20" Height="19">
      <L>####################</L>
      <L>#     #.##  ##    .#</L>
      <L>#$      ## $##  ####</L>
      <L>#     # ##  ###$####</L>
      <L>#.    #     $     ##</L>
      <L>## #### ## .#.  $ ##</L>
      <L>##.####    #########</L>
      <L>## #######$####  ###</L>
      <L># $ ###.$.  ### $###</L>
      <L>#@ $ .    . ###  ###</L>
      <L>##$######$#####  ###</L>
      <L>## #   ## .#### .###</L>
      <L>##.# # ##  ####$####</L>
      <L>#. #       $      ##</L>
      <L>#$ ### ## $##.  $  #</L>
      <L>#  #.  ##  #### ####</L>
      <L>#  #$#  ###   $  .##</L>
      <L>#  #.   ###   #.####</L>
      <L>####################</L>
    </Level>
    <Level Id="33" Width="19" Height="17">
      <L>###################</L>
      <L>###################</L>
      <L>####           ####</L>
      <L>####           ####</L>
      <L>####  .......  ####</L>
      <L>####  $$$$$$$  ####</L>
      <L>####  $.....$  ####</L>
      <L>####  $.$$$.$  ####</L>
      <L>#### .$.$@$.$. ####</L>
      <L>####  $.$$$.$  ####</L>
      <L>####  $.....$  ####</L>
      <L>####  $$$$$$$  ####</L>
      <L>####  .......  ####</L>
      <L>####           ####</L>
      <L>####           ####</L>
      <L>###################</L>
      <L>###################</L>
    </Level>
    <Level Id="34" Width="11" Height="11">
      <L>###########</L>
      <L>#.   . . .#</L>
      <L>#    #    #</L>
      <L># $ $#$ $ #</L>
      <L>#    #    #</L>
      <L>#.###@###.#</L>
      <L>#   $ $   #</L>
      <L># $  #  $ #</L>
      <L>#  $ # $  #</L>
      <L>#. . .   .#</L>
      <L>###########</L>
    </Level>
    <Level Id="35" Width="19" Height="18">
      <L>###################</L>
      <L>#.      .#.#.  #..#</L>
      <L>#  #$#$# # #.$.#  #</L>
      <L>#.$ .$  .#        #</L>
      <L>#  # # # #$#$#$#$ #</L>
      <L>#   $  #     #    #</L>
      <L>#### ########### $#</L>
      <L>####              #</L>
      <L>#########@####### #</L>
      <L>#.        # $.#.$ #</L>
      <L># ###$$$$   # # # #</L>
      <L>#         #.$ $ $.#</L>
      <L>#..###$$$ ### # # #</L>
      <L>#         #.$ . $.#</L>
      <L>#. .###$$   # # # #</L>
      <L>#         # $. .$ #</L>
      <L>#....###  #########</L>
      <L>###################</L>
    </Level>
    <Level Id="36" Width="20" Height="19">
      <L>####################</L>
      <L>#                $.#</L>
      <L># # ################</L>
      <L># #  .             #</L>
      <L># # # ##############</L>
      <L># # #. .         $ #</L>
      <L># # # # ########## #</L>
      <L># # # #. .       $ #</L>
      <L># # # # # ######## #</L>
      <L># # # # #.       $ #</L>
      <L># # # # # # ###### #</L>
      <L># # # # # # $     .#</L>
      <L># #$#$#$#$# ###### #</L>
      <L># #.#              #</L>
      <L># ######### ########</L>
      <L>#.   . $    $  $  ##</L>
      <L>### # #####       ##</L>
      <L>#@  # $  .#.########</L>
      <L>####################</L>
    </Level>
    <Level Id="37" Width="19" Height="17">
      <L>###################</L>
      <L>###################</L>
      <L>#######     #######</L>
      <L>#####  $### #######</L>
      <L>#####$  ### #######</L>
      <L>#####     $ #######</L>
      <L>###  $ $ ## #######</L>
      <L>### # ## ## #######</L>
      <L>#   # ## ## ##.$..#</L>
      <L># $  $    $ .*....#</L>
      <L>##### ### #@## $..#</L>
      <L>#####     # ## ####</L>
      <L>###########    ####</L>
      <L>###################</L>
      <L>###################</L>
      <L>###################</L>
      <L>###################</L>
    </Level>
    <Level Id="38" Width="19" Height="19">
      <L>###################</L>
      <L>############ @#####</L>
      <L>#                 #</L>
      <L># $   .#     $ # .#</L>
      <L># $   .#     $   .#</L>
      <L># $   #.     $ # .#</L>
      <L># $   #.     $ # .#</L>
      <L>#    #  ###### #  #</L>
      <L>#    #  #      #  #</L>
      <L>#   #   #      #  #</L>
      <L>#   #   #      #  #</L>
      <L># $#   .#      #  #</L>
      <L>#  #$  .#   ## #  #</L>
      <L># #  $ .  ##   #  #</L>
      <L># #$   .##   $ # .#</L>
      <L>#     ##     $   .#</L>
      <L>#   ## $   # $ # .#</L>
      <L>#.##       # $   .#</L>
      <L>###################</L>
    </Level>
  </LevelCollection>
</SokobanLevels>
