<?xml version="1.0" encoding="utf-8"?>
<SokobanLevels xmlns:xsi="http://www.w3.org/2001/XMLSchema-instance" xsi:schemaLocation="SokobanLev.xsd">
  <Title>MacTommy inventions</Title>
  <Description>
The MacTommy inventions collection.
  </Description>
  <LevelCollection Copyright="MacTommy" MaxWidth="27" MaxHeight="20">
    <Level Id="Level 1" Width="21" Height="13">
      <L>     ########</L>
      <L>     #      #</L>
      <L>######$ $ $$#</L>
      <L>#  #@#    $ ######</L>
      <L># $#  $ $ #   $  #</L>
      <L>#  # # ## $ #### ####</L>
      <L># $$ #$## # ###.....#</L>
      <L>#     $   $    .....#</L>
      <L>#  ### ## #####.....#</L>
      <L>#  $ # $ $#    .....#</L>
      <L># $# #### # # #$#####</L>
      <L>#               #</L>
      <L>#################</L>
    </Level>
    <Level Id="Level 2" Width="14" Height="13">
      <L>##############</L>
      <L>#       #    #</L>
      <L># $ $   $ $  #</L>
      <L>###### ##### #</L>
      <L>#... #   $ # #</L>
      <L>#... # $  $  #</L>
      <L>#..  #$#### ##</L>
      <L>#...     ## ##</L>
      <L>#... # #  $  #</L>
      <L>###### ##$ $ #</L>
      <L>  # @$ $ $   #</L>
      <L>  #    #     #</L>
      <L>  ############</L>
    </Level>
    <Level Id="Level 3" Width="15" Height="12">
      <L>    #####</L>
      <L>#####   #######</L>
      <L>#             #</L>
      <L># @##$##$ $ $ #</L>
      <L>#  ##  # $#$  #</L>
      <L>#####  #$   $ #</L>
      <L>    #$ #   $  #</L>
      <L>##### #### #$ #</L>
      <L>#..... ## $ $ #</L>
      <L>##....  $   $ #</L>
      <L>#......########</L>
      <L>########</L>
    </Level>
    <Level Id="Level 4" Width="19" Height="12">
      <L>############</L>
      <L>#    #     #</L>
      <L># $$$#$$$$ #</L>
      <L>#  $     $ #</L>
      <L># $$ #$ $$ ########</L>
      <L>#  $ #     #..#...#</L>
      <L>## ####### #..#...#</L>
      <L>#  $ #     #..#...#</L>
      <L>#    $ $  ##  ....#</L>
      <L># $ $#$$$     ....#</L>
      <L>#    #    ## @#####</L>
      <L>###############</L>
    </Level>
    <Level Id="Level 5" Width="21" Height="13">
      <L>#####</L>
      <L>#   ##########</L>
      <L># #$##       ########</L>
      <L>#      $    $     $ #</L>
      <L>############   $    #</L>
      <L>#..... ### $  $#@#$ #</L>
      <L>#.....    $ $$ ###  #</L>
      <L>#.....   #   $    $ #</L>
      <L>####### ####$####$  #</L>
      <L>     #  .# $ $      #</L>
      <L>     # ..#   $  $#$##</L>
      <L>     # ..#          #</L>
      <L>     ################</L>
    </Level>
    <Level Id="Level 6" Width="18" Height="11">
      <L>   ###############</L>
      <L>  ##             #</L>
      <L>### $####  $# $  #</L>
      <L>#.#..    $$@###  #</L>
      <L>#....# $# $$#  $ #</L>
      <L>#.#.##  # $ # $  #</L>
      <L>#..... $#$  #$####</L>
      <L>#.#.##  #  $  $  #</L>
      <L>#. ..#$$  $ #    #</L>
      <L>#      ##   #    #</L>
      <L>##################</L>
    </Level>
    <Level Id="Level 7" Width="20" Height="12">
      <L> ###################</L>
      <L> #@      ##   #    #</L>
      <L>#######$$ #    $ $ #</L>
      <L>#.#...#   # $ $# # #</L>
      <L>#.#..#   $##$ $    #</L>
      <L>#....     $   #  $ #</L>
      <L>#....    $###$##$###</L>
      <L>#.#..#    $    #   #</L>
      <L>#.#...##  #$   #$$ #</L>
      <L>########$ $  $ $   #</L>
      <L> #        #  # #   #</L>
      <L> ###################</L>
    </Level>
    <Level Id="Level 8" Width="14" Height="14">
      <L> #############</L>
      <L>##   #   #   #</L>
      <L>#  $   $     #</L>
      <L># $# $#$  $$##</L>
      <L>#       $ #@#</L>
      <L># $$#####$###</L>
      <L>### #...#  #</L>
      <L># $ #......#</L>
      <L># # #  $#..#</L>
      <L># $ #  $...#</L>
      <L># $ ## #...#</L>
      <L># $    #####</L>
      <L>#       #</L>
      <L>#########</L>
    </Level>
    <Level Id="Level 9" Width="23" Height="17">
      <L>##########   ##########</L>
      <L>#  #...  #####  ...#  #</L>
      <L>#  #...  ##@##  ...#  #</L>
      <L>#  #.#.         .#.#  #</L>
      <L># $#...  #   #  ...#$ #</L>
      <L>#  #...  ## ##  ...#  #</L>
      <L># $######## ########$ #</L>
      <L>#  $   $  # #  $   $  #</L>
      <L>#    $    #$#    $    #</L>
      <L>######## ## ## ########</L>
      <L>#     $  #   #  $     #</L>
      <L># $  $   $   $   $  $ #</L>
      <L>## ####### $ ####### ##</L>
      <L>#   $ $  #   #  $ $   #</L>
      <L>#    $ $ ## ## $ $    #</L>
      <L>#        #####        #</L>
      <L>##########   ##########</L>
    </Level>
    <Level Id="Level 10" Width="19" Height="18">
      <L>###################</L>
      <L>#  #..............#</L>
      <L># $#############..#</L>
      <L>#  #     ##### ...#</L>
      <L># $$   $$ # $  ...#</L>
      <L>#   $$#    $    #.#</L>
      <L># $   # $$ $$ ###.#</L>
      <L>### ###  $    # #.#</L>
      <L>#     # $ $ $ # #.#</L>
      <L># $ ####### #####.#</L>
      <L>###   #  $ $  #@#.#</L>
      <L>#     # $$ $ $# #.#</L>
      <L>#  #$ #  $      #.#</L>
      <L># $#  #  $$  $$ #.#</L>
      <L>#  #  #       # #.#</L>
      <L>#     ######### ###</L>
      <L>#                 #</L>
      <L>###################</L>
    </Level>
    <Level Id="Level 11" Width="19" Height="15">
      <L>###################</L>
      <L>#     #   #   #   #</L>
      <L># $ $ #$$ #$  $   #</L>
      <L>#  ##      $  # $ #</L>
      <L># ##  $ $$## ##$  #</L>
      <L># #  #$##     # $ #</L>
      <L># # # $ $$ # ###  #</L>
      <L>#@#  $  #  # $ ####</L>
      <L>####     #  $$ #  #</L>
      <L> ### ## $         #</L>
      <L> #..  ##   ########</L>
      <L> #...  ## ##  ...#</L>
      <L> #.#..        ...#</L>
      <L> #.....#####  ...#</L>
      <L> #######   #######</L>
    </Level>
    <Level Id="Level 12" Width="20" Height="13">
      <L>####################</L>
      <L>#                  #</L>
      <L># #$#$#   $    $ $ #</L>
      <L># $ $ $   ## ####  #</L>
      <L>#  $ $ $ ##....#   #</L>
      <L># $ $ $  #.....#   #</L>
      <L>#  $ $  ##....###$##</L>
      <L># # $$$ #...#.# $  #</L>
      <L>#  # # ##.....#    #</L>
      <L>##   # #### #### ###</L>
      <L> ####       #@# $  #</L>
      <L>    #       #      #</L>
      <L>    ################</L>
    </Level>
    <Level Id="Level 13" Width="17" Height="12">
      <L>#################</L>
      <L># ... .  #  . . #</L>
      <L>#.###$#$ # $# #.#</L>
      <L>#.# $ #@$## #$#.#</L>
      <L># $ # #$  #     #</L>
      <L>#$      $ # #$#$#</L>
      <L>#    ##$ ##$  $ #</L>
      <L># $ $#   #  # #.#</L>
      <L>#.#  # $   $   .#</L>
      <L>#.# $### ###$#$.#</L>
      <L># .. ... # . .  #</L>
      <L>#################</L>
    </Level>
    <Level Id="Level 14" Width="18" Height="16">
      <L>  ##########</L>
      <L>###@##.....#</L>
      <L>#    #.. ..#</L>
      <L># $####   ## #####</L>
      <L>#  ###..#..###   #</L>
      <L># $  $......##$# #</L>
      <L>#  ###......     #</L>
      <L>##    ### ### #$ #</L>
      <L>#  #$   #  $  #  #</L>
      <L>#  $ #$$  # $##$ #</L>
      <L>#  #   $$##$$ #  #</L>
      <L>## ###    $ # #$ #</L>
      <L># $ ## #### $ #  #</L>
      <L>#   $ $ $ $   $  #</L>
      <L>##          ##   #</L>
      <L> #################</L>
    </Level>
    <Level Id="Level 15" Width="18" Height="17">
      <L>   ########</L>
      <L>   #   #  #</L>
      <L>   #  $   #</L>
      <L> ### #$   ####</L>
      <L> #  $  ##$   #</L>
      <L> #  #   $ #$ ###</L>
      <L> #  #      $   ###</L>
      <L> ## ####$####$ $ #</L>
      <L> # $##.....##  # #</L>
      <L> #  ###...###$#  #</L>
      <L>##$    .#.       #</L>
      <L>#  $###...###$#  #</L>
      <L>#   ##.....##  # #</L>
      <L># $#####  ###  $ #</L>
      <L>##      $     #  #</L>
      <L># @#####  #####  #</L>
      <L>####   ####   ####</L>
    </Level>
    <Level Id="Level 16" Width="23" Height="17">
      <L>    ###################</L>
      <L>#####@       ##    #  #</L>
      <L>#   ##$  $ #   $    $ #</L>
      <L># $  #  ######  $ #   #</L>
      <L># $  #$##    ### ######</L>
      <L>#  $$ $    $        #</L>
      <L>###$ # $   #  $ #$  #</L>
      <L> #   ####  #  ##   ##</L>
      <L> #  $  ##.....##$  #</L>
      <L> #     #...#...#   #</L>
      <L> ##$#  $..###..  $##</L>
      <L>  #    #...#...#  #</L>
      <L>  # $$ #.......#  #</L>
      <L>  #  ###### ####$ #</L>
      <L>  #   $   $ $  $  #</L>
      <L>  #####       #####</L>
      <L>      #########</L>
    </Level>
    <Level Id="Level 17" Width="17" Height="16">
      <L>   ##########</L>
      <L>   #    #   #</L>
      <L>   # #    $ #</L>
      <L>   # $  # #######</L>
      <L> ###### # #     #</L>
      <L> # $        $   #</L>
      <L> # # #   ####  ##</L>
      <L> #   #   #  ## #</L>
      <L>#### ##      # ##</L>
      <L>#  $  #####  #  #</L>
      <L># # $  $  #  #$ #</L>
      <L>#  $  $   #  #  #</L>
      <L>##@# ## ###  ####</L>
      <L> ###    ##.....#</L>
      <L>   #######.....#</L>
      <L>         #######</L>
    </Level>
    <Level Id="Level 18" Width="19" Height="13">
      <L>      ###########</L>
      <L>      #  #  #   #</L>
      <L>      #    $    #</L>
      <L>     ## # $   $ ###</L>
      <L>######...##### #  #</L>
      <L>#  @#.#... #    $ #</L>
      <L># #$#..#.. $  #   #</L>
      <L>#   $ ..#.## #  ###</L>
      <L>#####  ## ## #   #</L>
      <L> ### $# # ##$ $  #</L>
      <L> # $  $ # $  # $##</L>
      <L> #               #</L>
      <L> #################</L>
    </Level>
    <Level Id="Level 19" Width="21" Height="13">
      <L>#####################</L>
      <L>#   #               #</L>
      <L># $ #  ####$###### ##</L>
      <L>## $  $             #</L>
      <L>## $   ### #$#$###$ #</L>
      <L>#  #  $  # # #      #</L>
      <L>#  #@#$#   # ##    ##</L>
      <L>## ###   # # #... ##</L>
      <L>#  $  #### # #.##.#</L>
      <L>#    $    $#  ....#</L>
      <L>####$   # $   .##.#</L>
      <L>#       #  #  ....#</L>
      <L>###################</L>
    </Level>
    <Level Id="Level 20" Width="24" Height="16">
      <L>    ##########</L>
      <L>#####        #########</L>
      <L>#     # $ $  #  #    #</L>
      <L># #######$####$ #$ $ #</L>
      <L># #    ## #  # $    ##</L>
      <L># # $     #$    #$ $ #</L>
      <L># # $  #     #  #    #</L>
      <L># #  ### ## $##########</L>
      <L># ###  #  #  ##       ##</L>
      <L># #   $#  #### .....#. #</L>
      <L># #$   $  $ #  .#.#... #</L>
      <L>#      # $ $   .###.#. #</L>
      <L>#####$####  #  .#.#.#. #</L>
      <L># $  $  $ $$ # ....... #</L>
      <L>#     #     @##       ##</L>
      <L>#######################</L>
    </Level>
    <Level Id="Level 21" Width="19" Height="16">
      <L>###################</L>
      <L>#       #         #</L>
      <L>#   $ $ #$ # $#   #</L>
      <L>## #### #  #$   $ #</L>
      <L>## #@## $     # $##</L>
      <L># $$$ $  $#   #   #</L>
      <L>#  # ## $ #########</L>
      <L>#  # ##  $ #  ##  #</L>
      <L>####  $$$  ...... #</L>
      <L># $  ##  #.##.##..#</L>
      <L># $#   $ #.#*.###.#</L>
      <L>#    #$  #.###.*#.#</L>
      <L>##  ##  $#..##.##.#</L>
      <L># $ $ #$   ...... #</L>
      <L>#        #  ##  # #</L>
      <L>###################</L>
    </Level>
    <Level Id="Level 22" Width="20" Height="17">
      <L>######</L>
      <L>#    #     ########</L>
      <L>#   $#######      #</L>
      <L>#  $  $       $$  ##</L>
      <L>##$   #$#     #    #</L>
      <L>#  $ ## ### ### #  #</L>
      <L># #  $  #.# #.# $  #</L>
      <L># ##   #..# #..#   #</L>
      <L># #   #...   ...#  #</L>
      <L># #   #...# #...#  #</L>
      <L># #   #         #$ #</L>
      <L>#  $ $#   ###   #  #</L>
      <L># $   #### @ #######</L>
      <L># $     $  $  $    #</L>
      <L>## ####### # ##### #</L>
      <L> #         #       #</L>
      <L> ###################</L>
    </Level>
    <Level Id="Level 23" Width="22" Height="14">
      <L>#####       ##########</L>
      <L>#   #########   ##   #</L>
      <L># $      $      $    #</L>
      <L>#  #### $#$ # ########</L>
      <L>#@##  ## # $#$ #     #</L>
      <L>##       $    $   $  #</L>
      <L>##.#..### #  ### #$$##</L>
      <L>#......#    $ #      #</L>
      <L>##.##.###$## ###$## ##</L>
      <L>#......#      #      #</L>
      <L>##..#.### $#$###  #$##</L>
      <L>##           $     $ #</L>
      <L>#   ###   #  #   #   #</L>
      <L>##### ################</L>
    </Level>
    <Level Id="Level 24" Width="25" Height="16">
      <L>##################</L>
      <L>#   #    ..#.#.. #####</L>
      <L>#  $#$   ..#.#..   $ #</L>
      <L># $$    #.......#  # ###</L>
      <L>## ##  ##.......##   $ #</L>
      <L>#      $ ##...## $$ #$ #</L>
      <L># $$# #   ##.##  # ##  #</L>
      <L># $ #  #   ####  $     #</L>
      <L>#       #$ ###      ##$#</L>
      <L>#####$      #  # ## #  #</L>
      <L>#   # ###   $ ## #  #  ##</L>
      <L>#   $   # $ #  $    $   #</L>
      <L>#   # $ #$$$ $#     #   #</L>
      <L>#####   #  #  $     #####</L>
      <L>    #   # @#  #  #  #</L>
      <L>    #################</L>
    </Level>
    <Level Id="Level 25" Width="19" Height="16">
      <L>#####  #####</L>
      <L>#   ####   #####</L>
      <L>#   #  #.......#</L>
      <L>#   # $#...#...#</L>
      <L>##$$#   .......#</L>
      <L>#   ## #####   ####</L>
      <L>#   #     ######  #</L>
      <L>##$ # $   # $     #</L>
      <L>#  $ #$$$$#       #</L>
      <L># #    #   $#$#$###</L>
      <L># # ## #$$$       #</L>
      <L># #    $     # #  #</L>
      <L># #   ##         ##</L>
      <L>#     ##$###$##   #</L>
      <L>#         @#      #</L>
      <L>###################</L>
    </Level>
    <Level Id="Level 26" Width="17" Height="13">
      <L> ################</L>
      <L> #  #           #</L>
      <L>##  # $#####@$$ #</L>
      <L>#  $#  #......  #</L>
      <L># $ #$$..#.#.####</L>
      <L>#  $#  #......#</L>
      <L>##  # $###  ###</L>
      <L> #$      #  $ #</L>
      <L> #  #  $$     #</L>
      <L>##$##### ##   #</L>
      <L>#  $   $      #</L>
      <L>#      ########</L>
      <L>########</L>
    </Level>
    <Level Id="Level 27" Width="25" Height="13">
      <L>########################</L>
      <L>#  #   #......#    #   #</L>
      <L># $# $ #......    ## # #</L>
      <L>#  #    ......#    #   #</L>
      <L>#  # ###......#  ####$ #</L>
      <L>#   $  ########  $  $  #</L>
      <L>#   #@ #  ##  #$# $ ##$##</L>
      <L># $# #$#$   $    # $    #</L>
      <L>#   #  #  #  # #$#  # $ #</L>
      <L>#   $    $ $$     $  $  #</L>
      <L>#      # $      ##$ #####</L>
      <L>###############    ##</L>
      <L>              ######</L>
    </Level>
    <Level Id="Level 28" Width="19" Height="17">
      <L>       #####</L>
      <L>      ##   ##</L>
      <L>    ###  $  ###</L>
      <L>   ##   $   $ ##</L>
      <L>  ##  $ $$  $  ##</L>
      <L> ## $ #..#.##   ##</L>
      <L>##   ##.....##$  ##</L>
      <L>#  $  ...#...   $ #</L>
      <L># $$$$#.#*#.#$$$$@#</L>
      <L>#   $ ...#... $   #</L>
      <L>##   ##.....## $ ##</L>
      <L> ## $ ##.#..# $ ##</L>
      <L>  ##   $ $ $   ##</L>
      <L>   ##   $ $   ##</L>
      <L>    ###  $  ###</L>
      <L>      ##   ##</L>
      <L>       #####</L>
    </Level>
    <Level Id="Level 29" Width="19" Height="16">
      <L>   #######   ###</L>
      <L>####     #####@####</L>
      <L>#    $          $ #</L>
      <L># $# ##$  #$  #   #</L>
      <L>## #$# $  #   # # #</L>
      <L>## # # $#### $#$# #</L>
      <L>#  $    #..#      #</L>
      <L>#   ## ##..##### ##</L>
      <L>#  ## ........ # #</L>
      <L>##  # ......*. # ##</L>
      <L>##$ #####..## ##$ #</L>
      <L>#  $  $ #..#      #</L>
      <L># $# $  #### $##  #</L>
      <L>#  $   $ # $ $ $  #</L>
      <L>#    ##      #    #</L>
      <L>###################</L>
    </Level>
    <Level Id="Level 30" Width="21" Height="15">
      <L> ###################</L>
      <L>##       #         ##</L>
      <L>#  #$  #     $ $  # #</L>
      <L>#  $  # # $## # ##  #</L>
      <L># $ ##   #  # $  #  #</L>
      <L># $   $$ #$ #$$$ #  #</L>
      <L>##  ##   #  #    $  #</L>
      <L>#@ #   ##  # ###$#  #</L>
      <L>## #    $  # .#.... #</L>
      <L>#   ## #  $# .#.... #</L>
      <L># $   $ #$ # .#..#. #</L>
      <L># $## $ #  # ....#. #</L>
      <L>#    $    #  ....#. #</L>
      <L>##  ## ##  #     ## #</L>
      <L> ####################</L>
    </Level>
    <Level Id="Level 31" Width="18" Height="16">
      <L>  ####   ########</L>
      <L>  #  #####      ##</L>
      <L> ##  #   #   #   #</L>
      <L> #  $# $ $  $# $##</L>
      <L> #$  $  # $  #$  #</L>
      <L>##  $##  $ $  $  #</L>
      <L>#  #    # $ $  $ #</L>
      <L># $$  # @ # $  # #</L>
      <L># $ #########$ # #</L>
      <L># $  $    $    $ #</L>
      <L>#       #     ####</L>
      <L>#  ##..###..###</L>
      <L>####.........#</L>
      <L>   ##..###..##</L>
      <L>   #....#....#</L>
      <L>   ###########</L>
    </Level>
    <Level Id="Level 32" Width="19" Height="16">
      <L>###################</L>
      <L>#           ##    #</L>
      <L>#    $    $   $ $ #</L>
      <L>#   ########  #   #</L>
      <L>#     $    $  $   #</L>
      <L># $#        #  # ##</L>
      <L>#  ###.....##     #</L>
      <L># $  ##....#   $$ #</L>
      <L>#  # ###..##$# $  #</L>
      <L>## $$   @     $#$##</L>
      <L>#  # ##..### # $  #</L>
      <L># $  #....##$ $   #</L>
      <L># $  #.....#   ## #</L>
      <L>#  ###     ##   # #</L>
      <L>#                 #</L>
      <L>###################</L>
    </Level>
    <Level Id="Level 33" Width="13" Height="15">
      <L>  #########</L>
      <L> ##   ##  ##</L>
      <L>##@ $$   $ ##</L>
      <L># $# ## $$  #</L>
      <L>#  $  #     #</L>
      <L># $$ $#  ####</L>
      <L>#   # # $  ##</L>
      <L>#      $ $  #</L>
      <L># $# $# $#  #</L>
      <L>#  $  #   $ #</L>
      <L>##### $ #####</L>
      <L> #.... ....#</L>
      <L> ##.......##</L>
      <L>  ##..#..##</L>
      <L>   #######</L>
    </Level>
    <Level Id="Level 34" Width="15" Height="11">
      <L>###############</L>
      <L>#.#.#  #  #   #</L>
      <L>#...#  $ $    #</L>
      <L>#...#  # # $  #</L>
      <L>##..# #   #$###</L>
      <L>##..#  $$  $  #</L>
      <L>#   #$#   #$  #</L>
      <L>#      # #  ###</L>
      <L>#  # $  $  $  #</L>
      <L>#  @##    #   #</L>
      <L>###############</L>
    </Level>
    <Level Id="Level 35" Width="20" Height="14">
      <L>######</L>
      <L>#    #########</L>
      <L>##...    #   #</L>
      <L> ##..##$$#$  #</L>
      <L>##...#@  #   #</L>
      <L>#....##$$#$$##</L>
      <L>##...    #  #</L>
      <L> ##..##$    ##</L>
      <L>  # .#  # $  #</L>
      <L>### ##   #   #</L>
      <L>#     $ $ ##########</L>
      <L># $$$$   $   $  $  #</L>
      <L>#    #####         #</L>
      <L>######   ###########</L>
    </Level>
    <Level Id="Level 36" Width="19" Height="13">
      <L>   #####   #####</L>
      <L>  ##   #####   ##</L>
      <L> ##    # @ #    ##</L>
      <L>##    $  #       ##</L>
      <L>#   #$# # # # #   #</L>
      <L>#  # $ $ # ... #  #</L>
      <L># $ $ $  $..#...  #</L>
      <L>#  # $ $ # ... #  #</L>
      <L>#   # # # # # #   #</L>
      <L>##    $  #        #</L>
      <L> ##     ###  ###  #</L>
      <L>  #  #### #### ####</L>
      <L>  ####</L>
    </Level>
    <Level Id="Level 37" Width="27" Height="14">
      <L> #################  #####</L>
      <L>##    ##   #     ####   #</L>
      <L>#     $   $#$ ## # $    #</L>
      <L>#  ####$$    $   $ $ $  #</L>
      <L>#  $    $ #$  ##$  ### ##</L>
      <L>##   ######  $     # #$#</L>
      <L>#  ##########$  #$ ### ##</L>
      <L># #.......#  $ # $ ## @ #</L>
      <L>#   .....#        $### ##</L>
      <L>#  #....    $$$    # #$##</L>
      <L>#   ....#  $  ## #####  ###</L>
      <L>#  #.....#  $$# $  $ $  $ #</L>
      <L>###.......#   #    #      #</L>
      <L>  #########################</L>
    </Level>
    <Level Id="Level 38" Width="23" Height="17">
      <L>######################</L>
      <L>#      #        #    #</L>
      <L>#  $ $ #$# ## $$# $  #</L>
      <L># $##### #...## ###  #</L>
      <L>##@#    $ ...  $  #  #</L>
      <L> # #   # #...# ## #$ #</L>
      <L> #$## #...#*#...  #  #</L>
      <L> #  # $....*....# #  #</L>
      <L> # $# #...#.#...# # $#</L>
      <L> #  #  ##    # #  #  #</L>
      <L>## $#$    $$   $  #  #</L>
      <L># $ #  #### ####  #$$#</L>
      <L>#   ###         ###  ##</L>
      <L>##   $   ##$$## $ $   #</L>
      <L> #  $  $      $       #</L>
      <L> ########   ###########</L>
      <L>        #####</L>
    </Level>
    <Level Id="Level 39" Width="15" Height="15">
      <L>    ######</L>
      <L>    #    #</L>
      <L>##### $ $######</L>
      <L>#      # $  $ #</L>
      <L># $ $ #.      #</L>
      <L>##   #... $ $ #</L>
      <L> #  #....### ##</L>
      <L> #$#.....*@$ #</L>
      <L> #  #....###$##</L>
      <L>## $ #... $   #</L>
      <L># $ $ #*      #</L>
      <L>#      #  $ $ #</L>
      <L>#  $ $$  ######</L>
      <L>#####    #</L>
      <L>    ######</L>
    </Level>
    <Level Id="Level 40" Width="12" Height="12">
      <L>  ########</L>
      <L>###      ###</L>
      <L>#  $  $  $ #</L>
      <L># $ ## $ $ #</L>
      <L>#  #..# $  #</L>
      <L># #....#$$ #</L>
      <L># #.....$  #</L>
      <L># $@...#$  #</L>
      <L>#  #..#  $ #</L>
      <L># $ ## $ $ #</L>
      <L>#          #</L>
      <L>############</L>
    </Level>
    <Level Id="Level 41" Width="26" Height="15">
      <L>#### #######</L>
      <L>#  ###  #  #####    ######</L>
      <L>#   $  $ $ #   ######    #</L>
      <L>#   #$  #$ #$ ..*......* #</L>
      <L>##$##   $   $ #########. #</L>
      <L>#        $    #   #   #. #</L>
      <L># $  $ $ #$ #$# ....* #.##</L>
      <L>### # ##$#    # .###.##*#</L>
      <L>#   # ## ## $$##.#.#. #.#</L>
      <L># $ #$$ $ $   ##.#.*. #.#</L>
      <L># $ $        $##*#  # #.##</L>
      <L>##### ### # # # .######. #</L>
      <L># $ $$$@$$$$$ # ..*..... #</L>
      <L>#             #   ####   #</L>
      <L>###################  #####</L>
    </Level>
    <Level Id="Level 42" Width="17" Height="17">
      <L>       ###</L>
      <L>      ## ##</L>
      <L>     ##   ##</L>
      <L>    ##  #  ##</L>
      <L>   ##  $#$  ##</L>
      <L>  ##    $  $ ##</L>
      <L> ## $ .# #.   ##</L>
      <L>## $ $#...# $  ##</L>
      <L>#  ## .... $$#  #</L>
      <L>##   $#...#    ##</L>
      <L> ##   .##..   ##</L>
      <L>  ##    $ $  ##</L>
      <L>   ## $###$ ##</L>
      <L>    ##  #  ##</L>
      <L>     ##   ##</L>
      <L>      ##@##</L>
      <L>       ###</L>
    </Level>
    <Level Id="Level 43" Width="19" Height="17">
      <L>    ###########</L>
      <L>    #         #</L>
      <L>    # $  $ $  #</L>
      <L>   ## $ # # $ ##</L>
      <L>  ##   # $ #   ##</L>
      <L> ##   # #.# #   ##</L>
      <L>##   # $.*.  # $ ##</L>
      <L># $ #  .....   $  #</L>
      <L>#  # $#..#..#$ #  #</L>
      <L>#   $  .....  #   #</L>
      <L>## $ #  ...  #   ##</L>
      <L> ## $ # #*# #   ##</L>
      <L>  ##   # @ #   ##</L>
      <L>   ##   # # $ ##</L>
      <L>    # $$ $  $ #</L>
      <L>    #         #</L>
      <L>    ###########</L>
    </Level>
    <Level Id="Level 44" Width="20" Height="15">
      <L>####################</L>
      <L>#                  #</L>
      <L># #$   $  #  $  $# #</L>
      <L>#  $  $  $  $ $    #</L>
      <L>##### ########### ##</L>
      <L>#  $   $  #  $     #</L>
      <L># $#$ #   # $# $#$ #</L>
      <L>#  $   $  #  $     #</L>
      <L>#    $  $ #@ ### ###</L>
      <L>#### ######### $   #</L>
      <L># ## # $ $ $ $     #</L>
      <L># #  .........     #</L>
      <L>#   #.........     #</L>
      <L>#    .........     #</L>
      <L>####################</L>
    </Level>
    <Level Id="Level 45" Width="17" Height="20">
      <L>     ### ###</L>
      <L>     #+# #.#</L>
      <L> #####.###.######</L>
      <L>##    $     $   #</L>
      <L># $$    $ $  $  #</L>
      <L>#  ###.###.######</L>
      <L># $# #.# #.#</L>
      <L>#  # #*# #.#</L>
      <L># $###.###*#####</L>
      <L>#  $  $  $   $ ##</L>
      <L>##   $     $ $  #</L>
      <L> #####.###.###$ #</L>
      <L>     #.# #*# #  #</L>
      <L>     #.# #.# #  #</L>
      <L>######.###.###  #</L>
      <L>#    $$      $  #</L>
      <L>#  $           ##</L>
      <L>######.###.#####</L>
      <L>     #.# #.#</L>
      <L>     ### ###</L>
    </Level>
    <Level Id="Level 46" Width="19" Height="20">
      <L>        ###</L>
      <L>       ##.##</L>
      <L>      ## . ##</L>
      <L>     ##  .  ##</L>
      <L>    ##.$ @  .##</L>
      <L>   ## $ $#    ##</L>
      <L>  ## #   # $$  ##</L>
      <L> ##.. #  #$ $ ..##</L>
      <L>## $ $ # #  $    ##</L>
      <L># $    $ # $ $    #</L>
      <L>#...######## $ ...#</L>
      <L>##   $   #   $   ##</L>
      <L> ##  $ $ #$#    ##</L>
      <L>  ##..  $#  #..##</L>
      <L>   ##    $$ $ ##</L>
      <L>    ##.     .##</L>
      <L>     ##  .  ##</L>
      <L>      ## . ##</L>
      <L>       ##.##</L>
      <L>        ###</L>
    </Level>
    <Level Id="Level 47" Width="19" Height="20">
      <L>  ###############</L>
      <L>  #             #</L>
      <L> ##$$ ### ### $ ##</L>
      <L>##  ###*# #*###$ ##</L>
      <L>#  $$ ### ###  $  #</L>
      <L>##       $       ##</L>
      <L> ##$   $###     ##</L>
      <L>  #  $ $ # $$  $#</L>
      <L>  #  ##  @  ##$ #</L>
      <L>  #$  #######   #</L>
      <L>  #     ###     #</L>
      <L>  ##     # $$ ###</L>
      <L>   ####...$.###</L>
      <L>      #*....#</L>
      <L>      #....*#</L>
      <L>      #..*..#</L>
      <L>#######.#.#.#######</L>
      <L>#      $...$ $    #</L>
      <L>#        .        #</L>
      <L>###################</L>
    </Level>
    <Level Id="Level 48" Width="25" Height="13">
      <L>     ###         ###</L>
      <L>    ## ##       ## ##</L>
      <L>   ##   ##     ##   ##</L>
      <L>  ##   $ ##   ##  $  ##</L>
      <L> ## $##   ## ##  $##$ ##</L>
      <L>##    $ $  ###  $   $  ##</L>
      <L>#   $$##$  $@$   ##$$$  #</L>
      <L>## $$ ##   ###   ## $  ##</L>
      <L> ## .*.*  ## ## $..*. ##</L>
      <L>  ##.....##   ##.....##</L>
      <L>   ##...##     ##.*.##</L>
      <L>    ##*##       ##.##</L>
      <L>     ###         ###</L>
    </Level>
    <Level Id="Level 49" Width="25" Height="20">
      <L>#########################</L>
      <L>#                       #</L>
      <L>#         ###    $ $    #</L>
      <L># $ $ $   #@# $   $$$   #</L>
      <L>#  $ $ $  $ # $$   $    #</L>
      <L># $ $ $     #$$ $  $$   #</L>
      <L>#    $ $   $#     $ $   #</L>
      <L>#   $ $     #  $ $      #</L>
      <L># ## ###### # ###### ## #</L>
      <L># ###.......#.......### #</L>
      <L>#  ###...... ......###  #</L>
      <L>#   ###..... *....### $ #</L>
      <L>#  $ ###....#*...### $  #</L>
      <L>#     ###...#...### $   #</L>
      <L># $    ###*.*.*### $    #</L>
      <L>#    $$ ###**.###  $$   #</L>
      <L>#   $$   ###.###  $ $   #</L>
      <L>#    $$     *      $$$  #</L>
      <L>#                       #</L>
      <L>#########################</L>
    </Level>
    <Level Id="Level 50" Width="24" Height="20">
      <L>###########  ###########</L>
      <L>#  #..  ..#  #..  ..#  #</L>
      <L># $#.#  #.#  #.#  #.#  #</L>
      <L>#  #..  ..#  #..  ..#  #</L>
      <L>## #.#  #.#  #.#  #.#$##</L>
      <L>#  #..  ..#  #..  ..# ##</L>
      <L># $#..  ..#  #..  ..#  #</L>
      <L>#  #### ###  ### ####  #</L>
      <L># $$  # ######## ####  #</L>
      <L>#     #   $@$       #  #</L>
      <L>#   $ #  ####### #  #$ #</L>
      <L># $############# # $#  #</L>
      <L>#  #    $        # $ $ #</L>
      <L># $#  $########  # $$  #</L>
      <L>#  $ $   $ $  ####$ $$ #</L>
      <L>#   $# $ $   #  $      #</L>
      <L>#  $  #  $  # $ #   $  #</L>
      <L>#  $$  #$  #  $$ #  $$ #</L>
      <L>#                      #</L>
      <L>########################</L>
    </Level>
  </LevelCollection>
</SokobanLevels>
