<?xml version="1.0" encoding="utf-8"?>
<SokobanLevels xmlns:xsi="http://www.w3.org/2001/XMLSchema-instance" xsi:schemaLocation="SokobanLev.xsd">
  <Title>Mariposa</Title>
  <Description>

  </Description>
  <LevelCollection Copyright="rikitin" MaxWidth="50" MaxHeight="33">
    <Level Id="Erim 96 remodel 1" Width="18" Height="13" Copyright="Erim Sever, rikitin">
      <L>##################</L>
      <L>#..  #  *  #  * .#</L>
      <L>#.** #  $  #  $  #</L>
      <L>#.#  #$ *$ #$ #$ #</L>
      <L>#.#  $  #  $  #  #</L>
      <L>#.#  *  #  #  #  #</L>
      <L>#+#############. #</L>
      <L>#.#  *  #  #  #  #</L>
      <L>#.#  $  #  $  #  #</L>
      <L>#.#  #$ *$ #$ #$ #</L>
      <L>#.** #  $  #  $  #</L>
      <L>#..  #  *  #  * .#</L>
      <L>##################</L>
    </Level>
    <Level Id="Erim 96 remodel 2" Width="18" Height="13" Copyright="Erim Sever, rikitin">
      <L>##################</L>
      <L>#..  #  *  #  * .#</L>
      <L>#.** #  $  #  $  #</L>
      <L>#.#  #$ #$ #$ #$ #</L>
      <L>#.#  $  #  $  #  #</L>
      <L>#.#  *  #  #  #  #</L>
      <L>#+#############. #</L>
      <L>#.#  *  #  #  #  #</L>
      <L>#.#  $  #  $  #  #</L>
      <L>#.#  #$ #$ #$ #$ #</L>
      <L>#.** #  $  #  $  #</L>
      <L>#..  #  *  #  * .#</L>
      <L>##################</L>
    </Level>
    <Level Id="erim 96 final remodel" Width="18" Height="13" Copyright="Erim Sever, rikitin">
      <L>##################</L>
      <L>#..  #  *  #  * .#</L>
      <L>#.** #  $  #  $  #</L>
      <L>#.#  #$ *$ #$ #$*#</L>
      <L>#.#  $  #  $  #  #</L>
      <L>#.#  *  #  *  #  #</L>
      <L>#+#############. #</L>
      <L>#.#  *  #  *  #  #</L>
      <L>#.#  $  #  $  #  #</L>
      <L>#.#  #$ *$ #$ #$ #</L>
      <L>#.** #  $  #  $  #</L>
      <L>#..  #  *  #  * .#</L>
      <L>##################</L>
    </Level>
    <Level Id="londen 2012" Width="27" Height="15">
      <L>###########################</L>
      <L>#                         #</L>
      <L># *  #***#**$#** #***#**$ #</L>
      <L># *   *@* * * * * *   * * #</L>
      <L># *   * * * * * * $*  * * #</L>
      <L># *   * * * * * * *   * * #</L>
      <L># *** *** * * ** #***#* * #</L>
      <L>#                         #</L>
      <L># # ##***#***# * #**$## # #</L>
      <L># #.#   * * * *$    * #.# #</L>
      <L># #.# **$ * *  *  *** #.# #</L>
      <L># #.# *   * *  *  *   #.# #</L>
      <L># ### *** *** *** *** ### #</L>
      <L>#                         #</L>
      <L>###########################</L>
    </Level>
    <Level Id="Quantum Apocalypse" Width="19" Height="17" Copyright="stopheart, rikitin">
      <L>       ##### #####</L>
      <L>########   ####  #</L>
      <L>#        #  *  @ ##</L>
      <L># *$*$ #    # * * #</L>
      <L>#  $ #####*## *$* #</L>
      <L>## $ $   *  # * * #</L>
      <L>#  . #  *   #     #</L>
      <L># ***# *  $ # * * #</L>
      <L>#  * #******# *** #</L>
      <L>## * # $  * # * * #</L>
      <L>#  . #   *  #     #</L>
      <L>##*.*#  *   # * * #</L>
      <L>#  * ##*##### *** #</L>
      <L>## . $  #..   * *##</L>
      <L> ##### ...###    ##</L>
      <L>     ###  ########</L>
      <L>     ######</L>
    </Level>
    <Level Id="Arubian Rattlesnake" Width="24" Height="16" Copyright="David Holland, York Shen, GrigoRusha, rikitin">
      <L>          ##############</L>
      <L>      #####            #</L>
      <L>      #     ********** #</L>
      <L>####### *****        * #</L>
      <L>#     # *     #####  * #</L>
      <L># ###   * ######   # * #</L>
      <L># # ***** # *    * # * #</L>
      <L># #       # $****  # * #</L>
      <L>#### ###### *    * # * #</L>
      <L> ### #   $. . *  * # * #</L>
      <L> # # #   ########    * #</L>
      <L> # # ##$##      #### * #</L>
      <L> # #       ****   ## * #</L>
      <L> # #.*******  ***$@# . #</L>
      <L> #                 #   #</L>
      <L> #######################</L>
    </Level>
    <Level Id="G" Width="17" Height="18" Copyright="Laizhufu, Jordi Doménech, rikitin">
      <L>#################</L>
      <L>#@              #</L>
      <L># *.*.*.*.*.*.* #</L>
      <L># .$ $ $ $ $ $. #</L>
      <L># * #$######  * #</L>
      <L># .$#.....  $$. #</L>
      <L># * #.$$$$$ # * #</L>
      <L># .$#.$...$ #$. #</L>
      <L># * #.$.$.$ # * #</L>
      <L># .$#.$$$.$ #$. #</L>
      <L># * #.....$ # * #</L>
      <L># .$# $$$$$ #$. #</L>
      <L># * $       # * #</L>
      <L># .$#######$#$. #</L>
      <L># * $ $ $ $ $ * #</L>
      <L># .*.*.*.*.*.*. #</L>
      <L>#               #</L>
      <L>#################</L>
    </Level>
    <Level Id="Goodbye London 2012" Width="33" Height="24">
      <L>#################################</L>
      <L># ....           . .       .... #</L>
      <L># .$$$  $$$$  $  .$.$$$$   *$$  #</L>
      <L># *   $ $   $ $  .$.$   $ $.  $ #</L>
      <L># * ..$.*. .*.$...$.*. .$.$...$ #</L>
      <L># *$$*$.$.$* .$. .$.$.$* .$*$$$ #</L>
      <L># *  .$.$.$. .$. .$.$. .$.$.  $ #</L>
      <L># *...$.*. *..$...$.*. .*.$...* #</L>
      <L># $   $ $   $ $$$$$ $$$$ .$   $ #</L>
      <L># #.#     #     #.    #  .  # # #</L>
      <L># $.  $ $$$$$ $  .  $  ...$$$$$ #</L>
      <L># $.  $ $     $  .  $     $     #</L>
      <L># $.  $.*. ...$... .*. ...$     #</L>
      <L># $.  $.$*$* .$. . .$. . .$$$$$ #</L>
      <L>#  * $ .$. . .$. . .$. . .#   $ #</L>
      <L>#  .*. .*. . .$... .*. . .    $ #</L>
      <L>#   $   $$$$$ $$$$$ $$$$$ $$$$$ #</L>
      <L># # #     #     #     #     #@# #</L>
      <L># $$$$$***$***$$*$$***$$$$$$$$$ #</L>
      <L>#   .    . . . ..    .  .   .   #</L>
      <L>###... ***$*$*$$*$$***$***$...###</L>
      <L>  # .# .# #.#.# .# .# # .#  .##</L>
      <L>  #    ... ... ... ...        #</L>
      <L>  #############################</L>
    </Level>
    <Level Id="guyaba" Width="19" Height="8">
      <L>       ############</L>
      <L>       #          #</L>
      <L>       # $ $ $.*..#</L>
      <L>######### #######.#</L>
      <L>#  . $    #. $ $ .#</L>
      <L>#@$#$#$$$$.$.$.$..#</L>
      <L>#  .      #.     .#</L>
      <L>###################</L>
    </Level>
    <Level Id="megatron c remodeled" Width="21" Height="15" Copyright="rikitin, stopheart">
      <L>       #######</L>
      <L>       #     #</L>
      <L>       # #$# #</L>
      <L>########  *  ########</L>
      <L>#    ## *   * ##    #</L>
      <L># **  *  ###  *  ** #</L>
      <L># *  # *     * #  * #</L>
      <L>#  * #  * * *  # *  #</L>
      <L># *# ### # # ### ** #</L>
      <L>## #*  #  .  #  ** ##</L>
      <L> #   *  #####  *   #</L>
      <L> ## ***       *** ##</L>
      <L>  ##  ****$****  ##</L>
      <L>   ##     +     ##</L>
      <L>    #############</L>
    </Level>
    <Level Id="Bazooka Gum 6" Width="10" Height="10">
      <L>#######</L>
      <L>#     #</L>
      <L># $**#####</L>
      <L># * *    #</L>
      <L># * **** #</L>
      <L># *  # * #</L>
      <L># *    * #</L>
      <L># *****. #</L>
      <L>#       @#</L>
      <L>##########</L>
    </Level>
    <Level Id="Brain Storm" Width="19" Height="12">
      <L>#######     #######</L>
      <L>#@ #  #######  #  #</L>
      <L>#*   *  ###  *   *#</L>
      <L># * * *  #  * * * #</L>
      <L>#  * # * # * # *  #</L>
      <L># * *   *#*   * * #</L>
      <L># *  *       *  * #</L>
      <L># ** #* .#. *# ** #</L>
      <L>#  *   * # *   *  #</L>
      <L># $****  #  ****$ #</L>
      <L>##      ###      ##</L>
      <L>###################</L>
    </Level>
    <Level Id="Butterflies" Width="50" Height="26">
      <L> ##########   ######## ######   #####   #####</L>
      <L> #        ##  #      ###    ## ##   ## ##   ##</L>
      <L> #$  # $   ######     #      ###     ###  $  ###</L>
      <L> #   $ ###       $ $    $$ $     $ $     $$$   #</L>
      <L> #$  # #    #     $   #   $ $             $    #</L>
      <L> #         # #    $  # #  $  ### $ $ ###     # ##</L>
      <L>##$    #  #   #     #   #   #   #   #   #   #   ##</L>
      <L>#     # ##  $  #####  $  ###  $$ ###  $  ###  $  #</L>
      <L>#     #    $$$        $      $$      $$$     $   #</L>
      <L>####  # ##     ######   ####     ###  $  ###    ##</L>
      <L>   #   #  #       $  # #    #   #   #   #   #  ##</L>
      <L>   # # #$  # #### $   #   $  ###@$   ###     # #</L>
      <L>#### # # $        $     $$$$    $$$      $$    #</L>
      <L>#      # $  #   $$$   #   $      $        $    #</L>
      <L># $# #     # #  $    # #     ###     ###  $$ # ##</L>
      <L>#  #   #  #   #     #   #   #   #   #   #   #   ##</L>
      <L># $# ## ##  $  #####  $  ###  $  ###  $  ###  $  #</L>
      <L>#  # $      $         $      $ $     $ $      $  #</L>
      <L># $#  # ##  $  ######   ####  $  ###  $  ###  . ##</L>
      <L>#  #   #  #          # #    #   #   #   #  .# .##</L>
      <L># $# $ $ $   ####     #   $  # #     ###  $ .#.#</L>
      <L>#  #        #     $       $      $ $      $ ...#</L>
      <L># $ $#####   ####.....#......###.....###.....#.#</L>
      <L>## $  $ $ .......###.# #....#.......#..........##</L>
      <L>##......................#..#.......#............#</L>
      <L> ################################################</L>
    </Level>
    <Level Id="santanero" Width="24" Height="16">
      <L> ####################</L>
      <L> #                  ####</L>
      <L> # **** #@*****  ***.  #</L>
      <L> # *  *  #*   * **  ** #</L>
      <L> # * #**  * # * *  # * #</L>
      <L> # * # *  *   * * ## * #</L>
      <L> # * # ****  ** * ## * #</L>
      <L> # *        **  * ## * #</L>
      <L> # * ********   *    * #</L>
      <L> # * *          * **** #</L>
      <L> # * *********  * *    #</L>
      <L> # *       # **** *** ##</L>
      <L>## * ***** #        * #</L>
      <L># $* *   ************ #</L>
      <L>#                     #</L>
      <L>#######################</L>
    </Level>
    <Level Id="triangle" Width="15" Height="18">
      <L>  ###########</L>
      <L>  #    *    #</L>
      <L>  #   *@*   #</L>
      <L>###  * . *  ###</L>
      <L>#   *     *   #</L>
      <L>#  *********  #</L>
      <L>#             #</L>
      <L>####### #######</L>
      <L>      # #</L>
      <L>      # #</L>
      <L>####### #######</L>
      <L>#             #</L>
      <L>#  *********  #</L>
      <L>#   *     *   #</L>
      <L>###  * $ *  ###</L>
      <L>  #   * *   #</L>
      <L>  #    *    #</L>
      <L>  ###########</L>
    </Level>
    <Level Id="four cells" Width="32" Height="21">
      <L>          ###########</L>
      <L>          #    *    #</L>
      <L>          #   *@*   #</L>
      <L>        ###  * . *  ###</L>
      <L>        #   *     *   #</L>
      <L>        #  *********  #</L>
      <L>######  #             #  ######</L>
      <L>#    ## ####### ####### ##    #</L>
      <L># **  #       # #       # *** ##</L>
      <L>#   * ######### ######### *   ##</L>
      <L># *$*                     * * .#</L>
      <L>#   * ######### ######### *   ##</L>
      <L># **  #       # #       # *** ##</L>
      <L>#    ## ####### ####### ##    #</L>
      <L>######  #             #  ######</L>
      <L>        #  *********  #</L>
      <L>        #   *     *   #</L>
      <L>        ###  * $ *  ###</L>
      <L>          #   * *   #</L>
      <L>          #    *    #</L>
      <L>          ###########</L>
    </Level>
    <Level Id="together" Width="11" Height="11">
      <L>###########</L>
      <L>#    *    #</L>
      <L>#   ***   #</L>
      <L>#  * * *  #</L>
      <L># *  *  * #</L>
      <L>#*@. * $ *#</L>
      <L># *  *  * #</L>
      <L>#  * * *  #</L>
      <L>#   ***   #</L>
      <L>#    *    #</L>
      <L>###########</L>
    </Level>
    <Level Id="Santanero lost in Paradise" Width="24" Height="16" Copyright="rikitin, haikemono">
      <L> ####################</L>
      <L> #                  ###</L>
      <L> # #*####@#*###  ***..#</L>
      <L> # # #  ###   * **  *##</L>
      <L> # # #    # # # #  # #</L>
      <L> # # #    #   * # ## #</L>
      <L> # # ######  ** # ## #</L>
      <L> # *        **  # ## ###</L>
      <L> # # ######**   *    * #</L>
      <L> # # #   #    # # #### #</L>
      <L> # # #####*$**  * # #  #</L>
      <L> # #       # ***# # # ##</L>
      <L>## # ##### #      # # #</L>
      <L># $* *   *****#*##### #</L>
      <L>#    #                #</L>
      <L>#######################</L>
    </Level>
    <Level Id="Santanero Express" Width="24" Height="16">
      <L> ####################</L>
      <L> #                  ####</L>
      <L> #$$### ###*#** $+**.  #</L>
      <L> # *  * ###   #.**  *# #</L>
      <L> # # ##*  *.# #$*  # # #</L>
      <L> # # # *  #   * * ## # #</L>
      <L> # # # #**#  ** * ## # #</L>
      <L> # #        **  * ## # #</L>
      <L> # . ###*##**   *    # #</L>
      <L> # * #        # * #### #</L>
      <L> # * ****###**  * *    #</L>
      <L> # *     ### ***. #*# ##</L>
      <L>## * #*#####        # #</L>
      <L>#  *$* ############*$ #</L>
      <L>#    #                #</L>
      <L>#######################</L>
    </Level>
    <Level Id="build a bell" Width="25" Height="25">
      <L>            #</L>
      <L>           # #</L>
      <L>          # . #</L>
      <L>         # .$. #</L>
      <L>        # ..$.. #</L>
      <L>       # .  $  . #</L>
      <L>      # .   $   . #</L>
      <L>     # .    $    . #</L>
      <L>    # .#$$$$$$$$$#. #</L>
      <L>   #  .#    $    #.  #</L>
      <L>   #$#.#    $    #.#$#</L>
      <L>   #  .#    $    #.  #</L>
      <L>   #$#.#    $    #.#$#</L>
      <L>   #  .#####$#####.  #</L>
      <L>   #$#......$......#$#</L>
      <L>   # .  $   $   $  . #</L>
      <L>  # *#   $ $@$ $   #* #</L>
      <L> # .  #   $ $ $   #  . #</L>
      <L>##.    # $  $  $ #    .##</L>
      <L> # .    $       $    . #</L>
      <L>  # .  $         $  . #</L>
      <L>   # .$$$$$$$$$$$$$. #</L>
      <L>    # .$ $ $ $ $ $. #</L>
      <L>     # ........... #</L>
      <L>      #############</L>
    </Level>
    <Level Id="Squary" Width="12" Height="11">
      <L>###########</L>
      <L>#         #</L>
      <L># .$.$.$. #</L>
      <L># $.$.$.$ #</L>
      <L># .$.$.$. #</L>
      <L># $.$@$.$ #</L>
      <L># .$.$.$. #</L>
      <L># $.$.$.$ ##</L>
      <L># .$.$.$.  #</L>
      <L>#          #</L>
      <L>############</L>
    </Level>
    <Level Id="Mini Spooky" Width="14" Height="15">
      <L>   ###########</L>
      <L>   #    #    #</L>
      <L> ###$$  $  $ #</L>
      <L>##    ##  $  #</L>
      <L>#  *  ##$#$  #</L>
      <L># * ####    ##</L>
      <L>##   ######$##</L>
      <L>#   $  ##..  #</L>
      <L># *...*.*.*. #</L>
      <L>##$### ##  # #</L>
      <L>#    $ ## *$ #</L>
      <L>#    $ ## @*.#</L>
      <L>#####     *..#</L>
      <L>    ###    ..#</L>
      <L>      ########</L>
    </Level>
    <Level Id="Medium Spooky" Width="14" Height="15">
      <L>   ###########</L>
      <L>   #    #    #</L>
      <L> ###$$  $  $ #</L>
      <L>##    ##  $  #</L>
      <L>#  *  ##$#$  #</L>
      <L># * ####    ##</L>
      <L>##   ######*##</L>
      <L>#   $  ##... #</L>
      <L># *...*.*.*. #</L>
      <L>##$### ##  # #</L>
      <L>#    $ ## *$ #</L>
      <L>#   $$ ## @*.#</L>
      <L>#####   $ *..#</L>
      <L>    ###    ..#</L>
      <L>      ########</L>
    </Level>
    <Level Id="First Oldie" Width="20" Height="20">
      <L>      ####</L>
      <L>#######  ##</L>
      <L>#.......$ #</L>
      <L>#.#.#$# $ #</L>
      <L>#.$.  ##  #</L>
      <L>#. $ #@ $ #</L>
      <L>#$##.* #  #</L>
      <L>#  #.*### #</L>
      <L>#  #.... .#</L>
      <L>#  ##$#**.##########</L>
      <L># ###              #</L>
      <L># ## .*.###$ #$#$$ #</L>
      <L># #  $ ## #    $   #</L>
      <L># # $ ##  # $$ #$$ #</L>
      <L># #  ##   # $  #   #</L>
      <L># ####    ###$######</L>
      <L>#    ########  #</L>
      <L>## $           #</L>
      <L>############  ##</L>
      <L>           ####</L>
    </Level>
    <Level Id="Second Oldie" Width="20" Height="20">
      <L>      ####</L>
      <L>#######  ##</L>
      <L>#.......$ #</L>
      <L>#.#.#$# $ #</L>
      <L>#.$.  ##  #</L>
      <L>#. $ #@ $ #</L>
      <L>#$##.* #  #</L>
      <L>#  #.*### #</L>
      <L>#  #.... .#</L>
      <L>#  ##$#**.##########</L>
      <L># ###              #</L>
      <L># ## .*.###$ #$#$$ #</L>
      <L># #  $ ## #    $   #</L>
      <L># # $ ##  # $$ #$$ #</L>
      <L># #  ##   # $  #   #</L>
      <L># ####    ###$######</L>
      <L>#  ##########  #</L>
      <L>## $           #</L>
      <L>############   #</L>
      <L>           #####</L>
    </Level>
    <Level Id="Fixie" Width="19" Height="14">
      <L>  #####</L>
      <L> ##  #####</L>
      <L>## $ #   ##########</L>
      <L>##  $  $  $ ###   #</L>
      <L>#  $  #*#   ## $  #</L>
      <L>#   ###+###    # ##</L>
      <L>## # ......# $ $ ##</L>
      <L> # # *****.. # $  #</L>
      <L>##  #*.*.*## $ $  #</L>
      <L>#  $#..*..#### #  #</L>
      <L>#     ###  ###  ###</L>
      <L>### $   $$      #</L>
      <L>  #######  ######</L>
      <L>        ####</L>
    </Level>
    <Level Id="Bazooka Gum 5" Width="10" Height="10">
      <L>#######</L>
      <L>#     #</L>
      <L># $**#####</L>
      <L># * *    #</L>
      <L># * **** #</L>
      <L># *    * #</L>
      <L># *    * #</L>
      <L># *****. #</L>
      <L>#       @#</L>
      <L>##########</L>
    </Level>
    <Level Id="Cadushi Largo 01" Width="15" Height="17">
      <L>          #####</L>
      <L>###########.  #</L>
      <L>#      ...... #</L>
      <L>### #$ #####* #</L>
      <L>#  * $$       #</L>
      <L># .* $  * * # #</L>
      <L>#@.# $$* ** * #</L>
      <L>##.* $  *  *  #</L>
      <L> #.# $$   * * #</L>
      <L> #.* $  *######</L>
      <L> #.# $$  #</L>
      <L> #.* $   #</L>
      <L> #.# $$ *#</L>
      <L> #.#  $  #</L>
      <L> #.$ #####</L>
      <L> #   #</L>
      <L> #####</L>
    </Level>
    <Level Id="armada" Width="32" Height="18" Copyright="Buddy Casamis, rikitin">
      <L>       ######################</L>
      <L>      ##           #.$      ##</L>
      <L>  #####  #######   #### ###$ #</L>
      <L>  #   # ##.   .### ###  ###.$#</L>
      <L>  # $.$ #### $  .#    $  ### #</L>
      <L>### .$. # ## #*##### ## .### ##</L>
      <L>#    * ####. $  ..#  .  .$ # .##</L>
      <L># $$. .   # $   $ # @##$*  #   #</L>
      <L>#  ##.$ #   .$   ###     ### $ #</L>
      <L>## ######.#*##$$. ## #####    ##</L>
      <L> #  #  $  # #   # #  ##    # $#</L>
      <L> ## # # $.#   $ $ # $##* ###  #</L>
      <L>  #       #.###   # $.$  ##. ##</L>
      <L>  ########### #####  * *.##$ ##</L>
      <L>                  ## $.  ##  .#</L>
      <L>                   #  .####   #</L>
      <L>                   ##### #.  ##</L>
      <L>                         #####</L>
    </Level>
    <Level Id="market place" Width="36" Height="33" Copyright="David W Skinner, rikitin">
      <L>                   ####</L>
      <L>                  ##  #</L>
      <L>                  # $ ###</L>
      <L>          ###     #$    #</L>
      <L>         ##.##### #.$$# #</L>
      <L>       ###.$.$  ### $.. ##</L>
      <L>       #  $ # * .#.   #  #</L>
      <L>     ### #.$#$$### # ### #####</L>
      <L>     #  ..$ *.  ##*$$# $ .   ##</L>
      <L>     # #$*$ . *        . $ #  #</L>
      <L>  ####.  .  #$***.**. ####.#  ###</L>
      <L>  # $  ..$. #    #   ## #  #. $ #</L>
      <L>### # $#$*##### ### #####$$#$ # ###</L>
      <L>#  .$*  .$  # *  $. $ #  * $ . .  ##</L>
      <L># .$.$.  $. # $*.  $* #$.$. .$* *  #</L>
      <L>#.$.$.## .$* *   #   * . . #$. * * #</L>
      <L># $ ##### . # #$.$.$# ### ##.## $ ##</L>
      <L># # #   #.###$$. #$.$$###.#####$#$#</L>
      <L># $ # $ ###.# #$*$. # # . ##.## $ ##</L>
      <L>#.$.# $   ..#.$. # . .$. . # . * * #</L>
      <L>#@. # $ $$$.#   *$* $ #$.$.$.$* *  #</L>
      <L>###.  $ $ $.#  . $ .$ #  . $ * .  ##</L>
      <L>  ### $ $ $.#############  #$$# ###</L>
      <L>    # $ $ $...........###.$$ .  #</L>
      <L>    # $ $ $ $$$ ....### . .$. ###</L>
      <L>    # $ $ $ $ $ ....#.#.$# #$ #</L>
      <L>    # $ $ $ $ $ $..## $ .$.  ##</L>
      <L>    # $$$ $$$ $$$..#  #$ # ###</L>
      <L>    #            ..#*   .$ #</L>
      <L>    #####..........# .$.$ ##</L>
      <L>        ############.$#$###</L>
      <L>                   # .  #</L>
      <L>                   ######</L>
    </Level>
    <Level Id="rock-star" Width="21" Height="21" Copyright="David W Skinner, rikitin">
      <L>          #########</L>
      <L>       ####  $..  #</L>
      <L>    ####  *$.   $ #</L>
      <L> #### .$*    ### ##</L>
      <L> # .$*    ####.# ##</L>
      <L>##     ####....#@ #</L>
      <L># . ####  $ $ .## #</L>
      <L># * #....$  $ $.# ##</L>
      <L>##$ ##.$$$$ $ $.#  #</L>
      <L> # . #.$  $ $ $ ## #</L>
      <L> # $ #. $   $ $  # ##</L>
      <L> ##* ##. $ $$ $$ #  #</L>
      <L>  #   #.$  $     ## #</L>
      <L>  # * #. $$  $....# #</L>
      <L>  ##$ ##. $ ...#### #</L>
      <L>   #.  #.   ####    #</L>
      <L>   # * #.##.#    ####</L>
      <L>   ##$ ### .  ####</L>
      <L>    #.     $###</L>
      <L>    #####   #</L>
      <L>        #####</L>
    </Level>
  </LevelCollection>
</SokobanLevels>
