<?xml version="1.0" encoding="utf-8"?>
<SokobanLevels xmlns:xsi="http://www.w3.org/2001/XMLSchema-instance" xsi:schemaLocation="SokobanLev.xsd">
  <Title>MF8 Sokoban Competition</Title>
  <Description>
MF8 Sokoban Competition: The MF8 forum is a forum for all twisty
puzzles. (i.e. Rubik's Cube) In 2009, a sub-forum is created for
Sokoban enthusiasts. The 1st Sokoban competition took place on April
7, 2009.  There is a Sokoban competition about every month.  Everyone
is free to join.  Winners of the competition will get a twisty cube.  
See this page for more details: 
http://sokoutil.orgfree.com/competition.html Due to the simplicity of
the first three competition levels, they are omitted from this set.
Authors: (not in any particular order) stopheart, anian, Yang Chao,
gyjgw, York Shen, Kevin B. Reilly, Jean-Pierre Martel, Matthias Meger,
Jordi Doménech, Thinking Rabbit.
  </Description>
  <Email>tuixiangziyouxi@126.com</Email>
  <LevelCollection Copyright="MF8: Many authors" MaxWidth="46" MaxHeight="29">
    <Level Id="MF8 04th Sokoban Competition" Width="17" Height="25" Copyright="Yang Chao">
      <L>#############</L>
      <L>#           #</L>
      <L># .$$$$$$$. #</L>
      <L># *.  $  .* #</L>
      <L># * . $ . * #</L>
      <L># *  .$.  * #</L>
      <L># .$$$*$$$. ###</L>
      <L># *   *   *   #</L>
      <L># * *.....*.* #</L>
      <L># * *$.   *$$ #</L>
      <L># .$* *$ $* $ #</L>
      <L>#   *  $ $  $ #</L>
      <L>#   *...*...* ###</L>
      <L>### *   $   $   #</L>
      <L>  # *$$*******$ #</L>
      <L>  # * . $ $ $ . #</L>
      <L>  # . . $ $ $ . #</L>
      <L>  #   .   $   . #</L>
      <L>  ### $*******$ #</L>
      <L>    # *       * #</L>
      <L>    # *       * #</L>
      <L>    # .       . #</L>
      <L>    #  .......@ #</L>
      <L>    #           #</L>
      <L>    #############</L>
    </Level>
    <Level Id="MF8 05th Sokoban Competition" Width="31" Height="23" Copyright="Yang Chao">
      <L>      ####</L>
      <L>      #  #     ################</L>
      <L>      #  #  ####   ##         #</L>
      <L>      #  #  #  #              #</L>
      <L>    #### #  #      ##         #</L>
      <L>    #  * #### ### ###   #######</L>
      <L>    #  **#      *  ##   #</L>
      <L>    #  *  ******** ##   #</L>
      <L>    # ** #  *      ##   #</L>
      <L>    # *  ## * ### ###   #######</L>
      <L>#####** ### * ##   ##         #</L>
      <L># $ * * #   *   *  ##         #</L>
      <L>#     * #********* ##         #</L>
      <L>##### * #  *    * #########   #</L>
      <L>    # * #  * ## * #       #   #</L>
      <L>    # * #  * @# * #       #   #</L>
      <L>    # * #  * ## * #       #   #</L>
      <L>    # * #  * ## * #########   #</L>
      <L>    # * #  *    *   #         #</L>
      <L>    # * **********. #         #</L>
      <L>    # *             #         #</L>
      <L>    #     #####################</L>
      <L>    #######</L>
    </Level>
    <Level Id="MF8 06th Sokoban Competition" Width="17" Height="21" Copyright="Jean-Pierre Martel, Matthias Meger, York Shen, anian">
      <L>#################</L>
      <L>#######   #######</L>
      <L>#     ....#     #</L>
      <L>#   # #...#     #</L>
      <L>#    $.#..... # #</L>
      <L>#  # #..*.##.   #</L>
      <L>#  # .#*.....#  #</L>
      <L>####.*#.###.## ##</L>
      <L>#   *.#.....    #</L>
      <L># $#+*... #  #  #</L>
      <L>#  #####*##     #</L>
      <L># $$ #   #    # #</L>
      <L># $  $$#     #  #</L>
      <L># $ $#   #####$##</L>
      <L># $  # ### $ $  #</L>
      <L># $  $$  #   $  #</L>
      <L># $  $   # #$ $ #</L>
      <L># $$$$$$$$    $ #</L>
      <L># $  $ $ # $ $$ #</L>
      <L>#        # ##   #</L>
      <L>#################</L>
    </Level>
    <Level Id="MF8 7th Sokoban competition" Width="18" Height="21" Copyright="Thinking Rabbit, Jordi Doménech, anian">
      <L>################</L>
      <L>#   #......#   #</L>
      <L>#    .    .# $ #</L>
      <L>### #......    #</L>
      <L> ## ######## ###</L>
      <L> #             #</L>
      <L> # $ $ $$$ $ $@#</L>
      <L> ####### #######</L>
      <L> #. #  .  #    #</L>
      <L> #.$# *.. # $  #</L>
      <L> #. ###.###$ $ ##</L>
      <L> #.   * # $ $ $ #</L>
      <L> # $##*      #$ #</L>
      <L> #. ##.####$##  #</L>
      <L> #.##   # $  #$ #</L>
      <L> #. #   #   $$  ##</L>
      <L> ## # $$ #       #</L>
      <L>  # #    # $ #$  #</L>
      <L>  # ######## #   #</L>
      <L>  #          #####</L>
      <L>  ############</L>
    </Level>
    <Level Id="MF8 8th Sokoban Competition" Width="46" Height="23" Copyright="Gyjgw">
      <L>#####         ##############################</L>
      <L>#   ##       ##                            ##</L>
      <L># *  ##     ##  * *#***********  *********  ##</L>
      <L># **  ##   ##  ** *             **       **  #</L>
      <L># * *  ## ##  * * * ########## ** ####### ** #</L>
      <L># *  *  # #  *  * * #        # *  #     #  * #</L>
      <L># *# *  ###  * #* * #        # * ##     ## * #</L>
      <L># *  #*  #  *#  * * #        # * ##     ## * #</L>
      <L># * #  *   *  # * * ########## *  ##   ##  * #</L>
      <L># * #  ** **  # * *            #.  #####  .# #</L>
      <L># * ##  * *  ## * *#**********$ **       **  #</L>
      <L># * ###  *  ### * *            # .*******. # #</L>
      <L># * # ##   ## # * * ########### .*       *. ##</L>
      <L># * #  #####  # * * #        # .*$##   ##$*. #</L>
      <L># * #         # * * #        # *$ ####### $* #</L>
      <L># * #         # * * #        # *  #     #  * #</L>
      <L># * #         # * * #        # *  #     #  * #</L>
      <L># * #         # * * #        # *  #     #  * #</L>
      <L># * #         # * * #        # ** ####### ** #</L>
      <L># * #         # * * #        #  **       **  #</L>
      <L># $ #         # $#$ ###########  *********  ##</L>
      <L>#  @#         #                            ##</L>
      <L>#####         ##############################</L>
    </Level>
    <Level Id="MF8 9th Sokoban Compettion" Width="29" Height="29" Copyright="Kevin B Reilly, stopheart, York Shen">
      <L>     #######</L>
      <L>     #  #  #</L>
      <L>     #     #</L>
      <L>     #  #  #</L>
      <L>     ## #.##</L>
      <L>####  # #  #</L>
      <L>#  ####$##$###     ####</L>
      <L># .*@   #    #     #  #</L>
      <L>#  $$$ # $ $ #######$ #</L>
      <L>##.# ###   $ $    $   ##</L>
      <L> #.$ ###  $$   $ $$ $  #</L>
      <L> # # ### $   $ $   $ # #</L>
      <L> #   #  ############   #</L>
      <L> ### #$ ##  ######## ###</L>
      <L>  #     ##$ ######## ##</L>
      <L>  # ##.#   $ ####.*.* ####</L>
      <L>###*. .#.#   ####.... #  #</L>
      <L>#   .#.# $$* #### #.###  ####</L>
      <L># $*$ * .. . #### #.  $$.   #</L>
      <L>###  $ #####$#### #*### .*. #</L>
      <L> #  ####....     .*..##*  ###</L>
      <L>## ##### ##.#####.##  * .##</L>
      <L>#      #..$. ####.### #  #</L>
      <L># $$#  $..#..*....  $ ####</L>
      <L>#    $$## ####### #$# #</L>
      <L>###$$  $  #    #  $   #</L>
      <L>  #    ####    # $  ###</L>
      <L>  ######       #  ###</L>
      <L>               ####</L>
    </Level>
    <Level Id="10th Sokoban Competition" Width="20" Height="27" Copyright="Gyjgw">
      <L>####################</L>
      <L>#                  #</L>
      <L># ** * * * * * * * #</L>
      <L>#  ##############* #</L>
      <L># *##          ##  #</L>
      <L>#  # *  **  **@# * #</L>
      <L># **  **  **  ##*  #</L>
      <L>#   **  **  .##  * #</L>
      <L># **  **  ** #  *  #</L>
      <L>#   **  **  ## * * #</L>
      <L># **  **  *## * *  #</L>
      <L>#   **  ** # * * * #</L>
      <L># **  **  ##* * *  #</L>
      <L>#   **   ##  * * * #</L>
      <L># **  **##  * * *  #</L>
      <L>#   **  #  * * * * #</L>
      <L># **  *## * * * *  #</L>
      <L>#   ** # * * * * * #</L>
      <L># **   #* * * * *  #</L>
      <L>#   **## * * * * * #</L>
      <L># **  # * * * * *  #</L>
      <L>#   *##* * * * * * #</L>
      <L># ** ## * * * * *  #</L>
      <L>#   *##* * * * * * #</L>
      <L># *** * * * * * *$ #</L>
      <L>#                  #</L>
      <L>####################</L>
    </Level>
    <Level Id="MF8 11th Sokoban Competition" Width="29" Height="29" Copyright="Kevin B Reilly, stopheart, York Shen">
      <L>     #######      #####</L>
      <L>     #  #  ########   #</L>
      <L>     #     ##         #</L>
      <L>     #  #  ##$######.####</L>
      <L>     ##.# ##  #   #   $ #</L>
      <L>####  # #  #   $# #   # #</L>
      <L>#  ####$##*# ##    #### #</L>
      <L># .*@   # .$$ # $$ #### #</L>
      <L>#  $$$ ## .$  # $  #    #</L>
      <L>##*# ##  $.#  #$  #  ######</L>
      <L> #.  ## $.. ##  $ # #     #</L>
      <L> # # ####  $     ## #.##*$##</L>
      <L> # ..  .###### ####    $.  #</L>
      <L> #####$ *..    .   # $.#$  #</L>
      <L>  #  . .##*.###### ##.   ###</L>
      <L>  #$##.#.  $ #####.$.$ ###</L>
      <L>###  ..# #  $   ##. ..#  #</L>
      <L>#  ..#*# $$* ##  ## ### .####</L>
      <L># $$$ $  . . ###  #   $* .  #</L>
      <L>###..$.#####$#### #$### .*. #</L>
      <L> #  ####   ...  ..*  ##*  ###</L>
      <L>## ##### ## ##### ##  * .##</L>
      <L>#      #..$.##### ### #  #</L>
      <L># $$#  $  #. $        ####</L>
      <L>#    $$## ####### #$#$#</L>
      <L>###$$  $  #    #  $   #</L>
      <L>  #    ####    # $  ###</L>
      <L>  ######       #  ###</L>
      <L>               ####</L>
    </Level>
    <Level Id="MF8 12th Sokoban Competition" Width="30" Height="24" Copyright="Jordi Doménech, Gyjgw, stopheart">
      <L>      #####  #####</L>
      <L> ######.. ####.  #####  ######</L>
      <L> #@ $  .$.$.. .#*  .######   #</L>
      <L> #$###.$ #.*..*.  $   $      #</L>
      <L> # ###   # ## ..#* ######## ##</L>
      <L> # .#### #$ $ ###  ######## #</L>
      <L>##.$ ..* #  $##### ######.*.#</L>
      <L>#. .#.*.$.   # $  .####..$..#</L>
      <L>#.$##**####    # ## $  $ # ##</L>
      <L># $.# .#. ##$$ # $    ## #$.#</L>
      <L>#.  .#    ##   ##  # ##  #. #</L>
      <L>####.* # .###$ ##$ #  $ ##. #</L>
      <L>   #  .**### $ ##  ## # ##* #</L>
      <L>  ###.$#      $ #$ ##  $ #. #</L>
      <L>  #  $ # $ $ #    $##  $.** #</L>
      <L>  #$  ###### ####$ ##  # #  #</L>
      <L>  #.$$.#       ##   #### #* #</L>
      <L>  ##  .#$$$#$$$## #  $   #  #</L>
      <L>  #   #           #  $# ##*##</L>
      <L>  # $## ######### #$  $     #</L>
      <L>  #   ..#       #   $ $##*. #</L>
      <L>  #######       ### $   $ # #</L>
      <L>                  #######.  #</L>
      <L>                        #####</L>
    </Level>
    <Level Id="5.3.20" Width="26" Height="24" Copyright="Christian Eggermont, anian, stopheart">
      <L>       #####   #####</L>
      <L>       #   #####   ##</L>
      <L>       #$# #   # $  #</L>
      <L>  #### #@$ $    $ # #</L>
      <L>  #  ### # ######   #</L>
      <L>  #    $   ####  $.#######</L>
      <L>  # $####### . . #.#     #</L>
      <L> ###.##...## .$$##.*.. # #</L>
      <L> #......*..# *  .$.*## $ #</L>
      <L> # *####......## #.*  $#.#</L>
      <L> #.. #  #****### ### $  .#</L>
      <L> #.*.# ....#..   #  ####.#</L>
      <L> ##$ #$.####.## $$ $     #</L>
      <L>  #  #  #  #  #  #  # ####</L>
      <L>  #.##$ #$ ##$### .# $#</L>
      <L>###*   $  $    ## ##$ #</L>
      <L>#   #####  $$#  #$ $  #</L>
      <L># $     # $  #  $   $ #</L>
      <L>#  #$$  #  $ #  $#    #</L>
      <L># $   $ # $$ ###    ###</L>
      <L>#  $   # $  $# ######</L>
      <L>##  #### $   #</L>
      <L> ####  #   ###</L>
      <L>       ######</L>
    </Level>
    <Level Id="MF8 14th Sokoban Competition" Width="21" Height="23" Copyright="Marko Dzekic, minglw, Gyjgw, stopheart">
      <L>#####</L>
      <L># . #################</L>
      <L># $                 #</L>
      <L>##*##### $ ###### #*#</L>
      <L> # ##### $      #  .#</L>
      <L> #  ##### ##### $ #.#</L>
      <L> #$ ...$..#####$  # #</L>
      <L> #   *###.##### # $$#</L>
      <L> #.#*...*.#####   # #</L>
      <L> # ...## #### $ #   #</L>
      <L> ####### ###  $ # #$#</L>
      <L>  # $  $*## $ $$# # #</L>
      <L>###..* #  $  $  $ # #</L>
      <L>#  ..*....#  $  $   #</L>
      <L># $#***##.##$ $$ $#$#</L>
      <L>#     $@$  #      # #</L>
      <L>##*.#$#$$# ########.#</L>
      <L> # ..$...# ####    .#</L>
      <L> ##.##$# # ## $ $$#*#</L>
      <L> ##. #.  $          #</L>
      <L>  #. $. ## # #### #$#</L>
      <L>  #.* *.   #        #</L>
      <L>  ###################</L>
    </Level>
    <Level Id="MF8 15th Sokoban Competition" Width="29" Height="29" Copyright="stopheart, York Shen">
      <L>     ##################</L>
      <L>     #  #@ ########   #</L>
      <L>     #   $ ##         #</L>
      <L>     #  #  ##$###### ####</L>
      <L>     ##.# ##  #   # $ . #</L>
      <L>####  # #  #   $# #   # #</L>
      <L>#  #### ##*# ##    #### #</L>
      <L># .*    # .$$ # $$ #### #</L>
      <L>#  $$$ ## .$  # $  #    #</L>
      <L>##*# ##  $.#  #$  #  ######</L>
      <L> #.  ## $.. ##  $ # #     #</L>
      <L> # # ####  $     ## #.##**##</L>
      <L> #  ..  ###### #### .  $   #</L>
      <L> #####$ ... $ .... # * #$  #</L>
      <L>  #  .  ##$.###### ## .  ###</L>
      <L>  # ##*#   $ #####.$ $ ###</L>
      <L>###$ ..#.#  $   ##.  .#  #</L>
      <L>#  ..#.# $$* ##  ## ### .####</L>
      <L># $$$ $ .. . ###  #   $* .  #</L>
      <L>###. $ #####$####$#*### .*. #</L>
      <L> #  ####   .     .*  ##*  ###</L>
      <L>## ##### ##.##### ##  * .##</L>
      <L>#      #..$. #### ### #  #</L>
      <L># $$#  $..#..$        ####</L>
      <L>#    $$## ####### #$#$#</L>
      <L>###$$  $  #    #  $   #</L>
      <L>  #    ####    #    ###</L>
      <L>  ######       #  ###</L>
      <L>               ####</L>
    </Level>
    <Level Id="MF8 16th Sokoban Competition" Width="25" Height="21" Copyright="Gyjgw">
      <L>#########################</L>
      <L>#                       #</L>
      <L># ### .###### ** ###### #</L>
      <L># ### * #####  **  #### #</L>
      <L># ###** ######   *  #.  #</L>
      <L>#    *      **********# #</L>
      <L># *********             #</L>
      <L>#   *     ##  **# * ### #</L>
      <L># # * ## * # **   **  # #</L>
      <L>#  ** ## * # * ####** # #</L>
      <L># #$. ## *  ** ###  **  #</L>
      <L>#  **   ** ** *  # * ** #</L>
      <L># # ** **     **   *    #</L>
      <L>#    ***   # # ** *  ####</L>
      <L>##### *  # $    *** #####</L>
      <L>#    * ** # ## ** **  ###</L>
      <L># # **  **    **   **  ##</L>
      <L># @**    **$ **  ## **  #</L>
      <L># ** ##### #**## ### ** #</L>
      <L>#                       #</L>
      <L>#########################</L>
    </Level>
    <Level Id="MF8 17th Sokoban Competition" Width="20" Height="27" Copyright="Gyjgw, stopheart">
      <L>####################</L>
      <L>#                  #</L>
      <L># ** * * * * * * * #</L>
      <L>#  ##############*##</L>
      <L># *##          ##  #</L>
      <L>#  ###  **$ **@# * #</L>
      <L># **  **  **  ##*  #</L>
      <L>#   **  **   ### * #</L>
      <L># **  **  ** #  *  #</L>
      <L>#   **  **  ## *.* #</L>
      <L># **  **  *## * *  #</L>
      <L>#   **  ** # * * * #</L>
      <L># **  **  ##* * *  #</L>
      <L>#   **   ##  * * * #</L>
      <L># **  **##  * * *  #</L>
      <L>#   **  #  * * * * #</L>
      <L># **  *## *** * *  #</L>
      <L>#   ** # * * * * * #</L>
      <L># **   #* * * * *  #</L>
      <L>#   **##.* * *.* * #</L>
      <L># **  # * * * * *  #</L>
      <L>#   **#. *** * * * #</L>
      <L># **  #** * * * *  #</L>
      <L>#   *$#. * * * * * #</L>
      <L># *** #$* *$* * *$ #</L>
      <L>#     *            #</L>
      <L>####################</L>
    </Level>
    <Level Id="MF8 18th Sokoban Competition" Width="21" Height="21" Copyright="David Holland, stopheart, Gyjgw">
      <L>             ####</L>
      <L>    ####     #  ##</L>
      <L>    #  #######   ##</L>
      <L>  ###$ # $     $  #</L>
      <L>### $   $ $#### $ #</L>
      <L>#     ##   #   # $#</L>
      <L>#  $ #  ####$#  # ##</L>
      <L># $ ##.* .*.* # #  ##</L>
      <L>###.    $ # ..  #$  #</L>
      <L>  #.$$#   #.**.## $ #</L>
      <L>  #.$.####### ## $  #</L>
      <L>  #.$.   #. $ $ $  ##</L>
      <L>  #*## $  .## @   ##</L>
      <L>  #  . $##. ## ####</L>
      <L>  #.$#  # ..##  #</L>
      <L>  ## ####$.*..$ #</L>
      <L>  ## ##..*.###  #</L>
      <L>  #.   *.**## $##</L>
      <L>  #   ####  #  ##</L>
      <L>  #####  ##    #</L>
      <L>          ######</L>
    </Level>
    <Level Id="MF8 19th Sokoban Competition" Width="24" Height="29" Copyright="Tui Leshan, stopheart">
      <L>  ####</L>
      <L>  #  #</L>
      <L>  #$ #</L>
      <L>  #  #</L>
      <L>  #$ #</L>
      <L>  #  #   ####</L>
      <L>  #$ #####  ########</L>
      <L>  #  ##  $.$##  . .###</L>
      <L>  #$ ##  . * $ # #   #</L>
      <L>  #    . #.#.$ # .$  #</L>
      <L>  #$#$$# $   ## ..# ###</L>
      <L>  #    ####* *  #.$$* #</L>
      <L> ##$ $$# $ .######.$ .##</L>
      <L> #     # $  #   #  $#  #</L>
      <L> # ### #   *# $$#$# ## #</L>
      <L> #  .$.####.#   #.     #</L>
      <L> #.*#.*. *.+.*..*.# # ##</L>
      <L> #  . #   #.#### .. $$#</L>
      <L> ## #$#$$ #*   #$## $ #</L>
      <L>###...#   #  $ #    # #</L>
      <L># .$ ######. $ #$##$# #</L>
      <L>#  * ####.**####... ..#</L>
      <L>#### $.#      *  # ####</L>
      <L>  #  #...# ## ##.$$$ #</L>
      <L>  #.$# $   $         #</L>
      <L>  # $.  # $# ##$.#####</L>
      <L>  #  #### $ $##  #</L>
      <L>  ####  ##   #####</L>
      <L>         #####</L>
    </Level>
  </LevelCollection>
</SokobanLevels>
