<?xml version="1.0" encoding="utf-8"?>
<SokobanLevels xmlns:xsi="http://www.w3.org/2001/XMLSchema-instance" xsi:schemaLocation="SokobanLev.xsd">
  <Title>Mill Remodel</Title>
  <Description>
The levels in this set were collected, documented and published by
Sokoplaza members. Collection supervisor: Mark (general supervisor and
author, coauthored by Anian, original Mill level by Dries de Clercq).
  </Description>
  <Email>de3s@hotmail.com</Email>
  <LevelCollection Copyright="Dries de Clercq, Mark, anian" MaxWidth="42" MaxHeight="41">
    <Level Id="Big Mill a" Width="40" Height="41">
      <L> ####     ####                     ####</L>
      <L>##  #######  ## ####################  ##</L>
      <L>#   *   *  *  # #      .   .   .     . #</L>
      <L>#     *   * # # # $ * * * * * * * ###  #</L>
      <L>## ########## #### # * * * * * * *. # ##</L>
      <L> # #        #      #  * $ * $ * $ $ # #</L>
      <L> # # ## ########## ############# ## # #</L>
      <L> # # # $ * * *  *     . * * * *   # # #</L>
      <L> # #   #   #   ## #####$  #   # #*  # #</L>
      <L> #   #   #####          #####     #   #</L>
      <L> ### # #   #  $# # ####.  ###* # *# ###</L>
      <L>   # # * * * * . *    $ *  ##  #  # #</L>
      <L>   # #* ######* ####$####  ##*###*# #</L>
      <L>   # #  ######  #  .   ##*###  #  # #</L>
      <L> ### #*###  ##* # $# $ #  ###* # *# ###</L>
      <L>##   #  # $ .   #.  .  #  * * *   #   ##</L>
      <L>#  * #* # .##  ##########     # # # *  #</L>
      <L># * *#   * ######  #   ######   #*#* * #</L>
      <L>#* * #*# #$#   #@$    $##.  #*#   # * *#</L>
      <L># *    #   #.$ # *.*.   # $ #   #    * #</L>
      <L>#  * # # # $  .# *$$*## $  .# # # # *  #</L>
      <L># *  # # # #.$ # ....#  # $ # # # #  * #</L>
      <L>#* * #   #.# $.### $$## #  .# # #*# * *#</L>
      <L># * *#*#   #########    ##### *   #* * #</L>
      <L>#  * # # #$    ######$###  ##* # *# *  #</L>
      <L>##   #   . * *  #      #   *   #  #   ##</L>
      <L> ### #* # *###  # $##  # *##  ###*# ###</L>
      <L>   # #  #  ###*##  . . #  ######  # #</L>
      <L>   # #*###*##  ##### ### *###### *# #</L>
      <L>   # #  #  ##  * *    * $ * * * * # #</L>
      <L> ### #* # *###   # #### #.  #   # # ###</L>
      <L> #   #     #####          #####   #   #</L>
      <L> # #   # #.  #   ##### ##$  #   #   # #</L>
      <L> # # # * $ * * * *     .  * * * * # # #</L>
      <L> # # ## ############# ########## ## # #</L>
      <L> # # $ $ * $ * $ *  #      #        # #</L>
      <L>## # .* * * * * * * # #### ########## ##</L>
      <L>#  ### * * * * * * * $ # # # *   *     #</L>
      <L># .     .   .   .      # #  *  *   *   #</L>
      <L>##  #################### ##  #######  ##</L>
      <L> ####                     ####     ####</L>
    </Level>
    <Level Id="Big Mill a (plus 1 box by Mark)" Width="41" Height="41">
      <L> ####     ####                     ####</L>
      <L>##  #######  ## ####################  ##</L>
      <L>#   *   *  *  # #      .   .   .     . #</L>
      <L>#     *   * # # # $ * * * * * * * ###  #</L>
      <L>## ########## #### # * * * * * * *. # ##</L>
      <L> # #        #      #  * $ * $ * $ $ # #</L>
      <L> # # ## ########## ############# ## # #</L>
      <L> # # # $ * * *  *     . * * * *   #.# ###</L>
      <L> # #   #   #   ## #####$  #   # #*  #   #</L>
      <L> #   #   #####          #####     #   $ #</L>
      <L> ### # #   #  $# # ####.  ###* # *# #####</L>
      <L>   # # * * * * . *    $ *  ##  #  # #</L>
      <L>   # #* ######* ####$####  ##*###*# #</L>
      <L>   # #  ######  #  .   ##*###  #  # #</L>
      <L> ### #*###  ##* # $# $ #  ###* # *# ###</L>
      <L>##   #  # $ .   #.  .  #  * * *   #   ##</L>
      <L>#  * #* # .##  ##########     # # # *  #</L>
      <L># * *#   * ######  #   ######   #*#* * #</L>
      <L>#* * #*# #$#   #@$    $##.  #*#   # * *#</L>
      <L># *    #   #.$ # *.*.   # $ #   #    * #</L>
      <L>#  * # # # $  .# *$$*## $  .# # # # *  #</L>
      <L># *  # # # #.$ # ....#  # $ # # # #  * #</L>
      <L>#* * #   #.# $.### $$## #  .# # #*# * *#</L>
      <L># * *#*#   #########    ##### *   #* * #</L>
      <L>#  * # # #$    ######$###  ##* # *# *  #</L>
      <L>##   #   . * *  #      #   *   #  #   ##</L>
      <L> ### #* # *###  # $##  # *##  ###*# ###</L>
      <L>   # #  #  ###*##  . . #  ######  # #</L>
      <L>   # #*###*##  ##### ### *###### *# #</L>
      <L>   # #  #  ##  * *    * $ * * * * # #</L>
      <L> ### #* # *###   # #### #.  #   # # ###</L>
      <L> #   #     #####          #####   #   #</L>
      <L> # #   # #.  #   ##### ##$  #   #   # #</L>
      <L> # # # * $ * * * *     .  * * * * # # #</L>
      <L> # # ## ############# ########## ## # #</L>
      <L> # # $ $ * $ * $ *  #      #        # #</L>
      <L>## # .* * * * * * * # #### ########## ##</L>
      <L>#  ### * * * * * * * $ # # # *   *     #</L>
      <L># .     .   .   .      # #  *  *   *   #</L>
      <L>##  #################### ##  #######  ##</L>
      <L> ####                     ####     ####</L>
    </Level>
    <Level Id="Big Mill b (more changes by Mark)" Width="42" Height="41">
      <L>  ####     ####                     ####</L>
      <L> ##  #######  ## ####################  ##</L>
      <L> #   *   *  *  # #      .   .   .     . #</L>
      <L> #     *   * # # # $ * * * * * * * ###  #</L>
      <L> ## ########## #### # * * * * * * *. # ##</L>
      <L>  # #        #      #  * $ * $ * $ $ # #</L>
      <L>  # # ## ########## ############# ## # #</L>
      <L>  # # # * * * *  *       * * * *   #.# ###</L>
      <L>  # #   #   #   ## #####*  #   # #*  #   #</L>
      <L>  #   #   #####          #####     #   $ #</L>
      <L>  ### #.#   #  $# # ####   ###* # *# #####</L>
      <L>    # # $ * * * . *    * *  ##  #  # #</L>
      <L>    # #* ######* ####$####  ##*###*# #</L>
      <L>    # #  ######  #  .   ##*###  #  # #</L>
      <L>  ### #*###  ##* # $# $ #  ###* # *# ###</L>
      <L> ##   #  # $ .   #.  .  #  * * *   #   ##</L>
      <L> #  * #* # .##  ##########     # # # *  #</L>
      <L> # * *#   * ######   *  ######   #*#* * #</L>
      <L> #* * #*# #$#   # . * *  #.  #*#   # * *#</L>
      <L> # *    #   #.$ #  * * * # $ #   #    * #</L>
      <L> #  * # # # $  .# * * *  #.  $ # # # *  #</L>
      <L> # *  # # # #.$ #  * * * # $ # # # #  * #</L>
      <L> #* * #   #.# $.# * * *  #  .# # #*# * *#</L>
      <L> # * *#*#   #####  $ $ . ##### *   #* * #</L>
      <L> #  * # # #$    ##### ####  ##* # *# *  #</L>
      <L> ##   #   . * *  #  @.  #   *   #  #   ##</L>
      <L>  ### #* # *###  # $##$ # *##  ###*# ###</L>
      <L>    # #  #  ###*##   .  #  ######  # #</L>
      <L>    # #*###*##  ##### ### *###### *# #</L>
      <L>    # #  #  ##  * *    * $ * * * * # #</L>
      <L>##### #$ # *###   # #### #.  #   # # ###</L>
      <L># $   #     #####          #####   #   #</L>
      <L>#   #   # #.  #   ##### ##$  #   #   # #</L>
      <L>### #.# * $ * * * *     .  * * * * # # #</L>
      <L>  # # ## ############# ########## ## # #</L>
      <L>  # # $ $ * $ * $ *  #      #        # #</L>
      <L> ## # .* * * * * * * # #### ########## ##</L>
      <L> #  ### * * * * * * * $ # # # *   *     #</L>
      <L> # .     .   .   .      # #  *  *   *   #</L>
      <L> ##  #################### ##  #######  ##</L>
      <L>  ####                     ####     ####</L>
    </Level>
    <Level Id="Big Mill c (more boxes in frame)" Width="40" Height="41">
      <L> ####     ####                     ####</L>
      <L>##  #######  ## ####################  ##</L>
      <L>#   *   *  *  # #      .   .   .     . #</L>
      <L>#     *   * # # # $ * * * * * * * ###  #</L>
      <L>## ########## #### # * * * * * * *. # ##</L>
      <L> # #        #      #  * $ * $ * $ $ # #</L>
      <L> # # ## ########## ############# ## # #</L>
      <L> # # # * * * *  *       * * * *   # # #</L>
      <L> # #   #   #   ## #####*  #   # #*  # #</L>
      <L> #   #   #####          #####     #   #</L>
      <L> ### #.#   #  $# # ####   ###* # *# ###</L>
      <L>##   # $ * * * . *    * *  ##  #  #   ##</L>
      <L>#  * #* ######* ####$####  ##*###*# *  #</L>
      <L># * *#  ######  #  .   ##*###  #  #* * #</L>
      <L>#* * #*###  ##* # $# $ #  ###* # *# * *#</L>
      <L># *  #  # $ .   #.  .  #  * * *   #  * #</L>
      <L>#  * #* # .##  ##########     # # # *  #</L>
      <L># * *#   * ###### *    ######   #*#* * #</L>
      <L>#* * #*# #$#   # * * $  #.  #*#   # * *#</L>
      <L># *    #   #.$ #  * * * # $ #   #    * #</L>
      <L>#  * # # # $  .# * * *  #.  $ # # # *  #</L>
      <L># *  # # # #.$ #  * * * # $ # # # #  * #</L>
      <L>#* * #   #.# $.# * * *  #  .# # #*# * *#</L>
      <L># * *#*#   #####  .   * ##### *   #* * #</L>
      <L>#  * # # #$    ##### ####  ##* # *# *  #</L>
      <L># *  #   . * *  #  +   #   *   #  #  * #</L>
      <L>#* * #* # *###  # $##$ # *##  ###*# * *#</L>
      <L># * *#  #  ###*##   .  #  ######  #* * #</L>
      <L>#  * #*###*##  ##### ### *###### *# *  #</L>
      <L>##   #  #  ##  * *    * $ * * * * #   ##</L>
      <L> ### #$ # *###   # #### #.  #   # # ###</L>
      <L> #   #     #####          #####   #   #</L>
      <L> # #   # #.  #   ##### ##$  #   #   # #</L>
      <L> # # # * $ * * * *     .  * * * * # # #</L>
      <L> # # ## ############# ########## ## # #</L>
      <L> # # $ $ * $ * $ *  #      #        # #</L>
      <L>## # .* * * * * * * # #### ########## ##</L>
      <L>#  ### * * * * * * * $ # # # *   *     #</L>
      <L># .     .   .   .      # #  *  *   *   #</L>
      <L>##  #################### ##  #######  ##</L>
      <L> ####                     ####     ####</L>
    </Level>
    <Level Id="Big Mill d (plus 4 boxes)" Width="42" Height="41">
      <L>  ####     ####                     ####</L>
      <L> ##  #######  ## ####################  ##</L>
      <L> #   *   *  *  # #      .   .   .     . #</L>
      <L> #     *   * # # # $ * * * * * * * ###  #</L>
      <L> ## ########## #### # * * * * * * *. # ##</L>
      <L>  # #        #      #  * $ * $ * $ $ # #</L>
      <L>  # # ## ########## ############# ## # #</L>
      <L>### #.# * * * *  *       * * * *   #.# ###</L>
      <L>#   #   #   #   ## #####*  #   # #*  #   #</L>
      <L># $   #   #####          #####     #   $ #</L>
      <L>##### #.#   #  $# # ####   ###* # *# #####</L>
      <L> ##   # $ * * * . *    * *  ##  #  #   ##</L>
      <L> #  * #* ######* ####$####  ##*###*# *  #</L>
      <L> # * *#  ######  #  .   ##*###  #  #* * #</L>
      <L> #* * #*###  ##* # $# $ #  ###* # *# * *#</L>
      <L> # *  #  # $ .   #.  .  #  * * *   #  * #</L>
      <L> #  * #* # .##  ##########     # #   *  #</L>
      <L> # * *#   * ###### *    ######   #*#* * #</L>
      <L> #* * #*# #$#   # . * *  #.  #*#   # * *#</L>
      <L> # *    #   #.$ #  * * * # $ #   #    * #</L>
      <L> #  * # # # $  .# * * *  #.  $ # # # *  #</L>
      <L> # *  # # # #.$ #  * * * # $ # # # #  * #</L>
      <L> #* * #   #.# $.# * * *  #  .# # #*# * *#</L>
      <L> # * *#*#   #####    $ * ##### *   #* * #</L>
      <L> #  *   # #$    ##### ####  ##* # *# *  #</L>
      <L> # *  #   . * *  #  @.  #   *   #  #  * #</L>
      <L> #* * #* # *###  # $##$ # *##  ###*# * *#</L>
      <L> # * *#  #  ###*##   .  #  ######  #* * #</L>
      <L> #  * #*###*##  ##### ### *###### *# *  #</L>
      <L> ##   #  #  ##  * *    * $ * * * * #   ##</L>
      <L>##### #$ # *###   # #### #.  #   # # #####</L>
      <L># $   #     #####          #####   #   $ #</L>
      <L>#   #   # #.  #   ##### ##$  #   #   #   #</L>
      <L>### #.# * $ * * * *     .  * * * * #.# ###</L>
      <L>  # # ## ############# ########## ## # #</L>
      <L>  # # $ $ * $ * $ *  #      #        # #</L>
      <L> ## # .* * * * * * * # #### ########## ##</L>
      <L> #  ### * * * * * * * $ # # # *   *     #</L>
      <L> # .     .   .   .      # #  *  *   *   #</L>
      <L> ##  #################### ##  #######  ##</L>
      <L>  ####                     ####     ####</L>
    </Level>
  </LevelCollection>
</SokobanLevels>
