<?xml version="1.0" encoding="utf-8"?>
<SokobanLevels xmlns:xsi="http://www.w3.org/2001/XMLSchema-instance" xsi:schemaLocation="SokobanLev.xsd">
  <Title>Mill</Title>
  <Description>
Mill by Dries de Clercq
  </Description>
  <Email>de3s@hotmail.com</Email>
  <LevelCollection Copyright="Dries de Clercq" MaxWidth="31" MaxHeight="31">
    <Level Id="mill-134" Width="31" Height="31">
      <L>###############################</L>
      <L>#                             #</L>
      <L># ## ########## ########## ## #</L>
      <L># #   * * *  *  * * * * *   # #</L>
      <L>#   #   #   ## ##   #   # #*  #</L>
      <L># #   #####       #####     # #</L>
      <L># # #   #   # # #*  ###* # *# #</L>
      <L># # * * * * * *   *  ##  #  # #</L>
      <L># #* ######* ######  ##*###*# #</L>
      <L># #  ######  #  ###*###  #  # #</L>
      <L># #*###  ##* #  ##  ###* # *# #</L>
      <L># #  #   *   #  ##  * * *   # #</L>
      <L># #* # *##  ##  ###     # # # #</L>
      <L># # $ . ######  #######   #*# #</L>
      <L># #.# #$######        #*#   # #</L>
      <L>#   #   #             #   #   #</L>
      <L># #   #*#        ###### # #*# #</L>
      <L># #*#   #######  ###### *   # #</L>
      <L># # # #     ###  ## @##* # *# #</L>
      <L># #   * * *  ##  #   *   #  # #</L>
      <L># #* # *###  ##  # *##  ###*# #</L>
      <L># #  #  ###*###  #  ######  # #</L>
      <L># #*###*##  ###### *###### *# #</L>
      <L># #  #  ##  * * *   * * * * # #</L>
      <L># #* # *###   # # #*  #   # # #</L>
      <L># #     #####       #####   # #</L>
      <L>#  $# #.  #   ## ##   #   #   #</L>
      <L># # . $ * * * *  *  * * * * # #</L>
      <L># ## ########## ########## ## #</L>
      <L>#                             #</L>
      <L>###############################</L>
    </Level>
  </LevelCollection>
</SokobanLevels>
