<?xml version="1.0" encoding="utf-8"?>
<SokobanLevels xmlns:xsi="http://www.w3.org/2001/XMLSchema-instance" xsi:schemaLocation="SokobanLev.xsd">
  <Title>Mitija 3</Title>
  <Description>
Mitija 3 collection by Milutin Negovanovic
  </Description>
  <Email>miltutinnegovanovic@gmail.com</Email>
  <LevelCollection Copyright="Milutin Negovanovic" MaxWidth="47" MaxHeight="25">
    <Level Id="1" Width="31" Height="20">
      <L>###############################</L>
      <L>#                             #</L>
      <L>#   *   $$$  $  $ $$$  $ $  $ #</L>
      <L>#  **   $  $ $  $ $  $ $ $  $ #</L>
      <L># * *   $  $ $  $ $  $ $ $$ $ #</L>
      <L>#   *   $$$  $  $ $  $ $ $ $$ #</L>
      <L>#   *   $  $ $  $ $ @$ $ $  $ #</L>
      <L>#   *   $  $ $  $ $  $ $ $  $ #</L>
      <L>#   * * $$$   $$  $$$  $ $  $ #</L>
      <L>###              #         ####</L>
      <L>  # # ######################</L>
      <L>  #   #    #     #</L>
      <L>  #    ..........#</L>
      <L>  #####..........#</L>
      <L>      #..........#</L>
      <L>      #..........#</L>
      <L>      #..........#</L>
      <L>      #..........#</L>
      <L>      #..........#</L>
      <L>      ############</L>
    </Level>
    <Level Id="2" Width="39" Height="13">
      <L> #########</L>
      <L> #      ##</L>
      <L> #  $$$  #############################</L>
      <L>## $...$     #            #          #</L>
      <L>## ....$ # *   * **** ***   **  *  * #</L>
      <L>## ....$   ** ** *    *  * *  * *  * ##</L>
      <L>## ...$  # * * * *    *  * *  * ** * ##</L>
      <L>## ..$     *   * **** *  * **** * ** ##</L>
      <L>##  $    # * @ * *    *  * *  * *  * ##</L>
      <L>## $       *   * *    *  * *  * *  * #</L>
      <L>## $$$$$ # *   * **** ***  *  * *  * #</L>
      <L>##      ##############################</L>
      <L> ########</L>
    </Level>
    <Level Id="3" Width="28" Height="13">
      <L> #######</L>
      <L>##     ###  ################</L>
      <L>#  $$$   ####         #    #</L>
      <L># $   $ *     **  *  * ****#</L>
      <L># ....$ *    *  * *  * *   #</L>
      <L># ....$ *    *@ * ** * *   #</L>
      <L># .$$$  *    **** * ** ***##</L>
      <L># ....$ *    *  * *  * *   #</L>
      <L># ....$ *    *  * *  * *   #</L>
      <L># $   $ **** *  * *  * ****#</L>
      <L>#  $$$                     #</L>
      <L>##     #####################</L>
      <L> ########</L>
    </Level>
    <Level Id="4" Width="34" Height="12">
      <L>    ######</L>
      <L>#####    #########################</L>
      <L># ##  $$        #                #</L>
      <L>###  $.$  **  *   * *** ***  **  #</L>
      <L> #  $..$ *  * * # * *    *  *  * #</L>
      <L> # $...$ *    *   * *    *  *  * #</L>
      <L>## $$$$$  **  * # * ***  *  *@ * #</L>
      <L>###....$    * *   * *    *  *  * #</L>
      <L># # ...$ *  *  * *  *    *  *  * #</L>
      <L>###  ..$  **    *   ***  *   **  #</L>
      <L>  ### .$.       #        #       #</L>
      <L>   ###############################</L>
    </Level>
    <Level Id="5" Width="35" Height="11">
      <L>   ##############################</L>
      <L>  ##                            ###</L>
      <L> ### $$$$ *  *  **  *   ***   **  #</L>
      <L>## # $... *  * *@ * *   *  * *  * #</L>
      <L>#  # $$$. * *  *  * *   *  * *  * #</L>
      <L>#### ...$ **   **** *   *  * *  * #</L>
      <L>#  # ...$ * *  *  * *   *  * *  * #</L>
      <L>## # $..$ *  * *  * *   *  * *  * #</L>
      <L> ### .$$. *  * *  * *** ***   **  #</L>
      <L>  ##                             ##</L>
      <L>   ###############################</L>
    </Level>
    <Level Id="6" Width="24" Height="12">
      <L>########################</L>
      <L>##       #             #</L>
      <L>#.$$$$ *   * * * # ****#</L>
      <L>#.$... ** ** * *   *   #</L>
      <L>#.$... * * * * * # *   #</L>
      <L>#.$$$$ *   * * *   *** #</L>
      <L>#.$..$ *   * * * # *   #</L>
      <L>#.$.+$ *   * * *   *   #</L>
      <L>#.$..$ * # * * *** ****#</L>
      <L>#.$$$$   #             #</L>
      <L>#      #################</L>
      <L>########  ##  ###  ## ##</L>
    </Level>
    <Level Id="7" Width="34" Height="12">
      <L>  ########</L>
      <L>###      #########################</L>
      <L>##.$$$$$              #          #</L>
      <L>#......$ ***  ***  **   **  *  * #</L>
      <L>## #..$  *  * *   *  * *  * *  * #</L>
      <L>## ..$   *  * *   *    *  * ** * #</L>
      <L>## .$    ***  *** * ** **** * ** #</L>
      <L>## $     *  * *   *  * *  * *  * #</L>
      <L>#  $     *  * *   *  * *  * *  * #</L>
      <L>#@ $ #   ***  ***  **  *  * *  * #</L>
      <L>##                    #          #</L>
      <L>##################################</L>
    </Level>
    <Level Id="8" Width="47" Height="25">
      <L>#####</L>
      <L>### ###########</L>
      <L>#####        ##################################</L>
      <L>#   #  $$$$  #                               ##</L>
      <L># ### $....$    *   * * *   *  * ***** * *  * #</L>
      <L>### # $....$ #  ** ** * *   *  *   *   * *  * #</L>
      <L>##  # $....$    * * * * *   *  *   *   * ** * #</L>
      <L>#   #  $$$$  #@ *   * * *   *  *   *   * * ** #</L>
      <L>##  # $....$    *   * * *   *  *   *   * *  * #</L>
      <L>### # $....$ #  *   * * *   *  *   *   * *  * #</L>
      <L># ### $....$    *   * * ***  **    *   * *  * #</L>
      <L>#   #  $$$$  #                                #</L>
      <L>## ##        ##################################</L>
      <L>############### # # # # # # # # # # # # # # ##</L>
      <L>######      ## # # # # # # # # # # # # # # ###</L>
      <L>#                #</L>
      <L># #     # #    # #</L>
      <L># ##   ## #    # #</L>
      <L># # # # # #    # #</L>
      <L># #  #  # ###### #</L>
      <L># #     # #    # #</L>
      <L># #     # #    # #</L>
      <L># #     # #    # #</L>
      <L>#                #</L>
      <L>##################</L>
    </Level>
    <Level Id="9" Width="29" Height="13">
      <L> #######</L>
      <L>##     ######################</L>
      <L>#  $$$                      #</L>
      <L># $...$   ***  **  *   **** #</L>
      <L># $...$  *    *  * *   *    #</L>
      <L># $...$  *    *  * *   *    #</L>
      <L>#@ $$$$  *    *  * *   **** #</L>
      <L># ....$  *    *  * *   *    #</L>
      <L># ....$  *    *  * *   *    #</L>
      <L># $...$   ***  **  *** **** #</L>
      <L>#  $$$                      #</L>
      <L>##     ######################</L>
      <L> #######</L>
    </Level>
    <Level Id="10" Width="33" Height="12">
      <L>  ###                        ##</L>
      <L>  ##############################</L>
      <L> ##                            ##</L>
      <L>###  $  $$  ***  *** ***   **  ##</L>
      <L>#.. $$ $..$ *@ * *   *  * *  * #</L>
      <L>#..$.$ $..$ *  * *   *  * *  * #</L>
      <L>#....$ $..$ ***  *** ***  *  * #</L>
      <L>#....$ $..$ *    *   *  * *  * #</L>
      <L>###  $ $..$ *    *   *  * *  * #</L>
      <L> ##  $  $$  *    *** *  *  **  ##</L>
      <L> ##                           ###</L>
      <L>  ##############################</L>
    </Level>
    <Level Id="11" Width="36" Height="15">
      <L>                #</L>
      <L>               ###</L>
      <L>             #######</L>
      <L>    ##########     #</L>
      <L>   ##          * * ################</L>
      <L>  ##..$....$    *                 ##</L>
      <L> ##..$$...$$   ***  **   ***   **  #</L>
      <L>##..$.$..$.$  *    *  *  *  * *  * #</L>
      <L>##.$..$.$ .$  *    *  *  *  * *  * #</L>
      <L>###   $    $  *    **** *** * *  * #</L>
      <L> ##   $ @  $  *    *  *  *  * *  * #</L>
      <L>  #   $    $  *    *  *  *  * *  * #</L>
      <L>  #   $    $   *** *  *  ***   **  #</L>
      <L>  #                               ##</L>
      <L>  #################################</L>
    </Level>
    <Level Id="12" Width="14" Height="19">
      <L>  ########</L>
      <L>  ##    ##</L>
      <L>  ## # $##</L>
      <L>  #  ..* #</L>
      <L>  # #*#* #</L>
      <L>  #  $@* #</L>
      <L>  ## $$* #</L>
      <L>  #   .$ #</L>
      <L>  # #.$# #</L>
      <L>  # $... #</L>
      <L>  # ##   #</L>
      <L>### ##########</L>
      <L>###    ##.   #</L>
      <L># $$ #  $ $$ #</L>
      <L># $. ##*#.#  #</L>
      <L>#. # ##.  # ##</L>
      <L>#.   #   . $#</L>
      <L>###  #   $. #</L>
      <L>#############</L>
    </Level>
    <Level Id="13" Width="15" Height="9">
      <L>###############</L>
      <L>#       @ *  ##</L>
      <L># ####. # $#  #</L>
      <L># #   * # $ . #</L>
      <L># # # * #.   ##</L>
      <L># *   * #######</L>
      <L># $**** ##</L>
      <L>##      #</L>
      <L>#########</L>
    </Level>
    <Level Id="14" Width="16" Height="20">
      <L>################</L>
      <L>#          #####</L>
      <L># ## #$### #####</L>
      <L># ##  * ## #####</L>
      <L># ###   #  @ ###</L>
      <L>#  ### ### #  ##</L>
      <L># *   ** #$.# ##</L>
      <L>#  * # #  $.# ##</L>
      <L># * ## # #$.# ##</L>
      <L>#  ### # #    ##</L>
      <L># * #  #  # ####</L>
      <L># * #  ##   ####</L>
      <L>#  *  ### ######</L>
      <L># *  #### ##.#.#</L>
      <L>#   #.. #      #</L>
      <L># *#.$ $#$ $$$ #</L>
      <L>#   $.       #.#</L>
      <L>### #..###$### #</L>
      <L>###    ###     #</L>
      <L>################</L>
    </Level>
    <Level Id="15" Width="19" Height="11">
      <L>      #############</L>
      <L>      #####   #####</L>
      <L>  ######   @$  ####</L>
      <L>  #    # # # #   ##</L>
      <L>### #$.$ # $ $ #  #</L>
      <L>## .$. # ## #$ $  #</L>
      <L>#   *  $ ##$ * #  #</L>
      <L>#  .$.#$## .###. ##</L>
      <L>## #     # .$.$. ##</L>
      <L> #   #.  # . . . ##</L>
      <L> ##################</L>
    </Level>
    <Level Id="16" Width="10" Height="24">
      <L>#######</L>
      <L>##   ##</L>
      <L>##$# ##</L>
      <L>##  $ #</L>
      <L># $.# #</L>
      <L># * . #</L>
      <L># *#* #</L>
      <L># . * #</L>
      <L># * * #</L>
      <L># * . #</L>
      <L># $.$##</L>
      <L>##   ##</L>
      <L>## #######</L>
      <L>#   ######</L>
      <L># #$##   #</L>
      <L># @  $   #</L>
      <L>###$ ##$##</L>
      <L> ## ... #</L>
      <L> ##$ .#$#</L>
      <L> ##  .. #</L>
      <L> # $#.# #</L>
      <L> #      #</L>
      <L> #  #  ##</L>
      <L> ########</L>
    </Level>
  </LevelCollection>
</SokobanLevels>
