<?xml version="1.0" encoding="utf-8"?>
<SokobanLevels xmlns:xsi="http://www.w3.org/2001/XMLSchema-instance" xsi:schemaLocation="SokobanLev.xsd">
  <Title>More Magic Pearls</Title>
  <Description>
More Magic Pearls
  </Description>
  <LevelCollection Copyright="Ward De Langhe" MaxWidth="21" MaxHeight="16">
    <Level Id="Level 1" Width="16" Height="11">
      <L>    ############</L>
      <L>    # $ .      #</L>
      <L>   ## ### # ** #</L>
      <L>  ##  ### #  $ #</L>
      <L>  #  ** # # $..#</L>
      <L>###   $ #    ###</L>
      <L># $. $..# ####</L>
      <L># ###@  # #</L>
      <L>#   ##### #</L>
      <L>###       #</L>
      <L>  #########</L>
    </Level>
    <Level Id="Level 2" Width="15" Height="10">
      <L>   ############</L>
      <L>   #.@ #      #</L>
      <L>####$* $ #### #</L>
      <L>#..#   $ #..# #</L>
      <L>#$ ##.. ##$ # #</L>
      <L>#     *  $ $# #</L>
      <L># $ #####     #</L>
      <L>##  $ ..# #####</L>
      <L> #####    #</L>
      <L>     ######</L>
    </Level>
    <Level Id="Level 3" Width="17" Height="12">
      <L>#####</L>
      <L>#   #</L>
      <L># $ #  #######</L>
      <L>#.# #  #  $. #</L>
      <L>#.  ####@*$ $#</L>
      <L>#.$ $   .* . #</L>
      <L>#.  #### $ #.####</L>
      <L>#.# #..###      #</L>
      <L># $ #  $ #####  #</L>
      <L>#   $        $  #</L>
      <L>##  ##  #########</L>
      <L> ########</L>
    </Level>
    <Level Id="Level 4" Width="20" Height="16">
      <L>          #####</L>
      <L>          #   ######</L>
      <L>    #######       .#</L>
      <L>#####       ###### #</L>
      <L>#     #####$#    # #</L>
      <L># ### # ###.#### # #</L>
      <L># # # # #.   # # # #</L>
      <L># ### # ##$$*  # # #</L>
      <L># # # #### . + # # #</L>
      <L>#     $   .*$$ # # #</L>
      <L>##### #####  . # # #</L>
      <L>    # #   ###### # #</L>
      <L>    # #          # #</L>
      <L>    # ############$#</L>
      <L>    #              #</L>
      <L>    ################</L>
    </Level>
    <Level Id="Level 5" Width="10" Height="10">
      <L> #########</L>
      <L> #  #    #</L>
      <L>##. .  . #</L>
      <L>#  $##. ##</L>
      <L>#  * .$$##</L>
      <L>##$  $ + #</L>
      <L>#  *. *  #</L>
      <L>## $ $  ##</L>
      <L> #  ### #</L>
      <L> #### ###</L>
    </Level>
    <Level Id="Level 6" Width="13" Height="13">
      <L>      ####</L>
      <L>#######  ###</L>
      <L># $    $  .#</L>
      <L>#   ###  ..#</L>
      <L># #.  #$#####</L>
      <L># $*$$#  .  #</L>
      <L># ..$.  ..$ #</L>
      <L># *@$ ### # #</L>
      <L>##.#  # # # #</L>
      <L> #   ####   #</L>
      <L> # $    $ ###</L>
      <L> #######  #</L>
      <L>       ####</L>
    </Level>
    <Level Id="Level 7" Width="10" Height="12">
      <L>     #####</L>
      <L>   ###   #</L>
      <L>   #  *  #</L>
      <L>   # +.$##</L>
      <L>  ##*.$ #</L>
      <L>### $*  #</L>
      <L>#   .. ##</L>
      <L># #*$  #</L>
      <L>#  #  ##</L>
      <L># ##$##</L>
      <L>#    #</L>
      <L>######</L>
    </Level>
    <Level Id="Level 8" Width="14" Height="12">
      <L>       #####</L>
      <L> #######   ##</L>
      <L> # $        #</L>
      <L> #   #$ #.# #</L>
      <L> #####   #  ##</L>
      <L> #     $* $ .#</L>
      <L> #*####..+ # #</L>
      <L>##     *$$   #</L>
      <L>#  # ##  .####</L>
      <L>#  #      #</L>
      <L>#  ########</L>
      <L>####</L>
    </Level>
    <Level Id="Level 9" Width="13" Height="13">
      <L>    ########</L>
      <L>    #      #</L>
      <L>  ### # ## #</L>
      <L>  #.# ## # #</L>
      <L>  # $$ # $ #</L>
      <L>### *. . # #</L>
      <L>#   $@*$.# #</L>
      <L># $  . $ # #</L>
      <L>#####  *   ##</L>
      <L>    ##### $ #</L>
      <L>       #    #</L>
      <L>       #...##</L>
      <L>       #####</L>
    </Level>
    <Level Id="Level 10" Width="12" Height="12">
      <L>############</L>
      <L>#.  ##..   #</L>
      <L># # ##..   #</L>
      <L>#  $  ##  ##</L>
      <L>#    **   #</L>
      <L># ##  $ $ #</L>
      <L>#  $ $..# #</L>
      <L>#$###@  # #</L>
      <L>#   # # # #</L>
      <L>###     $ #</L>
      <L>  ######  #</L>
      <L>       ####</L>
    </Level>
    <Level Id="Level 11" Width="7" Height="11">
      <L> ######</L>
      <L> #    #</L>
      <L> # ## #</L>
      <L> #   $#</L>
      <L> #.$  #</L>
      <L>##$$#.#</L>
      <L># ... #</L>
      <L>#.@$$ #</L>
      <L>#$ $. #</L>
      <L>#. #  #</L>
      <L>#######</L>
    </Level>
    <Level Id="Level 12" Width="15" Height="16">
      <L>     #######</L>
      <L>     #     #</L>
      <L>     # ### #</L>
      <L>     # # # ####</L>
      <L>     # ###    #</L>
      <L>     # #    # #</L>
      <L> ##### # ...# #</L>
      <L> #   $   ...  #</L>
      <L>##  $$ ####.###</L>
      <L>#  $@$  # # #</L>
      <L># $$$ $ # # #</L>
      <L>#  $   #### #</L>
      <L>##  #  ...# #</L>
      <L> ##### #### #</L>
      <L>     #      #</L>
      <L>     ########</L>
    </Level>
    <Level Id="Level 13" Width="19" Height="10">
      <L>           ######</L>
      <L>      ######..  ##</L>
      <L>##### #    #..   #</L>
      <L>#   ###    ##.  $#</L>
      <L>##$    ****+###$ ##</L>
      <L>#   ###       #   #</L>
      <L>#   # ####### #$$ #</L>
      <L>#####       # # $ #</L>
      <L>            #     #</L>
      <L>            #######</L>
    </Level>
    <Level Id="Level 14" Width="21" Height="15">
      <L>       #######</L>
      <L>    ####     ####</L>
      <L>#####    $ $    #####</L>
      <L>#    $ # # # # $    #</L>
      <L># ### .#     #. ### #</L>
      <L># # #### #$# #### # #</L>
      <L># #    # # # #    # #</L>
      <L># ###### # # ###### #</L>
      <L>#    $.   @   .$    #</L>
      <L># #### ###$### #### #</L>
      <L># #    # # # #    # #</L>
      <L># #  # ###.### #  # #</L>
      <L>#  * .    .    . *  #</L>
      <L>###  ###########  ###</L>
      <L>  ####         ####</L>
    </Level>
    <Level Id="Level 15" Width="11" Height="12">
      <L>  #######</L>
      <L>  #     #</L>
      <L>  # $ $ #</L>
      <L>### ### ###</L>
      <L>#  * # *  #</L>
      <L>#  * # *  #</L>
      <L>#  * # *  #</L>
      <L>#  * # *  #</L>
      <L>###. # .###</L>
      <L>  ## # ##</L>
      <L>   # @ #</L>
      <L>   #####</L>
    </Level>
  </LevelCollection>
</SokobanLevels>
