<?xml version="1.0" encoding="utf-8"?>
<SokobanLevels xmlns:xsi="http://www.w3.org/2001/XMLSchema-instance" xsi:schemaLocation="SokobanLev.xsd">
  <Title>Original Extra Sharpen</Title>
  <Description>
Sharpened and reduced versions of all of the levels 51-90 in the
collection &quot;Original Plus Extra&quot;.

The levels were originally collected and/or made by Joseph Traub and
others and supplied with the XSokoban player.
The changes here are mostly by me (DrFogh).
With lots of changes and levels added by Archanfel.
More about the project at http://sokoban.dk/original-extra-sharpen/

I think nobody claims any legal rights to these levels.
Please publish the collection on your site if you wish but don't
change this information.

Date_First: 2017-09-09
Date_Last: 2017-10-08

Regards
DrFogh
  </Description>
  <Email>bjertrup58@gmail.com</Email>
  <Url>http://www.sokoban.dk/</Url>
  <LevelCollection Copyright="DrFogh, Archanfel, Joseph L Traub" MaxWidth="23" MaxHeight="17">
    <Level Id="51X Sharpen" Width="13" Height="12" Copyright="Joseph L Traub, Archanfel">
      <L> #########</L>
      <L> #       #</L>
      <L> # $ $$ $#</L>
      <L>###$#  $ #</L>
      <L>#.#   $$ ##</L>
      <L>#.###   $ #</L>
      <L>#.#. $ ## ###</L>
      <L>#...$ $## $ #</L>
      <L>#...$   $  @#</L>
      <L>#..###$### ##</L>
      <L>#....#     #</L>
      <L>############</L>
    </Level>
    <Level Id="52X Sharpen" Width="19" Height="17" Copyright="Joseph L Traub, Archanfel">
      <L>           ########</L>
      <L>           #......#</L>
      <L>   ####    #......#</L>
      <L>   #  #########...#</L>
      <L>   # $   $  $ #...#</L>
      <L>   #  # # # # # . #</L>
      <L>##### # # #@# #   #</L>
      <L>#   # ### ### ## ##</L>
      <L>#    $ #   $   # #</L>
      <L># $$$  $ $ # $   #</L>
      <L>#   # ###$###$## #</L>
      <L>### #  $ $ # $   #</L>
      <L> ## $  #   $   ###</L>
      <L> #  # ### ### ##</L>
      <L> # $          #</L>
      <L> #  ###########</L>
      <L> ####</L>
    </Level>
    <Level Id="53X Sharpen" Width="18" Height="11" Copyright="Joseph L Traub, DrFogh">
      <L> #############</L>
      <L> #      ##   #####</L>
      <L>##$#  $ ##  $    #</L>
      <L>#    $##   ## $$ #</L>
      <L># ###    $ $ ##  #</L>
      <L>#...#  ###   ##$ #</L>
      <L>#...#$$### $###@ #</L>
      <L>#...#     $ # ####</L>
      <L>#...$ $##  ##</L>
      <L>#...   #####</L>
      <L>########</L>
    </Level>
    <Level Id="54X Sharpen" Width="20" Height="12" Copyright="Joseph L Traub, DrFogh">
      <L>##############</L>
      <L>#   ##  ##   ####</L>
      <L># $      $   $  ####</L>
      <L>## ###..## ###     #</L>
      <L> #  #....#$#  $### #</L>
      <L> #$ #....#  $  $ $ #</L>
      <L> #  #....# # # $ $ #</L>
      <L> # ###..##   #$#  @#</L>
      <L>##$###  #### #  #$##</L>
      <L>#   $  $     #  # #</L>
      <L>#   #######  #    #</L>
      <L>#####     #########</L>
    </Level>
    <Level Id="55X Sharpen" Width="16" Height="12" Copyright="Joseph L Traub, DrFogh">
      <L>      #########</L>
      <L>     ##   #   #</L>
      <L>    ##  $   $ #</L>
      <L>   ##....##  ##</L>
      <L>   #....###$ ###</L>
      <L>   #...#       #</L>
      <L>#####.## $   $ #</L>
      <L>#  $ $ ### # ###</L>
      <L>#@$      # $   #</L>
      <L>### $ $# ### $ #</L>
      <L>  ####   # #  ##</L>
      <L>     ##### ####</L>
    </Level>
    <Level Id="56X The Enigmatic Piglet" Width="23" Height="15" Copyright="Joseph L Traub, DrFogh">
      <L>                   ##</L>
      <L>                  ##</L>
      <L>                 ##</L>
      <L>      #############</L>
      <L> #  ###  ##   ##@##</L>
      <L># # #    $    # $#*##</L>
      <L> ####$# $ ##$# $ $  #</L>
      <L> # #   $#    $      ###</L>
      <L>#  # ##   $ ######....#</L>
      <L>   # ##$# # #####....##</L>
      <L>   #    $ $ ####....##</L>
      <L>   ##$##### $ #....##</L>
      <L>    # # $       ####</L>
      <L>    #     ####  #</L>
      <L>    #######  ####</L>
    </Level>
    <Level Id="57X Sharpen" Width="18" Height="12" Copyright="Joseph L Traub, DrFogh">
      <L>       #####</L>
      <L>      ##   #######</L>
      <L>      #@$  $     #</L>
      <L>######### $ $#$# #</L>
      <L>#.#..#####$ $    #</L>
      <L>#.....  $   #   ##</L>
      <L>#.....  ###$##$###</L>
      <L>#.#..#  $    #   #</L>
      <L>###### ##  #$  $ #</L>
      <L>     #  $    $ $ #</L>
      <L>     ####  #  ####</L>
      <L>        #######</L>
    </Level>
    <Level Id="58X Sharpen" Width="19" Height="12">
      <L>#########   #####</L>
      <L>#.....  #####   #</L>
      <L>#.....        $ ###</L>
      <L>#....#$# #$###$   #</L>
      <L>#...#    #   $  # #</L>
      <L>#...# #$ #  $ $$# #</L>
      <L>##### # $ $ ### $ #</L>
      <L>   #  $  $ #  # ###</L>
      <L>   # ## #$$# $#  ##</L>
      <L>   #   $ $ #   $  #</L>
      <L>   ###     #### @ #</L>
      <L>     #######  #####</L>
    </Level>
    <Level Id="59X Sharpen" Width="20" Height="12" Copyright="Joseph L Traub, DrFogh">
      <L>    ####    ####</L>
      <L>    #  ######  #</L>
      <L>  ###  $  @ $  ###</L>
      <L> ##    ###### $  ##</L>
      <L> #  # ##....#  $$ #</L>
      <L> #$##$##....#     #</L>
      <L>##     #....##$##$#</L>
      <L>#  $$  #....#     ##</L>
      <L># $  $ ##  ## ###  #</L>
      <L>#####  $   $    $  #</L>
      <L>    #####  ####   ##</L>
      <L>        ####  #####</L>
    </Level>
    <Level Id="60X Sharpen" Width="20" Height="12" Copyright="Joseph L Traub, DrFogh">
      <L>        ###########</L>
      <L>     ####         #</L>
      <L>     #  $  ## ### ##</L>
      <L> ##### ##   $  $   #</L>
      <L>##..## ## # $ # #  #</L>
      <L>#....  $  $  ##$# ##</L>
      <L>#....  $######  #$#</L>
      <L>##..# #  #   #  $@#</L>
      <L> #..# #  $   $  ###</L>
      <L> ## $  $ ########</L>
      <L>  ###  ###</L>
      <L>    ####</L>
    </Level>
    <Level Id="61X Sharpen" Width="20" Height="12">
      <L> #####  ####  #####</L>
      <L>##   ####..####   ##</L>
      <L># $$ ##......#  $@ #</L>
      <L>#  # ##......#  $$ #</L>
      <L>#     #......#  $  #</L>
      <L>####  ###..######$ #</L>
      <L>#   $$$ #.*#    #  #</L>
      <L># $#   $  $  $$ #$ #</L>
      <L>#  #$ ## $  ##  #  #</L>
      <L># $    $$## $    $ #</L>
      <L>#  #####    #####  #</L>
      <L>####   ######   ####</L>
    </Level>
    <Level Id="62X Sharpen" Width="19" Height="12" Copyright="Joseph L Traub, DrFogh">
      <L>          ####</L>
      <L>        ###  ######</L>
      <L>     #### $   $   #</L>
      <L>######    #  ##$  #</L>
      <L>#   ## ## #$ ## # #</L>
      <L>#    @ $   $   $  #</L>
      <L>#  ###$$## $##$ ###</L>
      <L>#....#  # $   $ #</L>
      <L>#....# $$   ##$ #</L>
      <L>#....#  #####   #</L>
      <L>#....##       ###</L>
      <L>###############</L>
    </Level>
    <Level Id="63X Sharpen" Width="19" Height="12" Copyright="Joseph L Traub, DrFogh">
      <L>############</L>
      <L>#....##    #######</L>
      <L>#....## $  $     ##</L>
      <L>#.... #  $# # $#$ #</L>
      <L>#...#  $   $#  $  #</L>
      <L>#..#######$   $$  #</L>
      <L>#     #### #### ###</L>
      <L>#  #    #   ##    #</L>
      <L># ## ##   $ # $ $ #</L>
      <L># ##   $ ## $  $  #</L>
      <L>#   @########  ####</L>
      <L>######      ####</L>
    </Level>
    <Level Id="64X Sharpen" Width="18" Height="12">
      <L>###### ##########</L>
      <L>#....# #        #</L>
      <L>#....### # $#$# #</L>
      <L>#....#   #$  $  #</L>
      <L>#....#    $  #$$##</L>
      <L>##..## $# ##$ $  #</L>
      <L> #  ##  $  $  #  #</L>
      <L> #  ##$###$## $  #</L>
      <L> #      #  #  $ ##</L>
      <L> #@  #$ #  $  ###</L>
      <L> #####  #  #  #</L>
      <L>     ##########</L>
    </Level>
    <Level Id="65X Sharpen" Width="20" Height="12" Copyright="Joseph L Traub, DrFogh">
      <L>  #####      #######</L>
      <L>###   ########.....#</L>
      <L>#   $ ##@   ###....#</L>
      <L># # # ##$## ## ....#</L>
      <L>#   $ #   $$$  ....#</L>
      <L>###$### $$  ### ##.#</L>
      <L>#     $  #   ## ####</L>
      <L>#  $  #  ### ## ####</L>
      <L>## #$##    $  $$   #</L>
      <L> #  $ ##  $#### #$ #</L>
      <L> ##   ###  #  #    #</L>
      <L>  ##### ####  ######</L>
    </Level>
    <Level Id="66X Sharpen" Width="20" Height="12" Copyright="Joseph L Traub, DrFogh">
      <L>######   #####</L>
      <L>#    #####...##</L>
      <L># #       ....##</L>
      <L>#  $ ######....##</L>
      <L># ##$#######....#</L>
      <L># $   $  #  #...####</L>
      <L># $$ #   #   # $$  #</L>
      <L>###  $$$#   $$  $  #</L>
      <L># $  #  #    # $#  #</L>
      <L>#   $#  #  #    $  #</L>
      <L>#  #    #    #  # @#</L>
      <L>####################</L>
    </Level>
    <Level Id="67X Sharpen" Width="19" Height="12" Copyright="Joseph L Traub, DrFogh">
      <L>   ### ############</L>
      <L>   #@###.##...##  #</L>
      <L>  ##$  ..#...#    #</L>
      <L>  #    ......#  $ #</L>
      <L>### $ #.....## # ##</L>
      <L>#  $$#######  $ $##</L>
      <L># $# $    ##  $$  #</L>
      <L>#  #  #    # $  $ #</L>
      <L>#   $$ ### #$##   #</L>
      <L># $#      $ $  $ ##</L>
      <L>##    #    #    ##</L>
      <L> ################</L>
    </Level>
    <Level Id="68X Sharpen" Width="19" Height="12" Copyright="Joseph L Traub, DrFogh">
      <L>        ####  #####</L>
      <L>        #  #  #   #</L>
      <L> ##### ##  #### # #</L>
      <L>##   ###  $$      #</L>
      <L>#  # #@# $ # $ ## #</L>
      <L>#     $ # $#$$ ## #</L>
      <L>#..###  #      ## #</L>
      <L>#..#.# $ #  $ #   #</L>
      <L>#..#.#  $ # ###$$ #</L>
      <L>#....##   $$$ $  ##</L>
      <L>#.....##        ##</L>
      <L>#################</L>
    </Level>
    <Level Id="69X Sharpen" Width="20" Height="12" Copyright="Joseph L Traub, DrFogh">
      <L>##################</L>
      <L>#  #     ##   #  ###</L>
      <L># $# $ $ ##...$  $ #</L>
      <L>#  $  ####....# $# #</L>
      <L># ## $ ##....##  $ #</L>
      <L># $    #....###$   #</L>
      <L># $##  #...#       #</L>
      <L>#   $$$##$##  ### ##</L>
      <L># # #  #  ##  #    #</L>
      <L># $ #  $  ##       #</L>
      <L>#   ##    ##@      #</L>
      <L>####################</L>
    </Level>
    <Level Id="70X Sharpen" Width="20" Height="11" Copyright="Joseph L Traub, DrFogh">
      <L>   ####  ########</L>
      <L> ###  ####   #  ####</L>
      <L> #  $      $ $     #</L>
      <L>## #  #$###$##  ##$#</L>
      <L>#   $     $  #  $  #</L>
      <L># ###$##$#   # $   #</L>
      <L># #   $ $  ###### $#</L>
      <L>#@$  $$ $$ #.......#</L>
      <L>###     #  #.......#</L>
      <L>  ##########......##</L>
      <L>           ########</L>
    </Level>
    <Level Id="71X Sharpen" Width="20" Height="12">
      <L>###################</L>
      <L>#  #     #  ##    ##</L>
      <L># $#   $ #.$   ##  #</L>
      <L># $  $ ##..#  $  $ #</L>
      <L># $ $  #....#   # ##</L>
      <L># $#  #......### $ #</L>
      <L>#   ####....#  #$  #</L>
      <L># $  ####..##  #   #</L>
      <L>## $   ##..## $  $##</L>
      <L> ## $  $ *#@$ $# $ #</L>
      <L>  ##   #       #   #</L>
      <L>   #################</L>
    </Level>
    <Level Id="72X Sharpen" Width="20" Height="12" Copyright="Joseph L Traub, DrFogh">
      <L>#################</L>
      <L>#   .......##   ####</L>
      <L># $ *.*.*.*    $ *.#</L>
      <L># # ##########   ..#</L>
      <L># #$  ##      ###*.#</L>
      <L>#  $  ##$$###   #..#</L>
      <L># $ ### $   $   #*.#</L>
      <L># $ #   $ $ #####..#</L>
      <L># @#  $$ # $ ##   ##</L>
      <L>#### $#  $  $   $ #</L>
      <L>   #    ###   #  ##</L>
      <L>   ###### ########</L>
    </Level>
    <Level Id="73X Sharpen" Width="20" Height="12" Copyright="Joseph L Traub, DrFogh">
      <L>##############</L>
      <L>#        #   #</L>
      <L># $$  #$$# # #######</L>
      <L>#  # $ $ #$$ #     #</L>
      <L>## #  #  # # #  #  #</L>
      <L>#   ##       #$ +..#</L>
      <L># $ # $ #$  # $ #..#</L>
      <L># $ #$ #   #  $ #..#</L>
      <L>##$ #  ####  $ #...#</L>
      <L>#  $          #....#</L>
      <L>#   #######  #.....#</L>
      <L>#####     ##########</L>
    </Level>
    <Level Id="74X Sharpen" Width="20" Height="12">
      <L> ##########</L>
      <L> #    #   #   ######</L>
      <L> # $  # $ #   #    #</L>
      <L>#### $$   ##### $  #</L>
      <L>#  $  $ ###..####  #</L>
      <L># $   ###.....  $$##</L>
      <L>#  #$# ......# # $ #</L>
      <L># #  # $...###$#   #</L>
      <L># #   $ #..#   ##  #</L>
      <L>#   $# @#### $ ##$##</L>
      <L>###  ####  #      #</L>
      <L>  ####     ########</L>
    </Level>
    <Level Id="75X Sharpen" Width="19" Height="12" Copyright="Joseph L Traub, DrFogh">
      <L>#################</L>
      <L>#   #   #   #   #</L>
      <L>#   $  $    # $ #</L>
      <L>##$# $####    $$###</L>
      <L>#  #  #..#  #$ $  #</L>
      <L>#  #$#....### ### #</L>
      <L># $  #.....#    # #</L>
      <L>##$  #.#...#$$ $ @#</L>
      <L>#  ######..# #  ###</L>
      <L>#  $        $ ###</L>
      <L>#  ######     #</L>
      <L>####    #######</L>
    </Level>
    <Level Id="76X Sharpen" Width="19" Height="12" Copyright="Joseph L Traub, DrFogh">
      <L>            #####</L>
      <L> ############   ##</L>
      <L> #        @  $   #</L>
      <L> # ##$#######$ # #</L>
      <L> #    #.....#  # #</L>
      <L>##$##$#.....##$#$#</L>
      <L>#   # #.....#  # ##</L>
      <L>#  $  ###..##  #  #</L>
      <L># $ #  $   $  $$$ #</L>
      <L>## $ $# #  #  $   #</L>
      <L> #  #   #####   ###</L>
      <L> ########   #####</L>
    </Level>
    <Level Id="77X Sharpen" Width="19" Height="15">
      <L>###################</L>
      <L>#    ##   #   #   #</L>
      <L>#  $  $ .$. # $   #</L>
      <L>## #####...##### ##</L>
      <L> # ##  ##...#### ##</L>
      <L>## ##$ ###..#     #</L>
      <L>#      #... # $ $ #</L>
      <L># $ ## ##.. ## ####</L>
      <L># # $    #.### #</L>
      <L># $ $ #    ### ###</L>
      <L>###  ## # #  #   #</L>
      <L>  #####  $#$ $ $@#</L>
      <L>      ##     $ ###</L>
      <L>       #  ######</L>
      <L>       ####</L>
    </Level>
    <Level Id="77SL Sharpen" Width="10" Height="12" Copyright="Scott Lindhurst, DrFogh">
      <L>##########</L>
      <L>#   ##   #</L>
      <L># $  # $ #</L>
      <L># $  @$  #</L>
      <L>#  ####$##</L>
      <L>#####   ##</L>
      <L>#...#$   #</L>
      <L>#...# $  #</L>
      <L>#.. # $  #</L>
      <L>#..  $ $ #</L>
      <L>##  ######</L>
      <L> ####</L>
    </Level>
    <Level Id="78X Sharpen" Width="15" Height="10" Copyright="Joseph L Traub, DrFogh">
      <L>    ##########</L>
      <L>    #        #</L>
      <L>    # $ $ $  #</L>
      <L>##### $ #### #</L>
      <L>#.. ### $ ##$#</L>
      <L>#... $ $     #</L>
      <L>#...   @# ## ##</L>
      <L>#.. ##### $ $ #</L>
      <L>#####   #     #</L>
      <L>        #######</L>
    </Level>
    <Level Id="79X Sharpen" Width="16" Height="10" Copyright="Joseph L Traub, DrFogh">
      <L>###########</L>
      <L>#         ###</L>
      <L># ### $$    #</L>
      <L>#   # $  $  #</L>
      <L>## $####$####</L>
      <L># $ ##   #  ####</L>
      <L>#  $$ $    ....#</L>
      <L>### ## $$# ....#</L>
      <L>  #  @   ##....#</L>
      <L>  ##############</L>
    </Level>
    <Level Id="80X Sharpen" Width="11" Height="13" Copyright="Joseph L Traub, DrFogh">
      <L>     ######</L>
      <L>######... #</L>
      <L>#  @##... #</L>
      <L># $  #... #</L>
      <L># $$ #...##</L>
      <L>## $ ###$##</L>
      <L> # ###  $ #</L>
      <L> #   $  $ #</L>
      <L>## $ #  $ #</L>
      <L># $  ##   #</L>
      <L>#  $ ######</L>
      <L>##   #</L>
      <L> #####</L>
    </Level>
    <Level Id="81X Sharpen" Width="12" Height="11" Copyright="Joseph L Traub, DrFogh">
      <L>############</L>
      <L>#       #  #</L>
      <L># $ $   $$ #</L>
      <L># #### # $ #</L>
      <L>#$$  #$# $ #</L>
      <L># ## # #$  #</L>
      <L># ## $ $   #</L>
      <L>#....  #   #</L>
      <L>#....@######</L>
      <L>#....##</L>
      <L>######</L>
    </Level>
    <Level Id="82X Sharpen" Width="15" Height="13" Copyright="Joseph L Traub, DrFogh">
      <L>   ######</L>
      <L>####    #</L>
      <L>#    ## #</L>
      <L># $     #</L>
      <L>## #### #######</L>
      <L>##$   $ #  ...#</L>
      <L># $$$ $$  ....#</L>
      <L># @ $  $# ....#</L>
      <L>#### ## #  ...#</L>
      <L>###  $  #######</L>
      <L># $ $$  #</L>
      <L>#    #  #</L>
      <L>#########</L>
    </Level>
    <Level Id="83X Sharpen" Width="15" Height="12" Copyright="Joseph L Traub, DrFogh">
      <L>##########</L>
      <L>#     #  ######</L>
      <L># ### #   $   #</L>
      <L># # $ #$ $$   #</L>
      <L># $ $$    ##$ #</L>
      <L>#@   ##   ##  #</L>
      <L>#####..#####$##</L>
      <L>   #...  ##   #</L>
      <L>   #...   $$  #</L>
      <L>   #...  ## $ #</L>
      <L>   ##..####   #</L>
      <L>    ####  #####</L>
    </Level>
    <Level Id="84X Sharpen" Width="16" Height="11" Copyright="Joseph L Traub, Howard Abed, DrFogh">
      <L>###############</L>
      <L>#     #    #  ##</L>
      <L># $  $#   $ $  #</L>
      <L>#  $  #  $ ##  #</L>
      <L># $$  ##$ $    #</L>
      <L>## #$ ## #######</L>
      <L>## # $##....#</L>
      <L>#  #$   ....#</L>
      <L>#   $$$@....#</L>
      <L>#     ##....#</L>
      <L>#############</L>
    </Level>
    <Level Id="85X Sharpen" Width="20" Height="16">
      <L> ###########</L>
      <L> #     #   ##</L>
      <L> # $ $ $ #  #####</L>
      <L> ###  #####     #</L>
      <L> #....#     ### #</L>
      <L> #.####  ####   #</L>
      <L> #....    #  $ ##</L>
      <L> # ...#   # $$$#####</L>
      <L>###.#######  $@$   #</L>
      <L># $   ##### $ ##   #</L>
      <L># #.# $      $###$ #</L>
      <L># #.########  #  $ #</L>
      <L># #...       ## $$ #</L>
      <L>#   ####### $ # #  #</L>
      <L>#####     #       ##</L>
      <L>          #########</L>
    </Level>
    <Level Id="86X Sharpen" Width="17" Height="10" Copyright="Joseph L Traub, Archanfel">
      <L>################</L>
      <L>#       #@ #   #</L>
      <L># # # # # $  $$#</L>
      <L># #...# #$$$   #</L>
      <L>#  ...# # $  $$##</L>
      <L># ##.## # ## $  #</L>
      <L># #....    $    #</L>
      <L># ## ############</L>
      <L>#    #</L>
      <L>######</L>
    </Level>
    <Level Id="87X Sharpen" Width="15" Height="14" Copyright="Joseph L Traub, DrFogh">
      <L>    #####</L>
      <L> ####   ######</L>
      <L> #  $    #   #</L>
      <L> # $@$ $  $  #</L>
      <L> # #$######$##</L>
      <L> # #  $  #  #</L>
      <L> # # $ $ # ##</L>
      <L>## #  $# # ####</L>
      <L>#  ##    #    #</L>
      <L>#    $ # ##   #</L>
      <L>##### ## #....#</L>
      <L>   # $   .....#</L>
      <L>   #   ###....#</L>
      <L>   ##### ######</L>
    </Level>
    <Level Id="88X Sharpen" Width="17" Height="16" Copyright="Joseph L Traub, Archanfel">
      <L>##########</L>
      <L>#........####</L>
      <L>#....### #  #####</L>
      <L>#...#  ###    $ #</L>
      <L>#...$$     $$$  #</L>
      <L>#  .#  $ $# $  ##</L>
      <L>#...# #$#   $  #</L>
      <L>#.# # $   $    #</L>
      <L>#.  #$###$####$#</L>
      <L>##  #   $ $    #</L>
      <L> #  #  $@$  #  #</L>
      <L> #  # #### $  $#</L>
      <L> #  #    ###   #</L>
      <L> #  # $$ # #####</L>
      <L> #  #    #</L>
      <L> #########</L>
    </Level>
    <Level Id="89X Sharpen" Width="20" Height="17">
      <L>     ##############</L>
      <L> ##### $     .....##</L>
      <L> #       ####..... #</L>
      <L> # #######  #..... #</L>
      <L> # #    $ $ ##....##</L>
      <L> # # $$ # # ###...#</L>
      <L> # # $@$ $  ##### #</L>
      <L>## #  $  $ $$   $ #</L>
      <L>#  #$# $##  # $## #</L>
      <L># ##    ## ## $ # #</L>
      <L># # $# $ $  #     #</L>
      <L># #         #######</L>
      <L># ########$##   #</L>
      <L>#        #  $   #</L>
      <L>########    #####</L>
      <L>       ###  #</L>
      <L>         ####</L>
    </Level>
    <Level Id="90X Sharpen" Width="19" Height="16">
      <L>##################</L>
      <L>#..#   #         #</L>
      <L>#.*  $ #$$  $## $##</L>
      <L># $#  ##  ## ##   #</L>
      <L>#  # $#  $$   $   #</L>
      <L># ### # #  #$ #####</L>
      <L>#  ## #$   #@ #   #</L>
      <L># $   $  #####  $ #</L>
      <L>#  # $#$#.*    $###</L>
      <L>#  #    #.. ### $ #</L>
      <L>#  ####### ##  ...#</L>
      <L>#          ##$#.#.#</L>
      <L>##$#######$#   ...#</L>
      <L>#  ...* #   $##.#.#</L>
      <L>#  *...$  $    ...#</L>
      <L>###################</L>
    </Level>
  </LevelCollection>
</SokobanLevels>
