<?xml version="1.0" encoding="utf-8"?>
<SokobanLevels xmlns:xsi="http://www.w3.org/2001/XMLSchema-instance" xsi:schemaLocation="SokobanLev.xsd">
  <Title>Original 3</Title>
  <Description>
50 original levels arranged roughly chronologically.
  </Description>
  <Email>bjertrup58@gmail.com</Email>
  <Url>http://www.sokoban.dk/</Url>
  <LevelCollection Copyright="DrFogh" MaxWidth="46" MaxHeight="29">
    <Level Id="(101) Rising Sun Sharpen" Width="13" Height="27">
      <L>#############</L>
      <L>#    ####   #</L>
      <L>#  #      # #</L>
      <L>#  # #.## # #</L>
      <L>#  . #.##.# #</L>
      <L>#  #. .#.   #</L>
      <L>#  ##... # ##</L>
      <L># ....#.... #</L>
      <L>#    ...##  #</L>
      <L># # .#. .#  #</L>
      <L>#  . #.# .  #</L>
      <L>#   ##.#    #</L>
      <L>#    # #    #</L>
      <L>#    # #    #</L>
      <L>######$######</L>
      <L>#   $       #</L>
      <L>#  $ $$#$#  #</L>
      <L>##  $    #$ #</L>
      <L>##$# $##$# ##</L>
      <L>##  $  @ $ ##</L>
      <L># $ $$$##   #</L>
      <L># #$     #$ #</L>
      <L># #  $#$    #</L>
      <L># $$$ $  #$ #</L>
      <L># $    $ #  #</L>
      <L>#    #   ####</L>
      <L>#############</L>
    </Level>
    <Level Id="(102) Passtime For The Weekend" Width="15" Height="5">
      <L>###############</L>
      <L># . . . . . . #</L>
      <L># $ $ $#$ $ $ #</L>
      <L>##### @   #####</L>
      <L>    #######</L>
    </Level>
    <Level Id="(103) MF888 Sharpen" Width="31" Height="21">
      <L>  #############################</L>
      <L>  #                           #</L>
      <L>  # # # # # # # # # # # # # # #</L>
      <L>  # $$$$$$$$$ $$$$$$$$$$$$$$$ #</L>
      <L>  # $ $ $ $  #    $ $ $ $ $ $ #</L>
      <L>  # $ $ $   $$ # $  $ $ $ $ $ #</L>
      <L>  # $    # $  $###$           #</L>
      <L>  #  $ $ $$$ $ #  $$$  $ $ $  #</L>
      <L>  # $ $ $  $   #    # $ $ $ $ #</L>
      <L>########### ##### ######### ###</L>
      <L>#    ######     # ########  ###</L>
      <L># .# #. ...#..  # # ..   ..#  #</L>
      <L># .. .. .# .  .## #.##. .##.  #</L>
      <L># . .#.#. #.##.## #.##.#.##.  #</L>
      <L># .  #. ..  ..      ..   ..   #</L>
      <L># .  #.#.  . #.## #.##.#.##. ##</L>
      <L># .  #.#.  . #.## #.##. .  . #</L>
      <L># .   .#.   ..    # ..   ..###</L>
      <L>##        @ #######  #######</L>
      <L> #######  ###     ####</L>
      <L>       ####</L>
    </Level>
    <Level Id="(104) Time for a Classic Puzzle" Width="10" Height="7">
      <L>#######</L>
      <L>#     ####</L>
      <L># #$# #  #</L>
      <L># *+*.   #</L>
      <L># #$###  #</L>
      <L>#       ##</L>
      <L>#########</L>
    </Level>
    <Level Id="(105) Kevin" Width="23" Height="24">
      <L>         #######</L>
      <L>        ##     ##</L>
      <L>        #  ###  #</L>
      <L>        # #   # #</L>
      <L>        # #   # #</L>
      <L>        # #   # #</L>
      <L>     #### #   # #</L>
      <L>    ##    # . # #</L>
      <L> ####  #### . # ##</L>
      <L>##    #   #...#  ##</L>
      <L>#  #### # .... #  #</L>
      <L># #  ##   .....#  #</L>
      <L># #  ### ## ####  ###</L>
      <L># #       # #####$  ###</L>
      <L>#  # ## $ $@$     $   #</L>
      <L>##  $#######$####$ $# #</L>
      <L> ##  #     # ##   # # #</L>
      <L>  # ########  $$$ # # #</L>
      <L>  #$     $    #   # # #</L>
      <L>  # ###### #  #     # #</L>
      <L>  #  #   #  ####  ### #</L>
      <L>  #  #   ##    ####   #</L>
      <L>  #  #    ####      ###</L>
      <L>  ####       ########</L>
    </Level>
    <Level Id="(106) Toppoint" Width="12" Height="18">
      <L>#########</L>
      <L>#    #  #</L>
      <L># #     #</L>
      <L>#  $$ $ #</L>
      <L>##$#   ##</L>
      <L>#   #$######</L>
      <L># #     #  #</L>
      <L>#  $$ # $  #</L>
      <L>## $ #*##  #</L>
      <L>#### +..# ##</L>
      <L>#  #****.$##</L>
      <L>#  *...... #</L>
      <L>#  ##   #  #</L>
      <L>## ####### #</L>
      <L>#          #</L>
      <L>#  # # # ###</L>
      <L>#        #</L>
      <L>##########</L>
    </Level>
    <Level Id="(107) Kreta" Width="23" Height="13">
      <L>  ####</L>
      <L>  #  # ############</L>
      <L>  #  # #   #      ##</L>
      <L>  # $###$# #  ###  ###</L>
      <L>  #  $  $  #  #  #   ##</L>
      <L>### $ $  # #  #  ###  #</L>
      <L>#    $ $ #... #  #  # #</L>
      <L>#   $$### .....  #  # #</L>
      <L>#     # #   #..     # #</L>
      <L>####### ##### ### @ # #</L>
      <L>            #    ###  #</L>
      <L>            ####     ##</L>
      <L>               #######</L>
    </Level>
    <Level Id="(108) Not Easy" Width="10" Height="12">
      <L>##########</L>
      <L>#        #</L>
      <L># $ $$#$ #</L>
      <L># #    $ #</L>
      <L>#  ####$##</L>
      <L>#   ...  #</L>
      <L>##$#.#.# #</L>
      <L># $ ...# #</L>
      <L># #  #   #</L>
      <L>#@    ####</L>
      <L>###   #</L>
      <L>  #####</L>
    </Level>
    <Level Id="(109) Hourglass" Width="13" Height="17">
      <L>#############</L>
      <L> ##       ##</L>
      <L> #  $$$ $  #</L>
      <L> # $  $  $ #</L>
      <L> # $  $$ $ #</L>
      <L>  ##$# $ ##</L>
      <L>   #@$ $ #</L>
      <L>    #   #</L>
      <L>     # #</L>
      <L>    #   #</L>
      <L>   #     #</L>
      <L>  ## ## ###</L>
      <L> #    .    #</L>
      <L> # # ..#   #</L>
      <L> #  ..... ##</L>
      <L> ##.......##</L>
      <L>#############</L>
    </Level>
    <Level Id="(110) Happy New Year 2017" Width="21" Height="10">
      <L> ###### ############</L>
      <L>##    # #          #</L>
      <L>#  .**###** #* .**.#</L>
      <L># .$# *@*  * * $  .##</L>
      <L># #   *#*  * * $$$. #</L>
      <L># #.**  * #* * $ .$ #</L>
      <L># .$    *  * * $. $ #</L>
      <L># .****##**# *#.$$  #</L>
      <L>##     ##          ##</L>
      <L> ###################</L>
    </Level>
    <Level Id="(111) Rudolph aka Merry Christmas 2016" Width="24" Height="29">
      <L> #                    #</L>
      <L> # #                # #</L>
      <L> # # #            # # #</L>
      <L>#  ##              ##  #</L>
      <L># ##                ## #</L>
      <L>###                  ###</L>
      <L> #       #    #       #</L>
      <L> ##     ##    ##     ##</L>
      <L>  ##    #      #    ##</L>
      <L>   ##   #      #  ###</L>
      <L>    ### #      # ##</L>
      <L> ##   #### ## ####  ###</L>
      <L>#  ##   ###  ###   #   #</L>
      <L># $  ## #  $ $ ####  $ #</L>
      <L>#  $   #   $ $ $  # $  #</L>
      <L>#   $$   $ $@$  # $$  #</L>
      <L> ###  #   # #$      ##</L>
      <L>    #   ##    ###  #</L>
      <L>     # #**#  #**# #</L>
      <L>     ##   $ #    ##</L>
      <L>      #  # $ $#  #</L>
      <L>      # #  #   # #</L>
      <L>      #  $##$#   #</L>
      <L>       ##  ..#  #</L>
      <L>        #.. ...##</L>
      <L>        #...#..#</L>
      <L>        #......#</L>
      <L>         #....#</L>
      <L>          ####</L>
    </Level>
    <Level Id="(112) Owl" Width="15" Height="12">
      <L>##           ##</L>
      <L> ##   ###   ##</L>
      <L>  ###########</L>
      <L>  ##  ###  ##</L>
      <L>  # .. # .. #</L>
      <L>  # .. # ..  #</L>
      <L> ###$## ##$# #</L>
      <L> #           #</L>
      <L> #  $$###$$ ##</L>
      <L>  # $  #  $ #</L>
      <L>   ##  @  ##</L>
      <L>     #####</L>
    </Level>
    <Level Id="(113) January 2017" Width="14" Height="15">
      <L>        ####</L>
      <L> ########  ##</L>
      <L> #  #       #</L>
      <L>##     $$$$ #</L>
      <L># $$$$$   $ #</L>
      <L>#       ### #</L>
      <L>#   ##### $$##</L>
      <L>####  ....#  #</L>
      <L>#    #....   #</L>
      <L>#    #....####</L>
      <L># #    ##@##</L>
      <L>#   #      #</L>
      <L>##### ## # #</L>
      <L>    #      #</L>
      <L>    ########</L>
    </Level>
    <Level Id="(114) Black Friday" Width="15" Height="15">
      <L>   ###########</L>
      <L>  ##         #</L>
      <L>  # $  $ $ $ ##</L>
      <L>  # ### ## #  #</L>
      <L>  #  .*...*#$ #</L>
      <L>###$#.  ##.#  #</L>
      <L>#   $.#$##.# ##</L>
      <L># # #.$ $ .$$#</L>
      <L># #$#.#@$#.# #</L>
      <L># # #..*...# ##</L>
      <L># # ####$###  #</L>
      <L>#     $ $     #</L>
      <L>### # # ####  #</L>
      <L>  #     #  ####</L>
      <L>  #######</L>
    </Level>
    <Level Id="115) From Mac to YASC" Width="25" Height="21">
      <L>        #########</L>
      <L>    #####   #   ###</L>
      <L>    #     # # #   ###</L>
      <L>   ## ###$$$$$$$#   ##</L>
      <L>  ##    $ #   # $ #  ####</L>
      <L>###  # $   $$$  #$ #    #</L>
      <L>#   ##$# #$$ $$ # $#### #</L>
      <L>#.#  * .....#..... *....#</L>
      <L>#.  #* .$ #.#.##$.#*# #.#</L>
      <L>#.## * *$ #.#.# $$ *  # #</L>
      <L># ...$ * ##.@ ...$ *# # #</L>
      <L># #.#$#**...# ##$* *    #</L>
      <L># #. $ .$##.#.# $.#*###.#</L>
      <L># #. $#.  #.#..... *....#</L>
      <L>#  #  $   $$ $$ # $#### #</L>
      <L>## # ##$#  $$$  #$  #   #</L>
      <L> # #    $ #   # $   # ###</L>
      <L> #  #####$$$$$$$####  #</L>
      <L> ##       # # #      ##</L>
      <L>  #######       ######</L>
      <L>        #########</L>
    </Level>
    <Level Id="(116) JCD" Width="35" Height="10">
      <L>###################################</L>
      <L># ...  .  . .  .  ..   .  .   . . #</L>
      <L># *$$ .$. * *#.$. *$. .$. *.##* * #</L>
      <L># *.. * * *.$ * * *.$ *.* *$. * * #</L>
      <L># $$* * * *$. * * *$. *$* * $.*#$ #</L>
      <L># ..* $.$ * * $.$ *.$ * * *  $* . #</L>
      <L>##$$$# $  $ $  $ #$$  $ $ $   $ $ #</L>
      <L> # # ###### ###### #### ###########</L>
      <L> #@                     #</L>
      <L> ########################</L>
    </Level>
    <Level Id="(117) Flowsnake" Width="8" Height="7">
      <L>   #####</L>
      <L>####   #</L>
      <L>#  .$. #</L>
      <L>#@#$*$ #</L>
      <L>#  .$. #</L>
      <L>##   ###</L>
      <L> #####</L>
    </Level>
    <Level Id="(118) February 2017" Width="13" Height="12">
      <L>   #########</L>
      <L>   #       #</L>
      <L>  ## $@$ $ ##</L>
      <L> ## $ $ $$$ #</L>
      <L> #  ##### # #</L>
      <L>##   .. # # #</L>
      <L>#  #.##.    #</L>
      <L>#   .##.# ###</L>
      <L>#  # .. # #</L>
      <L>##        #</L>
      <L> #####  ###</L>
      <L>     ####</L>
    </Level>
    <Level Id="(119) A Modification Gone Astray" Width="15" Height="17">
      <L>###############</L>
      <L>#      #      #</L>
      <L>#  $ $   $ $$ #</L>
      <L>#  $ $ # $ $  #</L>
      <L>##$#$#####$#$##</L>
      <L># $ $  #  $ $ #</L>
      <L>#      @      #</L>
      <L>######## ###$##</L>
      <L>#     ## ###  #</L>
      <L># # #     ### #</L>
      <L>#     ### ##  #</L>
      <L># #    #  ##  #</L>
      <L>#   ## # ##   #</L>
      <L>#   ...#...   #</L>
      <L>#  #... ...#  #</L>
      <L>#  #...#...#  #</L>
      <L>###############</L>
    </Level>
    <Level Id="(120) Happy Newyear 2018" Width="26" Height="16">
      <L>   #######################</L>
      <L>####     #               #</L>
      <L>#  # ### # ###### ###### #</L>
      <L>#    #   # #  #          #</L>
      <L>#  **  # $**$ #  *##$**$##</L>
      <L>##*# * # *  * # ** #.# * #</L>
      <L> #   * # *  *  # * #. @* #</L>
      <L>## #*##  *  *#   * ##.*  #</L>
      <L>#  *    #*# *  # * #.$#.##</L>
      <L># *   ## *  * ## *  * #.#</L>
      <L># **** # $**$ ###*# $.. ##</L>
      <L>#             # #    ##  #</L>
      <L>#   ######### #### #     #</L>
      <L>#####      #       #   ###</L>
      <L>           #   ##  #####</L>
      <L>           #########</L>
    </Level>
    <Level Id="(121) March 2017" Width="11" Height="11">
      <L> #########</L>
      <L> #       #</L>
      <L>##$## ## #</L>
      <L># $      #</L>
      <L># $$$$$# #</L>
      <L>#  # @ # #</L>
      <L>## ##### ##</L>
      <L> #....... #</L>
      <L> # ###### #</L>
      <L> #        #</L>
      <L> ##########</L>
    </Level>
    <Level Id="(122) April 2017" Width="11" Height="11">
      <L>   #####</L>
      <L>####   ####</L>
      <L># $ $.$ $ #</L>
      <L>#  # . #  #</L>
      <L># $#.#.#$ #</L>
      <L>##.. @ ..##</L>
      <L># $#.#.#$ #</L>
      <L>#  # . #  #</L>
      <L># $ $.$ $ #</L>
      <L>####   ####</L>
      <L>   #####</L>
    </Level>
    <Level Id="(123) Parabel" Width="15" Height="22">
      <L>           ####</L>
      <L>           #  #</L>
      <L>          ##@ #</L>
      <L>          # $ #</L>
      <L>          # * #</L>
      <L>          # * #</L>
      <L>          # * #</L>
      <L>         ## * #</L>
      <L>         # * ##</L>
      <L>        ## * #</L>
      <L>        #  * #</L>
      <L>        #  * #</L>
      <L>        # *  #</L>
      <L>       ## *  #</L>
      <L>       #  * ##</L>
      <L>      ## * ##</L>
      <L>     ##  * #</L>
      <L>######  *  #</L>
      <L>#     **  ##</L>
      <L># .***   ##</L>
      <L>#     ####</L>
      <L>#######</L>
    </Level>
    <Level Id="(124) Easter 2017 Rev" Width="15" Height="19">
      <L>     #####</L>
      <L>    #  #  #</L>
      <L>   #  *$*  #</L>
      <L>  #  * # *  #</L>
      <L>  # *  #  * #</L>
      <L> #  * *** *  #</L>
      <L> # *  ###  * #</L>
      <L> # * ***** * #</L>
      <L>#  * ##### *  #</L>
      <L># *  *****  * #</L>
      <L># * ####### * #</L>
      <L># * ******* * #</L>
      <L>#  * ##### * ##</L>
      <L> # *  ***  * #</L>
      <L> # *   #   * #</L>
      <L> #  ** # **  #</L>
      <L> #    *+*   ##</L>
      <L>  ####   ####</L>
      <L>     #####</L>
    </Level>
    <Level Id="(125) Christmas 2017" Width="23" Height="22">
      <L>         #####</L>
      <L>         #   #</L>
      <L>         # @ #</L>
      <L>        ## # ##</L>
      <L>      ###  #  ###</L>
      <L>    ###    #    ###</L>
      <L>    #     ###  #  #</L>
      <L>  ### # # ### #  ###</L>
      <L>  # # #  $ ## #$   ##</L>
      <L>  #   $$ #  ##  #   #</L>
      <L> ##  # $ ## ##   # ###</L>
      <L> # #$#  ###   $    # #</L>
      <L>## $  $##### ###$#$  ##</L>
      <L>#  $ $   ### ###   #  #</L>
      <L>#     ##     ####  $  #</L>
      <L>## $ ##### #   ###   ##</L>
      <L># $ ###### ###  ### $ #</L>
      <L>## ###   # ###   ### ##</L>
      <L>#          # #      $ #</L>
      <L># # ##. ..   #... . # #</L>
      <L>#  . ... . #.....**.  #</L>
      <L>#######################</L>
    </Level>
    <Level Id="(126) Sokoban Revisited" Width="46" Height="11">
      <L>#######      ####   #### ####       #### ####</L>
      <L>#     ########  ### #  # #  #########  ###  ##</L>
      <L># #** #   #  #    ###  ###  #   #        #   #</L>
      <L># *  *# #**  #*  *#  **   ***   #** # *  * * #</L>
      <L>#  *    * #*  * * # *  *  *  *# *  *  ** * * #</L>
      <L># # * ##*@ *  **  # * #*# ***   *  *# * ** * #</L>
      <L># . #*# *  *##* * # *  *  *  *# ****  *  * $ #</L>
      <L>## ** #  ** # *  *   **  #***   *  *  *# * * #</L>
      <L> #    #          ####       ##  #    #       #</L>
      <L> #################  #####################  ###</L>
      <L>                                        ####</L>
    </Level>
    <Level Id="(127) Taxes" Width="13" Height="12">
      <L>   ########</L>
      <L> ###   #  #</L>
      <L> #        #</L>
      <L>## #####  #</L>
      <L>#  #   # ###</L>
      <L># ## # *** ##</L>
      <L># #   *   * #</L>
      <L># # # * ##* #</L>
      <L># # ##*   * #</L>
      <L># #   .***$@#</L>
      <L>#   ##    ###</L>
      <L>###########</L>
    </Level>
    <Level Id="(128) Boring 5x5 Without Centerbox" Width="13" Height="12">
      <L>    #####</L>
      <L>   ##   ##</L>
      <L>  ##  *  ##</L>
      <L> ##  * *  ##</L>
      <L>##  * * *  ##</L>
      <L>#  * * * *  #</L>
      <L># * * # * * #</L>
      <L>#  * * * *  #</L>
      <L>##  * * *  ##</L>
      <L> ##  *$*  ##</L>
      <L>  ##  +  ##</L>
      <L>   #######</L>
    </Level>
    <Level Id="(129) Boring 7x7" Width="17" Height="16">
      <L>      #####</L>
      <L>     ##   ##</L>
      <L>    ##  *  ##</L>
      <L>   ##  * *  ##</L>
      <L>  ##  * * *  ##</L>
      <L> ##  * * * *  ##</L>
      <L>##  * * * * *  ##</L>
      <L>#  * * * * * *  #</L>
      <L># * * * * * * * #</L>
      <L>#  * * * * * *  #</L>
      <L>##  * * * * *  ##</L>
      <L> ##  * * * *  ##</L>
      <L>  ##  * * *  ##</L>
      <L>   ##  *$*  ##</L>
      <L>    ##  +  ##</L>
      <L>     #######</L>
    </Level>
    <Level Id="(130) Big Omega" Width="12" Height="13">
      <L>   ####</L>
      <L>####  #####</L>
      <L>#  #  #   ##</L>
      <L>#  #*.* #  #</L>
      <L>#  *   *   #</L>
      <L>##*# #  * ##</L>
      <L># *   ##* #</L>
      <L>#  *#$ * ###</L>
      <L>#   * *    #</L>
      <L>##*** ***  #</L>
      <L> # # #   ###</L>
      <L> # @ #   #</L>
      <L> #########</L>
    </Level>
    <Level Id="(131) MF8 Centennial Final Version" Width="34" Height="19">
      <L>       ####        ###############</L>
      <L> #######  ##########         ##  #</L>
      <L> #.   .#....  ..#    .##.. # ..  #</L>
      <L> #.. .. . ## .  . # .. .  .#. #. #</L>
      <L> #.#.#.#.####.##.   #.#.# . . #. #</L>
      <L> #.# #.#...   .. ##.#.#.##.#. #. #</L>
      <L> #.  #.#.#   .##.#  #.#.##.#.  . #</L>
      <L> #.###.#.#   . #.  # . .##.#. #.##</L>
      <L> #.   . .  ## ..     .  .. ##..##</L>
      <L>##### #### ### ## ####### #### ###</L>
      <L># $   $ $   # $$  #  $  $$   $$  #</L>
      <L># $ # $ $ #  $  $#   $ $  $ $# $ #</L>
      <L># $ # $ $ #  $  $  # $ $ #$ $  $ #</L>
      <L># $ # $ $$$ # $$## $ $ $  $ $  $ #</L>
      <L># $ $ $ $   #$  $ #  $ $  $ $ #$ #</L>
      <L># $$ $$ $  # $  $  #$$ $  $ $  $ #</L>
      <L># $   $ $$$$ #$$ #   $ #$$   $$###</L>
      <L>#            #   # @ #     #   #</L>
      <L>################################</L>
    </Level>
    <Level Id="(132) Easter 2018" Width="15" Height="18">
      <L>     #####</L>
      <L>    ## +  #</L>
      <L>  ### .#. ###</L>
      <L> #   . # .   #</L>
      <L> # #.#.$.#.# #</L>
      <L> # $.$.$.$.$ #</L>
      <L> # $.$.$.$.$ #</L>
      <L>#  $.$.$.$.$  #</L>
      <L># ##.#.#.#.## #</L>
      <L>#  $.$.$.$.$  #</L>
      <L>#  $.$.$.$.$  #</L>
      <L># #$#$#$#$#$# #</L>
      <L>#  $.$.$.$.$  #</L>
      <L> # $.$.$.$.$ #</L>
      <L> # $.$.$.$.$ #</L>
      <L> #   #.$.#   #</L>
      <L>  ##   #   ##</L>
      <L>    #######</L>
    </Level>
    <Level Id="(133) Flipped" Width="11" Height="14">
      <L>   #####</L>
      <L>#### @ ####</L>
      <L>#    $    #</L>
      <L># #$#$#$# #</L>
      <L># $.....$ #</L>
      <L># #.###.# #</L>
      <L># $.# #.$ #</L>
      <L># #.###.# #</L>
      <L># $.....$ #</L>
      <L># #$$#$$# #</L>
      <L>#  $ # $  #</L>
      <L>###  #  ###</L>
      <L>  #     #</L>
      <L>  #######</L>
    </Level>
    <Level Id="(134) Butterfly" Width="23" Height="27">
      <L>       #       #</L>
      <L>       #       #</L>
      <L>       ##     ##</L>
      <L>        #     #</L>
      <L>        ##   ##</L>
      <L>         # # #</L>
      <L>         #*#*#</L>
      <L>  #####  **#**  #####</L>
      <L> #     #  *#*  #     #</L>
      <L>#   *$  # # # # $ *$  #</L>
      <L># $*#.   ##  #  $.#.$ #</L>
      <L>#   .$ .....*#.* $.   #</L>
      <L> # $ # #####.### #$$ #</L>
      <L> #   #$........* #   #</L>
      <L>  ##$# ####.# ## # ##</L>
      <L>   #      $. # $   #</L>
      <L>    ## $$ #.## # ##</L>
      <L>   #  .*  #.#@ #.. #</L>
      <L>  #   ### #.#$$$ $  #</L>
      <L>  # $$ $  #. $  $$$ #</L>
      <L>  #  $  ##   ##  $  #</L>
      <L>   #   #  #.#  ##  #</L>
      <L>    ###    #    ###</L>
      <L>           #</L>
      <L>           #</L>
      <L>           #</L>
      <L>           #</L>
    </Level>
    <Level Id="(135) Bjertrup1" Width="15" Height="9">
      <L>###############</L>
      <L>#             #</L>
      <L># $$$$# #$$$$ #</L>
      <L>##           ##</L>
      <L> ######@#######</L>
      <L>## .... ....  #</L>
      <L>#             #</L>
      <L>#   ########  #</L>
      <L>#####      ####</L>
    </Level>
    <Level Id="(136) Bjertrup2" Width="10" Height="11">
      <L>   #####</L>
      <L>   #   ##</L>
      <L>   #    ##</L>
      <L>##### #  #</L>
      <L>#   #... #</L>
      <L>#   $..* #</L>
      <L>##$####$ #</L>
      <L> #     $ #</L>
      <L> # $# #@ #</L>
      <L> #    ####</L>
      <L> ######</L>
    </Level>
    <Level Id="(137) Blue" Width="13" Height="14">
      <L>      ####</L>
      <L>      #  #</L>
      <L>##### #  #</L>
      <L>#   ###  #</L>
      <L>#    $  #####</L>
      <L>#### # $.*. #</L>
      <L>   #@# #... #</L>
      <L>   #$#$$... #</L>
      <L>   # #  ##  #</L>
      <L>  ##  $ #####</L>
      <L>  #  #$$#</L>
      <L>  #     #</L>
      <L>  #  ####</L>
      <L>  ####</L>
    </Level>
    <Level Id="(138) Count" Width="20" Height="21">
      <L>  ####</L>
      <L>  #  #########</L>
      <L> ##  #  #    #  ####</L>
      <L>##  $$  # #$ ####  #</L>
      <L>#  $ #  #  $    #  #</L>
      <L># $ $ # $   $ $ #  #</L>
      <L>#  $   $##$$##### ##</L>
      <L># $$$# $      $    #</L>
      <L>#  $@#  #   $ ##   #</L>
      <L>#   #########  #$###</L>
      <L>########    ##     #</L>
      <L>   ##  # ##  # #   #</L>
      <L>   #      .....#####</L>
      <L>   #     #...#.####</L>
      <L>   #  #  #.....#  #</L>
      <L>   ##### #.##..   ##</L>
      <L>      #  #.....#   #</L>
      <L>      #  ##  ###   #</L>
      <L>      #      # ##  #</L>
      <L>      ###    #  ####</L>
      <L>        ######</L>
    </Level>
    <Level Id="(139) Easter 2019" Width="12" Height="16">
      <L>    ####</L>
      <L>  ###   ##</L>
      <L> #     $$ #</L>
      <L> # $#  $  #</L>
      <L> #$ # #   #</L>
      <L>#  $ $######</L>
      <L>#  $  #. ..#</L>
      <L>#  $$$#.#..#</L>
      <L>##$# @$.#*.#</L>
      <L>#  ####.#.*#</L>
      <L>#  $   .#..#</L>
      <L>#  ##  ...*#</L>
      <L>####### #  #</L>
      <L> #  $ $   #</L>
      <L> ##      ##</L>
      <L>  ########</L>
    </Level>
    <Level Id="(140) NP Crowded Center" Width="11" Height="11">
      <L>###########</L>
      <L>#   ####  #</L>
      <L>#    $    #</L>
      <L>##$###$# ##</L>
      <L>#  #...#  #</L>
      <L>#  #...$$ #</L>
      <L>#  #...#  #</L>
      <L>##$##$## ##</L>
      <L>#    $@ $ #</L>
      <L>#     #   #</L>
      <L>###########</L>
    </Level>
    <Level Id="(141) Flacon 3" Width="21" Height="27">
      <L>       #######</L>
      <L>     ####    ###</L>
      <L>   ###     #  ####</L>
      <L>  ##    #     #  ##</L>
      <L>  #        #      #</L>
      <L> #### ###### # #  ##</L>
      <L> #     #   # #     #</L>
      <L> # #   #  ... ## # #</L>
      <L> #    ####... #    #</L>
      <L> ##      #.#. #   ##</L>
      <L>  ###    #.########</L>
      <L>    #  ###.#.  ##</L>
      <L>    ####  ...  ##</L>
      <L> ######## ...#######</L>
      <L>##      # .#.#     ##</L>
      <L>#  #### #### # ###  #</L>
      <L># ##        $    ## #</L>
      <L># #  $#$ # $$ ##  # #</L>
      <L># # $$    # ##  # # #</L>
      <L># ## # ##$ $    $ # #</L>
      <L># #   $ $ ##$#  $ # #</L>
      <L># #### $# $ $  $### #</L>
      <L>#   #  $     #  #   #</L>
      <L>### #   ###@ #### ###</L>
      <L>  # ##### #### ## #</L>
      <L>  #               #</L>
      <L>  #################</L>
    </Level>
    <Level Id="(142) Round34" Width="13" Height="11">
      <L>   #####</L>
      <L>   #   #####</L>
      <L>####       #</L>
      <L>#   #****  ##</L>
      <L>#   *   #*  #</L>
      <L>## #*  # *  #</L>
      <L> #  * ## *  #</L>
      <L> ###*    *###</L>
      <L>   # ****   #</L>
      <L>   #  @ #   #</L>
      <L>   ##########</L>
    </Level>
    <Level Id="(143) Fixed Rev" Width="10" Height="11" Copyright="39Fix, DrFogh">
      <L> #########</L>
      <L>##   #   #</L>
      <L>#  #@#   #</L>
      <L># $$$$$$$#</L>
      <L>## # # # #</L>
      <L> #   #   #</L>
      <L> ##   #  #</L>
      <L> #  #    #</L>
      <L> #.......#</L>
      <L> ####  ###</L>
      <L>    ####</L>
    </Level>
    <Level Id="(144) Grapes" Width="24" Height="27">
      <L>##############</L>
      <L>#       #    #####</L>
      <L>#@$ $ $ $ $ $##  #######</L>
      <L># ### $$ $ $ $       $ #</L>
      <L>#  ####      ##...#$$$ #</L>
      <L>##   #########**.**    #</L>
      <L>#  $  ## #    **.***   #</L>
      <L># $ $ #  ##... .. *** ##</L>
      <L># $ $ #   .....#....*$##</L>
      <L># $ $ ## **....##  .$  #</L>
      <L># $ $$## ***... ...#$$ #</L>
      <L># $$   ** *#$ $.**..   #</L>
      <L># $   #*.* .*** **..* ##</L>
      <L># $$$**..#..*.**#.*** #</L>
      <L># $  **..#.##.**# ***$##</L>
      <L># $ $***.. .. *#.. * $ #</L>
      <L># $  **** .... ...*#   #</L>
      <L># $ $   #**.... **.. $ #</L>
      <L># $ $ $  **..#  ***. $ #</L>
      <L># $ $ $  *** .. ***. $ #</L>
      <L># $ $ $ # * .*.. ..  $ #</L>
      <L># $ $ $ $  $**...##$ $ #</L>
      <L># $    $    **.** $  $ #</L>
      <L># $$$$$$$$$#**.** $$$$ #</L>
      <L>#  $ $ $ #   ...  #    #</L>
      <L>##       ####   ########</L>
      <L> #########  #####</L>
    </Level>
    <Level Id="(145) Blooming Flower" Width="7" Height="10">
      <L>#####</L>
      <L>#   ###</L>
      <L># .$. #</L>
      <L>##$*$ #</L>
      <L># .*. #</L>
      <L>#  *  #</L>
      <L>## *  #</L>
      <L> # $ ##</L>
      <L> ##@ #</L>
      <L>  ####</L>
    </Level>
    <Level Id="(146) Lambda First Version" Width="13" Height="14">
      <L>    #####</L>
      <L> ####   ##</L>
      <L> #  # #  ##</L>
      <L>##  #* #  #</L>
      <L>#   * * # #</L>
      <L>#  ## * # ###</L>
      <L># #   *@#   #</L>
      <L># #   #*    #</L>
      <L>#   # .* # ##</L>
      <L>#####*$* * #</L>
      <L> ## * # * ##</L>
      <L> #       ##</L>
      <L> #   #####</L>
      <L> #####</L>
    </Level>
    <Level Id="(147) November 2017" Width="9" Height="9">
      <L>  #####</L>
      <L>  #   #</L>
      <L>### # #</L>
      <L>#  * *###</L>
      <L>#  *@*  #</L>
      <L>#  * *  #</L>
      <L>### # ###</L>
      <L>  #   #</L>
      <L>  #####</L>
    </Level>
    <Level Id="(148) The Apple Tree" Width="15" Height="18">
      <L>    #######</L>
      <L>  ###   # ###</L>
      <L> ##   $$$ $ ##</L>
      <L>##  $ # #    ##</L>
      <L>#  $ #   #    #</L>
      <L># $ ##   ##$  #</L>
      <L># # # ##$ #   #</L>
      <L># # #    # # ##</L>
      <L>#   $ # $     #</L>
      <L>##  ### ###  ##</L>
      <L> #### # # ####</L>
      <L>      # #</L>
      <L>      # #</L>
      <L>     ## ##</L>
      <L>    ##...##</L>
      <L>   ##. . .##</L>
      <L>   #.. + ..#</L>
      <L>   #########</L>
    </Level>
    <Level Id="(149) Happy Newyear 2019" Width="29" Height="18">
      <L>          #####</L>
      <L>   ########   #  ##### #####</L>
      <L>####      #   ####   ###   #</L>
      <L>#  *** #  #*** ## *    *** ##</L>
      <L># *   *#  *   *   * # *#  * #</L>
      <L># . # * # * # * # * # *@  * #</L>
      <L># # #** # *   * # * # #***  #</L>
      <L># ***   # *###* # * # $   * #</L>
      <L># *   . # *   * # *  #$#  * #</L>
      <L># ***** #  ***  # *  # ***  #</L>
      <L>##   # ##  # ###   ##  #   ##</L>
      <L> ##  # ##  # ###   #  ######</L>
      <L>  # #  ##### ###  #  ##</L>
      <L>  # #           ##  ##</L>
      <L>  # #  # ######    ##</L>
      <L>  #  ##  #    ######</L>
      <L>  ##    ##</L>
      <L>   ######</L>
    </Level>
    <Level Id="(150) Questionmark" Width="9" Height="13">
      <L>  #######</L>
      <L>###  #  #</L>
      <L>#    #  #</L>
      <L>#  $$$  #</L>
      <L>##$# #$##</L>
      <L># *...* #</L>
      <L># .  $. #</L>
      <L>####$ # #</L>
      <L># . $ . #</L>
      <L># #.#.###</L>
      <L>#   $   #</L>
      <L>## @#   #</L>
      <L> ########</L>
    </Level>
  </LevelCollection>
</SokobanLevels>
