<?xml version="1.0" encoding="utf-8"?>
<SokobanLevels xmlns:xsi="http://www.w3.org/2001/XMLSchema-instance" xsi:schemaLocation="SokobanLev.xsd">
  <Title>Original02</Title>
  <Description>
50 original puzzles arranged roughly chronologically.
A few previously published variations only differing slightly from the
puzzles here are omitted.

FirstDate: 2015-11-21
LastDate: 2016-06-29

The puzzles can be freely distributed.
Don't remodel or sharpen anything unless it is obviously good.
I am the judge on that. 

Regards 
DrFogh
  </Description>
  <Email>bjertrup58@gmail.com</Email>
  <Url>http://www.sokoban.dk/</Url>
  <LevelCollection Copyright="DrFogh" MaxWidth="50" MaxHeight="24">
    <Level Id="051 And Now Something Different" Width="11" Height="10">
      <L>     #####</L>
      <L>######   ##</L>
      <L>#   $.$   #</L>
      <L># #$#.#$# #</L>
      <L>#  ..+..# #</L>
      <L># #$#.#$# #</L>
      <L># # $.$   #</L>
      <L># # #$### #</L>
      <L>#         #</L>
      <L>###########</L>
    </Level>
    <Level Id="052 Eazy 1" Width="17" Height="6">
      <L>     ####</L>
      <L>######  #########</L>
      <L>#   $ *..$      #</L>
      <L># # #$.*.$# # # #</L>
      <L>#   $@*..$      #</L>
      <L>#################</L>
    </Level>
    <Level Id="053 Medium 1" Width="14" Height="9">
      <L>####</L>
      <L>#  ###########</L>
      <L>#    $ $ $ $ #</L>
      <L>#  #. . . .  #</L>
      <L>## ######## ##</L>
      <L>#  . . . .#  #</L>
      <L># $ $ $ $    #</L>
      <L>########### @#</L>
      <L>          ####</L>
    </Level>
    <Level Id="054 Tough 1" Width="10" Height="11">
      <L>  ######</L>
      <L>  #    #</L>
      <L>###$ #$###</L>
      <L># $ .. $ #</L>
      <L># # ..$# #</L>
      <L># #$.. # #</L>
      <L># # *.$# #</L>
      <L>#  $.*   #</L>
      <L>### #@####</L>
      <L>  #   #</L>
      <L>  #####</L>
    </Level>
    <Level Id="055 13018" Width="7" Height="14">
      <L> #####</L>
      <L>##   ##</L>
      <L>#  #. #</L>
      <L># $#* #</L>
      <L>#  #. #</L>
      <L># $#* #</L>
      <L>#  #. #</L>
      <L># $ * #</L>
      <L># ##. #</L>
      <L># $ * #</L>
      <L>#  #. #</L>
      <L>## $ ##</L>
      <L> # @ #</L>
      <L> #####</L>
    </Level>
    <Level Id="056 Cyclic 3 Study 1" Width="9" Height="10">
      <L>  #######</L>
      <L>  #     #</L>
      <L>  #     #</L>
      <L>### ## ##</L>
      <L>#@*  # #</L>
      <L>##** # #</L>
      <L>#      #</L>
      <L># #### #</L>
      <L>#      #</L>
      <L>########</L>
    </Level>
    <Level Id="057 Cyclic 3 Study 2" Width="10" Height="7">
      <L>     #####</L>
      <L>######   #</L>
      <L>#    * # #</L>
      <L># # #*   #</L>
      <L>#   @* # #</L>
      <L>######   #</L>
      <L>     #####</L>
    </Level>
    <Level Id="058 Cyclic 3 Study 3" Width="8" Height="8">
      <L>   #####</L>
      <L>####   #</L>
      <L>#@*  # #</L>
      <L>##*  # #</L>
      <L># *    #</L>
      <L>#  ### #</L>
      <L>##     #</L>
      <L> #######</L>
    </Level>
    <Level Id="059 Cyclic 3 Study 4" Width="8" Height="9">
      <L> #####</L>
      <L> #   #</L>
      <L> # # #</L>
      <L> #   ###</L>
      <L>## #   #</L>
      <L># @* * #</L>
      <L># * # ##</L>
      <L>##    #</L>
      <L> ######</L>
    </Level>
    <Level Id="060 5x5 Cross" Width="7" Height="7">
      <L>#######</L>
      <L>#  +  #</L>
      <L># *** #</L>
      <L># $.$ #</L>
      <L># $.$ #</L>
      <L>#  .  #</L>
      <L>#######</L>
    </Level>
    <Level Id="061 Peacemaker Plus Rev" Width="36" Height="21">
      <L>                                ##</L>
      <L>#                              ##</L>
      <L>######          ###########  ###</L>
      <L>#     ########################</L>
      <L>#  $$$  $   $ $ #......#  #  #</L>
      <L># $    $ $ $  $ #.....***.   #</L>
      <L># $$$#$ $#$ $#$  ..#... ..#  ##</L>
      <L>#               ## ### ####   #</L>
      <L>################## ### #### # #</L>
      <L>                ## ### #### # ##</L>
      <L>                 #   # #    #  ##</L>
      <L>                 #  @# # #      #</L>
      <L>                 #  ## #   ## # ##</L>
      <L>                  #    #         ##</L>
      <L>                   #### # ####    #</L>
      <L>                        #  #   ## ##</L>
      <L>                        ##         #</L>
      <L>                         # #  #    #</L>
      <L>                         #   ##  # #</L>
      <L>                         ##        #</L>
      <L>                          ##########</L>
    </Level>
    <Level Id="062 Medium 2" Width="9" Height="9">
      <L>########</L>
      <L>#      #</L>
      <L># #### #</L>
      <L># .$.  #</L>
      <L>##$#$# ##</L>
      <L> #.$.   #</L>
      <L> # ## # #</L>
      <L> #@     #</L>
      <L> ########</L>
    </Level>
    <Level Id="063 Medium 3" Width="11" Height="11">
      <L>###########</L>
      <L>#    #    #</L>
      <L># $# #  . #</L>
      <L>#  $ # .# #</L>
      <L># $ $#. . #</L>
      <L># @$ * .  #</L>
      <L># $ $#. . #</L>
      <L>#  $ # .# #</L>
      <L># $# #  . #</L>
      <L>#    #    #</L>
      <L>###########</L>
    </Level>
    <Level Id="064 Tough 2" Width="14" Height="10">
      <L>         #####</L>
      <L>   #######   #</L>
      <L>####  $    # #</L>
      <L>#    ##### $ #</L>
      <L># #  ...*..###</L>
      <L>#   ## # # $ #</L>
      <L>###  #   #@# #</L>
      <L>  ## ###$$   #</L>
      <L>   #     #####</L>
      <L>   #######</L>
    </Level>
    <Level Id="065 Sun" Width="13" Height="12">
      <L>    ########</L>
      <L>    #      ##</L>
      <L>##### .###  #</L>
      <L>#  . $$$ .  #</L>
      <L># # * . * ###</L>
      <L># #$ *** $###</L>
      <L># .$.*+*.$. #</L>
      <L># #$ *** $# #</L>
      <L>#   * . *   #</L>
      <L># #.#$$$#.# #</L>
      <L>#     *     #</L>
      <L>#############</L>
    </Level>
    <Level Id="066 Eazy 2" Width="13" Height="8">
      <L>#############</L>
      <L>#   ######  #</L>
      <L>#        $  #</L>
      <L>## #######  #</L>
      <L>#  $ $ $ #$##</L>
      <L>#  #....+   #</L>
      <L>#  ######   #</L>
      <L>#############</L>
    </Level>
    <Level Id="067 Medium 4" Width="27" Height="11">
      <L>                     ######</L>
      <L>########################  #</L>
      <L>#      #######   #######  #</L>
      <L>#  $ $$#   ### # #   ###  #</L>
      <L># # $  #....     #....   ##</L>
      <L># $$ $$##  ### ####  ##   #</L>
      <L># # $  ## ####  ### ###   #</L>
      <L>#  $ $$     #....     #   #</L>
      <L># ## # ## # #   ### # ##  #</L>
      <L>#@     ##   #######   ##  #</L>
      <L>###########################</L>
    </Level>
    <Level Id="068 Swastika" Width="11" Height="10">
      <L>    #####</L>
      <L>   ##   ##</L>
      <L> ###  #  #</L>
      <L>## @.*$  ##</L>
      <L>#  $ * .  #</L>
      <L># #**#**# #</L>
      <L>#  . * $  #</L>
      <L>## #$*.# ##</L>
      <L> #   #   #</L>
      <L> #########</L>
    </Level>
    <Level Id="069 Oblique" Width="14" Height="13">
      <L>    #####</L>
      <L>  ###   ######</L>
      <L>###   #      #</L>
      <L>#   # #.###  #</L>
      <L># # # ..  #$ #</L>
      <L>#   #.### $ ##</L>
      <L># # ..  #$# #</L>
      <L># #.### $ $ #</L>
      <L># ..  #$ $  #</L>
      <L># # # $ $# @#</L>
      <L>#   #    ####</L>
      <L>#####  ###</L>
      <L>    ####</L>
    </Level>
    <Level Id="070 Eazy" Width="7" Height="13">
      <L> #####</L>
      <L> #   #</L>
      <L>##   ##</L>
      <L># $$$ #</L>
      <L># .#. #</L>
      <L># . . #</L>
      <L># #$# #</L>
      <L># . . #</L>
      <L># .#. #</L>
      <L>##$$$##</L>
      <L> # $ #</L>
      <L> # @ #</L>
      <L> #####</L>
    </Level>
    <Level Id="071 Never Done Before" Width="15" Height="15">
      <L>###############</L>
      <L>#.............#</L>
      <L>#.$$$$$$$$$$$.#</L>
      <L>#.$         $.#</L>
      <L>#.$ ******* $.#</L>
      <L>#.$ *     * $.#</L>
      <L>#.$ * $$$ * $.#</L>
      <L>#.$ * $@$ * $.#</L>
      <L>#.$ * $$$ * $.#</L>
      <L>#.$ *     * $.#</L>
      <L>#.$ ******* $.#</L>
      <L>#.$         $.#</L>
      <L>#.$$$$$$$$$$$.#</L>
      <L>#.............#</L>
      <L>###############</L>
    </Level>
    <Level Id="072 Twosix11" Width="11" Height="12">
      <L>  #####</L>
      <L>  #   ###</L>
      <L>  #     ###</L>
      <L> #### #   #</L>
      <L> # $ $### #</L>
      <L>## ##..   #</L>
      <L>#   #..# ##</L>
      <L># #  ..# ##</L>
      <L># #$##$#  #</L>
      <L>#  $ @  $ #</L>
      <L>########  #</L>
      <L>       ####</L>
    </Level>
    <Level Id="073 Big22" Width="19" Height="15">
      <L>        ######</L>
      <L>#########    ####</L>
      <L>#      ## ## $  #</L>
      <L># #$# $   # $   ###</L>
      <L>#    $ #  @  #    #</L>
      <L># #  # #$######$# #</L>
      <L># $  $ #.*.*..#   #</L>
      <L>####$ ##.#.*.* $$ #</L>
      <L>   #  # .*.*..#$ ##</L>
      <L>   ## # ...*..#  #</L>
      <L>    # ###$### # ##</L>
      <L>    #$           #</L>
      <L>    #  #######$# #</L>
      <L>    ####     #   #</L>
      <L>             #####</L>
    </Level>
    <Level Id="074 Sunday Morning" Width="11" Height="8">
      <L>###########</L>
      <L># . . .   #</L>
      <L># $* .$   #</L>
      <L>## ##### ##</L>
      <L>#  #   # #</L>
      <L>#  $ $@  #</L>
      <L>#  #######</L>
      <L>####</L>
    </Level>
    <Level Id="075 Pinhole70" Width="18" Height="13">
      <L>     #####</L>
      <L>   ###   #</L>
      <L>   #   # #</L>
      <L>   # #   #</L>
      <L>####  ##$########</L>
      <L>#   #$  $ #     ##</L>
      <L>#   $ #$# # # #  #</L>
      <L># # # #   #....  #</L>
      <L># $   ## $@  #.  #</L>
      <L># # #$## ##....  #</L>
      <L>#   $    ## # #  #</L>
      <L>######   ##     ##</L>
      <L>     ############</L>
    </Level>
    <Level Id="076 Smallbone" Width="14" Height="13">
      <L>##############</L>
      <L>#     ####   #</L>
      <L># $$  ###    #</L>
      <L>## $  ###    #</L>
      <L>## $ ####   ##</L>
      <L>## $ ####   ##</L>
      <L>##   #  ##  ##</L>
      <L>## $##....  ##</L>
      <L>## $... ##  ##</L>
      <L>## $# #.##  ##</L>
      <L>##  # @ ##  ##</L>
      <L>##  ##########</L>
      <L>##############</L>
    </Level>
    <Level Id="077 Dollars" Width="9" Height="11" Copyright="Tyge Fogh">
      <L>  #####</L>
      <L> ## @ ##</L>
      <L>## $$$ ##</L>
      <L># $ . $ #</L>
      <L># .***. #</L>
      <L># * . $ #</L>
      <L># ***** #</L>
      <L># $ . * #</L>
      <L># .***. #</L>
      <L>#   *   #</L>
      <L>#########</L>
    </Level>
    <Level Id="078 Euro" Width="14" Height="15" Copyright="Tyge Fogh">
      <L>       #####</L>
      <L>########   #</L>
      <L>#   ##     #</L>
      <L>#     **** ###</L>
      <L>## ##*# # *  #</L>
      <L> #  *      # #</L>
      <L> # *******   #</L>
      <L> #  *@  #  ###</L>
      <L> # *******####</L>
      <L> ## * #      #</L>
      <L> #   *    *  #</L>
      <L> # ###****####</L>
      <L> #         #</L>
      <L> ######    #</L>
      <L>      ######</L>
    </Level>
    <Level Id="079 Yen" Width="15" Height="14" Copyright="Tyge Fogh">
      <L>###############</L>
      <L>##.. ##   .. ##</L>
      <L>#  ..   #..# ##</L>
      <L># #$**$$**$$  #</L>
      <L>#  $ ..*.  $# #</L>
      <L># #$##+*## $  #</L>
      <L>#  $...*.. $  #</L>
      <L># #$$$**$$$$# #</L>
      <L>#  $...... $  #</L>
      <L>###$##..###$# #</L>
      <L>#  $  ..   $  #</L>
      <L># #$##..$$$$# #</L>
      <L>#      ##     #</L>
      <L>###############</L>
    </Level>
    <Level Id="080 Pound Rev" Width="13" Height="15" Copyright="Tyge Fogh">
      <L>    #####</L>
      <L>   ##   #####</L>
      <L>   #    #   #</L>
      <L>   #  **    #</L>
      <L>   ##*  .# ##</L>
      <L>####@* #$# #</L>
      <L>#   ***#   #</L>
      <L># #  *  #####</L>
      <L># ## *      #</L>
      <L>#   *****## #</L>
      <L>### #     # #</L>
      <L>  # ##    # #</L>
      <L>  #  ###### #</L>
      <L>  ##        #</L>
      <L>   ##########</L>
    </Level>
    <Level Id="081 Ski" Width="17" Height="9" Copyright="Tyge Fogh">
      <L>            #####</L>
      <L>#############   #</L>
      <L># $ $ $ $ $ $ # #</L>
      <L># # # # # # # # #</L>
      <L># #             #</L>
      <L># # ###### # # ##</L>
      <L>#@. . . . . .   #</L>
      <L>#########       #</L>
      <L>        #########</L>
    </Level>
    <Level Id="082 McDonalds" Width="17" Height="18" Copyright="Tyge Fogh">
      <L>           ####</L>
      <L>  ##########  #</L>
      <L>  #        #  #</L>
      <L>  #   * # *   #</L>
      <L>  #  * * * * ##</L>
      <L>#### * * * *  #</L>
      <L>#   * #* * #* ##</L>
      <L># # *   *#  *  #</L>
      <L>#   * # *   *  #</L>
      <L>## * ###* ###*##</L>
      <L> # *##  * #  * ##</L>
      <L> # *@# #*    *  #</L>
      <L> # *##   ##  *  #</L>
      <L> ## ##   ###  ###</L>
      <L> #  ### ## #  #</L>
      <L> #      #  ####</L>
      <L> #####  #</L>
      <L>     ####</L>
    </Level>
    <Level Id="083 Month" Width="11" Height="9" Copyright="Tyge Fogh">
      <L>#######</L>
      <L>#  #  ####</L>
      <L>#  # $   ##</L>
      <L>#  ...#$  #</L>
      <L>## #$ # # #</L>
      <L>#  .*.# $ #</L>
      <L>#  #$   ###</L>
      <L>#  # @###</L>
      <L>#######</L>
    </Level>
    <Level Id="084 13083" Width="22" Height="9" Copyright="Tyge Fogh">
      <L>             ######</L>
      <L>             #    #</L>
      <L>##############    #</L>
      <L>#          #...# #####</L>
      <L># $$$$$$$$$ ...#     #</L>
      <L>#        @ #...      #</L>
      <L>#########  ## #### # #</L>
      <L>        #####        #</L>
      <L>            ##########</L>
    </Level>
    <Level Id="085 Sokoban.dk Logo" Width="50" Height="9" Copyright="Tyge Fogh">
      <L>##################################################</L>
      <L>#      #    #    #    #    #    #   #  #     #   #</L>
      <L># $*** #**  *  * #**  ***   **  *  *   ***  *# * #</L>
      <L># *    *  * * *  *  * *  * *  * ** *  #*  * * *  #</L>
      <L>#  **  *  * **   *  * ***  *  * * **#  *  * **   #</L>
      <L>#    * *  * * *  *  * *  * **** *  *  #*  * * *  #</L>
      <L># ***  #**  *  * #**  ***  *  * *  * * ***  *# + #</L>
      <L>#      #    #    #    #         #  #   #     #   #</L>
      <L>##################################################</L>
    </Level>
    <Level Id="086 Spiros" Width="16" Height="16" Copyright="Tyge Fogh">
      <L>###########</L>
      <L>#@    ##  ######</L>
      <L>#   # ##...    #</L>
      <L>#     ##.*.# # #</L>
      <L>#     #.*.# $  #</L>
      <L>#    ##*..# $  #</L>
      <L>#  $ #...# $ # #</L>
      <L># $ ##...#  $# #</L>
      <L>#  $#.**# $$$  #</L>
      <L>#   $...# #  $ #</L>
      <L># # ##  # $  # #</L>
      <L>#    #$## $  $ #</L>
      <L>#     $ # #$$# #</L>
      <L>#   #   #      #</L>
      <L>##  #   ########</L>
      <L> ########</L>
    </Level>
    <Level Id="087 How Easy Can It Be" Width="7" Height="7" Copyright="Tyge Fogh">
      <L>#######</L>
      <L>####  #</L>
      <L>#  *  #</L>
      <L>#  *  #</L>
      <L>#  *@ #</L>
      <L>#  ####</L>
      <L>#######</L>
    </Level>
    <Level Id="088 April 2016" Width="12" Height="16" Copyright="Tyge Fogh">
      <L>  ######</L>
      <L> ##    #</L>
      <L> #     ####</L>
      <L> # ## #   #</L>
      <L> # ....   #</L>
      <L>###....####</L>
      <L>#  ....#</L>
      <L># #....####</L>
      <L># ####$   #</L>
      <L>#   $  $  #</L>
      <L>### $ $ $ ##</L>
      <L>  #$ $ $ $ #</L>
      <L>  # $   $  #</L>
      <L>  #$ $$$ ###</L>
      <L>  #   @ ##</L>
      <L>  #######</L>
    </Level>
    <Level Id="089 SokobanOnline Rev2" Width="18" Height="19" Copyright="Tyge Fogh">
      <L>##################</L>
      <L>#                #</L>
      <L>#  $$$   ####    #</L>
      <L>#  $  # #    #   #</L>
      <L># $ $  #      #  #</L>
      <L># $$ #  ....  #  #</L>
      <L># $  $ ..#... # ##</L>
      <L># $$$$#..#...##  #</L>
      <L>#   $ # ....##   #</L>
      <L># $ $ $ #####    #</L>
      <L># $$  #  ###  # ##</L>
      <L># $ $#..#*#*# .  #</L>
      <L>#  $ #...#####.. #</L>
      <L># $  #$# #####.. #</L>
      <L># $ $ $  ## ## # #</L>
      <L># $ $ #...$...   #</L>
      <L># $$$  ### ### # #</L>
      <L>#@          #    #</L>
      <L>##################</L>
    </Level>
    <Level Id="090 VW2" Width="21" Height="24" Copyright="Tyge Fogh">
      <L>            #####</L>
      <L>        #####   ##</L>
      <L>       ##     #  ##</L>
      <L>   #####   #   #  #</L>
      <L>  ##  # *****  #  ##</L>
      <L>###   ** # # **#   #</L>
      <L>#   #*# *   *  * # ##</L>
      <L># # * # *   * # *   #</L>
      <L># # *   #* *# # *   #</L>
      <L>#  **  # * *  # **# #</L>
      <L># #* *#  #*# # * *  #</L>
      <L>#  *  *  #@#  *  *# #</L>
      <L># #* #*   *   *# *  #</L>
      <L>#  *   *#*#*#*   *# #</L>
      <L>## #*  * * * * #*   #</L>
      <L> #  * # *   *   *   #</L>
      <L> # # *  * # *# * #  #</L>
      <L> #  # **#    **##  ##</L>
      <L> ## #   *****#    ##</L>
      <L>  #  ##    #   ####</L>
      <L>  ##  #    # ###</L>
      <L>   ##  ####  #</L>
      <L>    ##      ##</L>
      <L>     ########</L>
    </Level>
    <Level Id="091 Big Right" Width="31" Height="11" Copyright="Tyge Fogh">
      <L>###############################</L>
      <L>#     #.   #. ###.   #        #</L>
      <L># $$# $..# #..  $..  # $$$$$$ #</L>
      <L># $   #... $... #... # $      #</L>
      <L># $$$ #....#....#....# $$$$$$ #</L>
      <L># $   #... $... #... # $      #</L>
      <L># $$$ #..# #..# #..# # $$$$$$ #</L>
      <L>#     $.   #.   #.   $        #</L>
      <L># $$$ #$#########$####$$$$$$$ #</L>
      <L>#@      #########             #</L>
      <L>###############################</L>
    </Level>
    <Level Id="092 Nine" Width="14" Height="11" Copyright="Tyge Fogh">
      <L>#############</L>
      <L>#  ...#     ##</L>
      <L># #...  $##  #</L>
      <L>#  ... #     #</L>
      <L># ## # #$# # #</L>
      <L>#  $  $  $ # #</L>
      <L>###### # # $ #</L>
      <L>   #  $  $ ###</L>
      <L>   #   $#  #</L>
      <L>   ### @####</L>
      <L>     ####</L>
    </Level>
    <Level Id="093 Single Quote" Width="16" Height="11" Copyright="Tyge Fogh">
      <L>################</L>
      <L>#   ##     #   #</L>
      <L>#   $ $ ##. .  #</L>
      <L>## #$ $###. .###</L>
      <L> #  $@$ # . .  #</L>
      <L> ### ## #      #</L>
      <L>  #     ### ####</L>
      <L>  #  ## ###  #</L>
      <L>  #  #       #</L>
      <L>  ####   ##  #</L>
      <L>     #########</L>
    </Level>
    <Level Id="094 My First Autogenerated Level Rev" Width="9" Height="13" Copyright="Tyge Fogh">
      <L>   ###</L>
      <L>   #.#</L>
      <L>   #.#</L>
      <L>   #.#</L>
      <L>####.##</L>
      <L>#  #.@##</L>
      <L>#  #.  ##</L>
      <L>#  #.$$ #</L>
      <L># $##$  #</L>
      <L>#     $ #</L>
      <L>## $ #$ #</L>
      <L> #     ##</L>
      <L> #######</L>
    </Level>
    <Level Id="095 Flacon Rev" Width="13" Height="20" Copyright="Tyge Fogh">
      <L>     ###</L>
      <L>    ##  #</L>
      <L>   ##   ##</L>
      <L>  ## . . ##</L>
      <L>  # . . . #</L>
      <L>  #. # # .#</L>
      <L>  # . . . #</L>
      <L>  #  . .  #</L>
      <L>  ###   ###</L>
      <L>    ## ##</L>
      <L>   ##   ##</L>
      <L>  ## $ $ ##</L>
      <L>### $   $ ###</L>
      <L>#  $ $#$ $  #</L>
      <L># # $   $ # #</L>
      <L># #  $ $  # #</L>
      <L># ##  #   # #</L>
      <L>#  #######  #</L>
      <L>##    @    ##</L>
      <L> ###########</L>
    </Level>
    <Level Id="096 Just Pop The Bottle" Width="14" Height="18" Copyright="Tyge Fogh">
      <L>    #######</L>
      <L>    ##   ##</L>
      <L>     # . #</L>
      <L>     #   #</L>
      <L>     ##$##</L>
      <L>     #   #</L>
      <L>  ####   ##</L>
      <L> #   #*** ###</L>
      <L>## #  * *   ##</L>
      <L>#   *** ***  #</L>
      <L># ##*  @  *# #</L>
      <L># # *** ***  #</L>
      <L># # # * *  # #</L>
      <L># #   ***# # #</L>
      <L># #   #    # #</L>
      <L>#   ######   #</L>
      <L>###        ###</L>
      <L>  ##########</L>
    </Level>
    <Level Id="097 The Little Train" Width="16" Height="14" Copyright="Tyge Fogh">
      <L>  #####</L>
      <L>         ###</L>
      <L>            ##</L>
      <L>#########    ##</L>
      <L> #     #     ##</L>
      <L> # # # ########</L>
      <L> #            ##</L>
      <L> ### # ######  #</L>
      <L> # $ # .     # #</L>
      <L> #@$ # .#### # #</L>
      <L> # $ # .     # #</L>
      <L> ###        #  #</L>
      <L>   #   ####   #</L>
      <L>   #####  #####</L>
    </Level>
    <Level Id="098 Not much to be done" Width="9" Height="9" Copyright="Tyge Fogh">
      <L> ######</L>
      <L> #    ###</L>
      <L> #      #</L>
      <L>###*$*# #</L>
      <L>#  * *  #</L>
      <L>#  *+* ##</L>
      <L>### # ##</L>
      <L>  #   #</L>
      <L>  #####</L>
    </Level>
    <Level Id="099 False" Width="12" Height="15" Copyright="Tyge Fogh">
      <L>#########</L>
      <L>#       #</L>
      <L># *$*$* #</L>
      <L>#@      #</L>
      <L># *$*$* ####</L>
      <L>#       #  #</L>
      <L># *$*$*    #</L>
      <L>#       #  #</L>
      <L>#### #### ##</L>
      <L>  #..#    #</L>
      <L>  #..# ## ##</L>
      <L>  #..      #</L>
      <L>  #  # #   #</L>
      <L>  #    #####</L>
      <L>  ######</L>
    </Level>
    <Level Id="100 Snooker" Width="13" Height="12" Copyright="Tyge Fogh">
      <L>   ######</L>
      <L>   #    #</L>
      <L>   #    ####</L>
      <L>#### # ##  ##</L>
      <L>#  $   # $  #</L>
      <L># @$#.....# #</L>
      <L>### # #$#$  #</L>
      <L>  #   #    ##</L>
      <L>  ####  #  #</L>
      <L>     #  ####</L>
      <L>     #  #</L>
      <L>     ####</L>
    </Level>
  </LevelCollection>
</SokobanLevels>
