<?xml version="1.0" encoding="utf-8"?>
<SokobanLevels xmlns:xsi="http://www.w3.org/2001/XMLSchema-instance" xsi:schemaLocation="SokobanLev.xsd">
  <Title>Pacov</Title>
  <Description>
Pacov by Zivojin Trifunovic
  </Description>
  <Email>zivojintrifunovic21@gmail.com</Email>
  <LevelCollection Copyright="Zivojin Trifunovic" MaxWidth="45" MaxHeight="21">
    <Level Id="1" Width="28" Height="16">
      <L>                ###</L>
      <L>               #   #</L>
      <L>              #     #</L>
      <L>             #   . . #</L>
      <L>     ####   #   # #  #</L>
      <L>    #   #  #  #  . . #####</L>
      <L>    #   # #      #   #   #</L>
      <L>     #  ## $$ # #. . #   #</L>
      <L>     ## $ $  $  ##   #   #</L>
      <L>    ##  $$  #@$ #. . #   #</L>
      <L>  ### . $ $    $##   #   #</L>
      <L>###.      $ #  $ #   #   #</L>
      <L>   #  .### # #   . . #   ###</L>
      <L>    ###  # # ####    #</L>
      <L>         # # #       #</L>
      <L>         ### #########</L>
    </Level>
    <Level Id="2" Width="30" Height="13">
      <L>             #####</L>
      <L>            #.....#</L>
      <L>   #####   #. $   .#</L>
      <L>   #   #  #.  $  $$.#</L>
      <L>   #   # #.$  $ $   .#</L>
      <L>    #  ##.  $  $    .#</L>
      <L>     #  $   $$$$ #.$..#######</L>
      <L>    # . $$$$#@ $#.  .# #    #</L>
      <L>   #  $$$  $   $.$$$.#      ##</L>
      <L>  #.$....  $   $.  $.#</L>
      <L> #######.########  .#</L>
      <L>#       #       #..#</L>
      <L>       #       ####</L>
    </Level>
    <Level Id="3" Width="30" Height="13">
      <L>             #####</L>
      <L>            #.....#</L>
      <L>   #####   #. $ $ .#</L>
      <L>   #  .#  #.$$$$$$$.#</L>
      <L>   #  .# #.$  $ $  ..#</L>
      <L>    # .##.$ $  $  $$.#</L>
      <L>     #$ $   $$$$ #.$..#######</L>
      <L>    #.. $$$$#+.$#.  .#      #</L>
      <L>   #. $$$  $ . $.$$$.#      ##</L>
      <L>  #.$....  $ . $.  $.#</L>
      <L> #######.######## $.#</L>
      <L>#       #       #..#</L>
      <L>       #       ####</L>
    </Level>
    <Level Id="4" Width="45" Height="21">
      <L>              ##</L>
      <L>           ########      ########</L>
      <L>           #      ##   ###      ######</L>
      <L>           #       #  ##             ##</L>
      <L>           ##      #  # $$$$$$$.....  #</L>
      <L>           #       # ##        .$$$$$ ##</L>
      <L>          #   $#######.. .. .  .....$  #</L>
      <L>       ####   $ ##   #. . . .      .$  #</L>
      <L>      ##      $  $   $. . . . $ .. .$  #</L>
      <L>    ###   .   $  $   $.   . . $.   .$  #</L>
      <L>   ##   $     $  $$$$$. $ . .  . ...$  #####</L>
      <L> ###.$$$$$$$$$$$$$ @ $  $      .    $  #   #</L>
      <L>#### ....     $  ##  $  $      .    $  #   ##</L>
      <L>   #####..... $ ..## $  $$$$$$$.$$$$$  #    #</L>
      <L>       ########  ..# $     .....      ##   ##</L>
      <L>            ###  ..########          ##    #</L>
      <L>            #.....##     #############     #</L>
      <L>           # ######        ##              #</L>
      <L>           ###             ##             ##</L>
      <L>                                          #</L>
      <L>                                          ##</L>
    </Level>
    <Level Id="5" Width="28" Height="15">
      <L>        ###    ####</L>
      <L>       #  #   #    #</L>
      <L>      # $ #  #..$$. #</L>
      <L>     #   .# #.. $ ..###</L>
      <L>     # ...##..$$$$$$  #</L>
      <L>      #$$# $.$$ $..$  #</L>
      <L>     #   $ .  $@ . $$ ##</L>
      <L>    #  .$ $ $ $$$.#.$ .#</L>
      <L>   #  $$$$$$ #    #.$$.#####</L>
      <L>  # .....$ .# #####.$  #   #</L>
      <L>########## .# #.....  ##   #</L>
      <L>        ###.# # #######    #</L>
      <L>       #    # # #        ###</L>
      <L>       ###### ###        #</L>
      <L>                         ###</L>
    </Level>
    <Level Id="6" Width="43" Height="19">
      <L>         #####################</L>
      <L>         #           @       #####</L>
      <L>         #                       ##</L>
      <L>        ##      .#       #.       #</L>
      <L>        #     ####       ####     #</L>
      <L>        #     #**# #   # #**#     #</L>
      <L>        #    .#**# #   # #**#.    #</L>
      <L>        #    ##### #   # #####    #</L>
      <L>        #          #. .#         ##</L>
      <L>        #          ## ##         #</L>
      <L>        #          .# #          #</L>
      <L>        #          ## ##         #</L>
      <L>        #    #  #. ##$##  #.#    #</L>
      <L>        #   #.$$.#$$ $   #.$$$#  #</L>
      <L>        #  #.   $ .# ##$#  $  .# #</L>
      <L>######### ###$ $$ .   .  $ $ .## ##########</L>
      <L>  #     .    $ $ ###.  ### $ $    .     #</L>
      <L> ############    #  # #  #    ############</L>
      <L> #          #####    #    #####          #</L>
    </Level>
    <Level Id="7" Width="28" Height="15">
      <L>        ###    ####</L>
      <L>       #  #   #    #</L>
      <L>      # $.#  #..$$. #</L>
      <L>     #   .# #.. $ ..###</L>
      <L>     # ...##..$$$$$$  #</L>
      <L>      # $# $.$$ $..$  #</L>
      <L>     #   $ .  $@ .$$$ ##</L>
      <L>    #  .$ $ $ $$$.#.$ .#</L>
      <L>   # $$$$$$$ #    #.$$.#####</L>
      <L>  # .....$ .# #####.$  #   #</L>
      <L>########## .# #.....  ##   #</L>
      <L>        ###.# # #######    #</L>
      <L>       #    # # #        ###</L>
      <L>       ###### ###        #</L>
      <L>                         ###</L>
    </Level>
    <Level Id="8" Width="28" Height="15">
      <L>        ###    ####</L>
      <L>       #  #   # $ .#</L>
      <L>      # $ #  #..$$. #</L>
      <L>     #   .# #.. $ ..###</L>
      <L>     # ...##..$$$$$$  #</L>
      <L>      #$$# $.$$ $..$  #</L>
      <L>     #   $ .  $@$. $$ ##</L>
      <L>    #  .$ $ $ $$$.#.$ .#</L>
      <L>   #  $$$$$$.#    #.$$.#####</L>
      <L>  #......$ .# #####.$  #   #</L>
      <L>########## .# #.....$ ##   #</L>
      <L>        ###.# # #######    #</L>
      <L>       #    # # #        ###</L>
      <L>       ###### ###        #</L>
      <L>                         ###</L>
    </Level>
    <Level Id="9" Width="31" Height="19">
      <L>       ####   ####</L>
      <L>       #**#   #**#</L>
      <L>       #**#   #**#</L>
      <L>     ###############</L>
      <L>     #      @      #</L>
      <L>     #  ###$.$###  #</L>
      <L>     #  #*# . #*#  #</L>
      <L>     #  ###$.$###  #</L>
      <L>    #  $. # . # .$  #</L>
      <L>     # $.$ $.$ $.$ #</L>
      <L>      # .$ $.$ $. #       # # #</L>
      <L>       # $.....$ #           #</L>
      <L>        #  $.$  #  ## ##  # ###</L>
      <L>         #  .  #   # # #  # #</L>
      <L>         ###.###   # # #  # ###</L>
      <L>##########**#**##### # ## #   #</L>
      <L>         #*###*#          # ###</L>
      <L>##########**#**##########</L>
      <L>         ### ###</L>
    </Level>
    <Level Id="10" Width="28" Height="12">
      <L>    ######</L>
      <L>   #     #</L>
      <L>  # .$.$ # #########</L>
      <L>   # .$. # #*      ##</L>
      <L>    #  ### # $. .  *#</L>
      <L>     # #   #  $   $ #</L>
      <L>     # #####. .$.$. #</L>
      <L>    #    $ $.   $ . #####</L>
      <L>   #..    $@  .$.$  #   #</L>
      <L>  #   ###* $  $   $ #   #</L>
      <L>## ###  #### $. .####   ####</L>
      <L>         #  ######</L>
    </Level>
    <Level Id="11" Width="35" Height="17">
      <L>       #####        ##</L>
      <L>       #    #      #..#</L>
      <L>    ### $.$ #     #.  .#</L>
      <L>    #   $.$ #    #.$$$ .#</L>
      <L>    # ..... #   #.   $  .#</L>
      <L>    ## $$. #   #.$$$$$$$ .#</L>
      <L>      #  $#   #+   . $    .#   #</L>
      <L>      ## $ ###.$ .$ .###$$.#</L>
      <L>     #  $.$    $  $$$.$. $$.######</L>
      <L>     #  $ $ $$$.$$$  #. .$.#      #</L>
      <L>   ###$  $  $ .#. $  #.  $ #      #</L>
      <L>  #    .## $$.# #.$ .#.$.$.#      #</L>
      <L>## ## .#  #   #  #.  ## $  #      #</L>
      <L>     ##   ##.#    #.$.#. .$#   ####</L>
      <L>           #.#     #.# #   #   #</L>
      <L>           #.#    # .     .#   #</L>
      <L>           ###    ##########</L>
    </Level>
    <Level Id="12" Width="35" Height="17">
      <L>       #####        ##</L>
      <L>       #    #      #..#</L>
      <L>    ### $.$ #     #.  .#</L>
      <L>    #   $.$ #    #.$$$ .#</L>
      <L>    # ..... #   #.   $  .#</L>
      <L>    ## $$. #   #.$$$$$$$ .#</L>
      <L>      #  $#   #+   . $ .. .#   #</L>
      <L>      ## $ ###.$ .$ .###$$.#</L>
      <L>     #  $.$    $  $$$.$. $$.######</L>
      <L>     #  $ $ $$$.$$$  #.$.$.#      #</L>
      <L>   ###$  $  $ .#. $  #.$ $ #      #</L>
      <L>  #    .## $$.# #.$ .#.$.$.#      #</L>
      <L>## ## .#  #   #  #.  ## $  #      #</L>
      <L>     ##   ##.#    #.$.#. .$#   ####</L>
      <L>           #.#     #.# #   #   #</L>
      <L>           #.#    # .     .#   #</L>
      <L>           ###    ##########</L>
    </Level>
    <Level Id="13" Width="35" Height="17">
      <L>       #####        ##</L>
      <L>       #    #      #..#</L>
      <L>    ### $.$ #     #.  .#</L>
      <L>    # $ $.$ #    #.$$$$.#</L>
      <L>    # ..... #   #.   $  .#</L>
      <L>    ## $$. #   #.$$$$$$$$.#</L>
      <L>      #  $#   #+   . $ .. .#   #</L>
      <L>      ##   ###.$ .$ .###$$.#</L>
      <L>     #  $.$    $  $$$.$. $$.######</L>
      <L>     #  $ $ $$$.$$$. #.$.$.#      #</L>
      <L>   ### $ $  $ .#. $. #.$ $ #      #</L>
      <L>  #.  $.## $$.# #.$ .#.$.$.#      #</L>
      <L>## ## .#  #   #  #.  ## $  #      #</L>
      <L>     ##   ##.#    #.$.#. .$#   ####</L>
      <L>           #.#     #.# #   #   #</L>
      <L>           #.#    # .     .#   #</L>
      <L>           ###    ##########</L>
    </Level>
    <Level Id="14" Width="31" Height="19">
      <L>       ####   ####</L>
      <L>       #**#   #**#</L>
      <L>       #**#   #**#</L>
      <L>     ###############</L>
      <L>     #      @      #</L>
      <L>     # $###$.$###$ #</L>
      <L>     # .#*# . #*#. #</L>
      <L>     #  ###$.$###  #</L>
      <L>    #  $. # . # .$  #</L>
      <L>     # $.$ $.$ $.$ #</L>
      <L>      # .$ $.$ $. #       # # #</L>
      <L>       # $.....$ #           #</L>
      <L>        # .$.$. #  ## ##  # ###</L>
      <L>         # $.$ #   # # #  # #</L>
      <L>         ###.###   # # #  # ###</L>
      <L>##########**#**##### # ## #   #</L>
      <L>         #*###*#          # ###</L>
      <L>##########**#**##########</L>
      <L>         ### ###</L>
    </Level>
    <Level Id="15" Width="31" Height="19">
      <L>       ####   ####</L>
      <L>       #**#   #**#</L>
      <L>       #**#   #**#</L>
      <L>     ###############</L>
      <L>     #      @      #</L>
      <L>     # $###$.$###$.#</L>
      <L>     # .#*# . #*#. #</L>
      <L>     #  ###$.$###  #</L>
      <L>    #  $. # . # .$  #</L>
      <L>     # $.$ $*$ $.$ #</L>
      <L>      # .$ $.$ $. #       # # #</L>
      <L>       # $.....$ #           #</L>
      <L>        # .$.$. #  ## ##  # ###</L>
      <L>         # $.$ #   # # #  # #</L>
      <L>         ###.###   # # #  # ###</L>
      <L>##########**#**##### # ## #   #</L>
      <L>         #*###*#          # ###</L>
      <L>##########**#**##########</L>
      <L>         ### ###</L>
    </Level>
    <Level Id="16" Width="31" Height="19">
      <L>       ####   ####</L>
      <L>       #**#   #**#</L>
      <L>       #**#   #**#</L>
      <L>     ###############</L>
      <L>     #.     $@     #</L>
      <L>     # $###$.$###$.#</L>
      <L>     # .#*# . #*#. #</L>
      <L>     #  ###$.$###  #</L>
      <L>    #  $. # . # .$  #</L>
      <L>     # $.$ $*$ $.$ #</L>
      <L>      # .$ $.$ $. #       # # #</L>
      <L>       # $.....$ #           #</L>
      <L>        # .$.$. #  ## ##  # ###</L>
      <L>         # $.$ #   # # #  # #</L>
      <L>         ###.###   # # #  # ###</L>
      <L>##########**#**##### # ## #   #</L>
      <L>         #*###*#          # ###</L>
      <L>##########**#**##########</L>
      <L>         ### ###</L>
    </Level>
    <Level Id="17" Width="22" Height="10">
      <L>     #</L>
      <L>    # #    #</L>
      <L>   #  .#  # #</L>
      <L>    #  # #. .#</L>
      <L>     #$.# $ $ #</L>
      <L>    #   $$@    #####</L>
      <L>   # .$ $ $$$  #   #</L>
      <L>  # .  .#.   .#    #</L>
      <L>## ##### ###.#     ###</L>
      <L>      #  #  #</L>
    </Level>
    <Level Id="18" Width="22" Height="10">
      <L>     #</L>
      <L>    # #    ####</L>
      <L>   #  .#  #   .#</L>
      <L>    # .# #.$.$  #</L>
      <L>     #$.# $ $.$$#</L>
      <L>    #   $$@.   .####</L>
      <L>   # .$ $ $$$$ #   #</L>
      <L>  # .  .#.   .#    #</L>
      <L>## ##### ###.#     ###</L>
      <L>      #  #  #</L>
    </Level>
    <Level Id="19" Width="27" Height="15">
      <L>          #</L>
      <L>         # #</L>
      <L>        #   #</L>
      <L>     #########    ######</L>
      <L>     #   @$  .#   #....#</L>
      <L>     #     $ $ #  #....#</L>
      <L>    ##     $ $ .# #...#</L>
      <L>  #### $$$$$    .##..#</L>
      <L>  # ##     $$$$$$  $$.#</L>
      <L>  #  #     $     $$$  .#</L>
      <L>  #  #      ####   $   .#</L>
      <L>  #  #     .#  #.####.# ###</L>
      <L>###  ###### #  # #   # #</L>
      <L>          #.#  # #   # #</L>
      <L>          ###  ###   # #</L>
    </Level>
    <Level Id="20" Width="27" Height="15">
      <L>          #</L>
      <L>         # #</L>
      <L>        #   #</L>
      <L>     #########    ######</L>
      <L>     #.$   .  #   #....#</L>
      <L>     # .$$ $ $ #  #....#</L>
      <L>    ## . $ $ $ .# #...#</L>
      <L>  #### $$$ $  $ .##..#</L>
      <L>  # ##   $ $$$$$$   $.#</L>
      <L>  #  # .$$ $     $$$$$.#</L>
      <L>  #  # ..$ $####   $@. .#</L>
      <L>  #  #   $ .#  #.####.# ###</L>
      <L>###  ######.#  #.#   # #</L>
      <L>          #.#  #.#   # #</L>
      <L>          ###  ###   # #</L>
    </Level>
    <Level Id="21" Width="36" Height="15">
      <L>                        #######</L>
      <L>                        #     #</L>
      <L>                        #     #</L>
      <L>          ############  # $ $ #</L>
      <L>         #           ###   ####</L>
      <L>        #.$ $.$ .$ $.  .$ $#</L>
      <L>       # ..$..$ .$$..$@.$. #</L>
      <L>      # $.$.$.$ .$.$.$ .$.$.#</L>
      <L>      # $.$ ####..$ .$ .$.$. #</L>
      <L>      #  .$$$. #.$  ## .....  #</L>
      <L>######## . $ . #####  ## $$$ $ #</L>
      <L>#       #          #    ##   $  #</L>
      <L>#        ###########      ##     #</L>
      <L>#                           ## ## #</L>
      <L>#                             #  # #</L>
    </Level>
    <Level Id="22" Width="36" Height="15">
      <L>                        #######</L>
      <L>                        #     #</L>
      <L>                        # .$. #</L>
      <L>          ############  # $.$ #</L>
      <L>         #           ###   ####</L>
      <L>        #.$ $.$$.$ $.  .$ $#</L>
      <L>       # ..$..$ .$$..$$+$. #</L>
      <L>      # $.$.$.$ .$.$.$ .$.$.#</L>
      <L>      # $.$ ####..$ .$$.$.$. #</L>
      <L>      #  .$$$. #.$  ## .....  #</L>
      <L>######## . $ . #####  ## $$$ $ #</L>
      <L>#       #          #    ##   $. #</L>
      <L>#        ###########      ##     #</L>
      <L>#                           ## ## #</L>
      <L>#                             #  # #</L>
    </Level>
    <Level Id="23" Width="36" Height="15">
      <L>                        #######</L>
      <L>                        #     #</L>
      <L>                        # .$. #</L>
      <L>          ############  # $.$ #</L>
      <L>         #           ###   ####</L>
      <L>        #.$ $.$$.$ $.$ .$ $#</L>
      <L>       # ..$..$ .$$..$$+$. #</L>
      <L>      # $.$.$.$ .$.$.$ .$.$.#</L>
      <L>      # $.$ ####.*  .$$.$.$. #</L>
      <L>      #  .$$$. #.$  ## .....  #</L>
      <L>######## . $ . #####  ## $$$ $ #</L>
      <L>#       #          #    ##   $. #</L>
      <L>#        ###########      ##     #</L>
      <L>#                           ##.## #</L>
      <L>#                             #  # #</L>
    </Level>
    <Level Id="24" Width="27" Height="12">
      <L>   ######     ####</L>
      <L>   #    #    #    #</L>
      <L>   # . .#   # $  $#</L>
      <L>    #. .#  #  .$$.#</L>
      <L>     #$$# #   $.. #</L>
      <L>    # $ ##    $..$#</L>
      <L>   #       @  . $.######</L>
      <L>  #           $$  #    #</L>
      <L> #    #   #   .$$.#    #</L>
      <L># #### ######$$..$#    ##</L>
      <L>         #  #  .. #     ###</L>
      <L>        ##  #######</L>
    </Level>
    <Level Id="25" Width="27" Height="12">
      <L>   ######     ####</L>
      <L>   #    #    #    #</L>
      <L>   # . .#   # $  $#</L>
      <L>    #. .#  #  .$$.#</L>
      <L>     #$$# #   $.. #</L>
      <L>    # $ ## $  $..$#</L>
      <L>   #       $@ . $.######</L>
      <L>  #        $  $$  #    #</L>
      <L> #. ..#   #   .$$.#    #</L>
      <L># #### ######$$..$#    ##</L>
      <L>         #  #  .. #     ###</L>
      <L>        ##  #######</L>
    </Level>
    <Level Id="26" Width="27" Height="12">
      <L>   ######     ####</L>
      <L>   #    #    #    #</L>
      <L>   # . .#   # $  $#</L>
      <L>    #. .#  #  .$$.#</L>
      <L>     #$$# #   $.. #</L>
      <L>    # $ ## $  $..$#</L>
      <L>   #       $@ . $.######</L>
      <L>  #       $$$ $$  #    #</L>
      <L> #. ..#. .#   .$$.#    #</L>
      <L># #### ######$$..$#    ##</L>
      <L>         #  #  .. #     ###</L>
      <L>        ##  #######</L>
    </Level>
    <Level Id="27" Width="27" Height="12">
      <L>   ######     ####</L>
      <L>   #    #    #    #</L>
      <L>   # . .#   #.$  $#</L>
      <L>    #. .#  #.$.$$.#</L>
      <L>     #$$# # $ $.. #</L>
      <L>    # $ ## $  $..$#</L>
      <L>   #.      $@ . $.######</L>
      <L>  #      $$$$ $$  #    #</L>
      <L> #. ..#. .#   .$$.#    #</L>
      <L># #### ######$$..$#    ##</L>
      <L>         #  #  .. #     ###</L>
      <L>        ##  #######</L>
    </Level>
    <Level Id="28" Width="27" Height="12">
      <L>   ######     ####</L>
      <L>   #    #    #    #</L>
      <L>   # .$.#   #.$  $#</L>
      <L>    #. .#  #.$.$$.#</L>
      <L>     #$$# #.$ $.. #</L>
      <L>    # $ ##.$  $..$#</L>
      <L>   #. $    $@$. $.######</L>
      <L>  # .$. .$$$$ $$  #    #</L>
      <L> #.$..#. .#   .$$.#    #</L>
      <L># #### ######$$..$#    ##</L>
      <L>         #  #  .. #     ###</L>
      <L>        ##  #######</L>
    </Level>
    <Level Id="29" Width="27" Height="12">
      <L>   ######     ####</L>
      <L>   #    #    #   .#</L>
      <L>   # .$.#   #.$  $#</L>
      <L>    #. .#  #.$.$$.#</L>
      <L>     #$$# #.$ $.. #</L>
      <L>    # $ ##.$  $..$#</L>
      <L>   #. $    $@$.$$.######</L>
      <L>  # .$. .$$$$ $$  #    #</L>
      <L> #.$..#. .#   .$$.#    #</L>
      <L># #### ######$$..$#    ##</L>
      <L>         #  #  .. #     ###</L>
      <L>        ##  #######</L>
    </Level>
    <Level Id="30" Width="27" Height="16">
      <L>               #######</L>
      <L>       ###     #   . #</L>
      <L>      #. .#    # .  .#</L>
      <L>     # $  .#   #     #</L>
      <L>    #  $   .#  # . .##</L>
      <L>    #  $    .# ##  #</L>
      <L>    #  $      #..# .#</L>
      <L>    #  # $$$$$      .#   #</L>
      <L>#####  $ #   $       .#  #</L>
      <L>#   # $$$# @ $    ... .# #</L>
      <L>#   # #  #   $  #.##### ###</L>
      <L>#   # $ $$$$$ ###.#      #</L>
      <L>#   #        #  #. ##    #</L>
      <L>#   ##########  ####     #</L>
      <L>#</L>
      <L>### # # # # #</L>
    </Level>
    <Level Id="31" Width="27" Height="11">
      <L>      ##</L>
      <L>     #  #    #####</L>
      <L>    # . .#  #*   *#</L>
      <L>     #. .# # $$ $*#</L>
      <L>      #  ##  $ $ $ #</L>
      <L>     #.   $$ $ @ $ #</L>
      <L>    #.     $ $ . $.#####</L>
      <L> # #.  . .#         #  #</L>
      <L>### ###########. .  #  ####</L>
      <L> #        #   #######</L>
      <L>       ####   #</L>
    </Level>
    <Level Id="32" Width="17" Height="12">
      <L>    #########</L>
      <L>#   #   @   #   #</L>
      <L> # ##.$.$.$.## #</L>
      <L>  #  $ $ $ $  #</L>
      <L>   # .$.$.$. #</L>
      <L> #  # .$.$. #  #</L>
      <L>     #  $  #</L>
      <L> #    #. .#    #</L>
      <L> ####  # #  ####</L>
      <L>        #</L>
      <L>        #</L>
      <L>       ###</L>
    </Level>
    <Level Id="33" Width="21" Height="14">
      <L>  #               #</L>
      <L>   # ########### #</L>
      <L>    #     @     #</L>
      <L>#    # $.$.$.$ #    #</L>
      <L> #    # $.$.$ #    #</L>
      <L>  #   # .$.$. #   #</L>
      <L>       #  $  #</L>
      <L>  # #   #.$.#   #</L>
      <L>  #      #.#      #</L>
      <L>  #       #       #</L>
      <L>  #####       #####</L>
      <L>      #       #</L>
      <L>      #       #</L>
      <L>      #########</L>
    </Level>
  </LevelCollection>
</SokobanLevels>
