<?xml version="1.0" encoding="utf-8"?>
<SokobanLevels xmlns:xsi="http://www.w3.org/2001/XMLSchema-instance" xsi:schemaLocation="SokobanLev.xsd">
  <Title>Park</Title>
  <Description>
Park collection by Zivojin Trifunovic

Side note. Level 2 was the exact copy of Infinity level 1180 or Aerie
level 10 (rotated 180 degrees and horizontally mirrored), and level 3
and 12 the remodels with practically the same solution as originals.
The actual author of these levels has resubmited the collection, with
these plagiat levels removed. Levels 13 to 17 are all remodels from
the collection Atroxija level 11. The author of the original, from
which these remodels were made, has labeled them as rem 1-5 or
remodels.

  </Description>
  <Email>zivojintrifunovic21@gmail.com</Email>
  <LevelCollection Copyright="Zivojin Trifunovic" MaxWidth="13" MaxHeight="14">
    <Level Id="1" Width="9" Height="9">
      <L>#########</L>
      <L>#@. * . #</L>
      <L># $.$.$ #</L>
      <L># .$$$. #</L>
      <L># $.$.$ #</L>
      <L># $.$.$.#</L>
      <L>#.$.$.$ #</L>
      <L>#   .   #</L>
      <L>#########</L>
    </Level>
    <Level Id="4" Width="11" Height="8">
      <L>###########</L>
      <L>#     @  ##</L>
      <L># $#.$$$$ #</L>
      <L># .$.... ##</L>
      <L># $$*$$*$ #</L>
      <L># #.....  #</L>
      <L>#    #*   #</L>
      <L>###########</L>
    </Level>
    <Level Id="5" Width="11" Height="8">
      <L>###########</L>
      <L>#     @   #</L>
      <L>#$$ .$$*$$#</L>
      <L>#..$..... #</L>
      <L># $$*$$*$.#</L>
      <L>#  ..*..$ #</L>
      <L># .$  *   #</L>
      <L>###########</L>
    </Level>
    <Level Id="6" Width="10" Height="10">
      <L>##########</L>
      <L># #      #</L>
      <L>#  ..#$* #</L>
      <L>###. . # #</L>
      <L>#  $ * # #</L>
      <L># $.$@$$ #</L>
      <L>####.$.  #</L>
      <L># #   # ##</L>
      <L>#  #  #  #</L>
      <L>##########</L>
    </Level>
    <Level Id="7" Width="10" Height="10">
      <L>##########</L>
      <L># #      #</L>
      <L># $..#$* #</L>
      <L># #. . # #</L>
      <L># .$ * # #</L>
      <L># $.$@$$ #</L>
      <L>####.$.  #</L>
      <L># #   # ##</L>
      <L>#  #  #  #</L>
      <L>##########</L>
    </Level>
    <Level Id="8" Width="10" Height="10">
      <L>##########</L>
      <L># #      #</L>
      <L># $..#$*.#</L>
      <L># #. . #.#</L>
      <L># .$ * # #</L>
      <L># $.$@$$ #</L>
      <L># ##.$.  #</L>
      <L>#  $  #$##</L>
      <L>#  #     #</L>
      <L>##########</L>
    </Level>
    <Level Id="9" Width="10" Height="10">
      <L>##########</L>
      <L># #      #</L>
      <L># $..#$*.#</L>
      <L># #. ..#.#</L>
      <L># .$ * # #</L>
      <L># $.$@$$ #</L>
      <L># $#.$.  #</L>
      <L>#  $  #$##</L>
      <L>#  #     #</L>
      <L>##########</L>
    </Level>
    <Level Id="10" Width="10" Height="10">
      <L>##########</L>
      <L># #      #</L>
      <L># $..#$*.#</L>
      <L># #.$..#.#</L>
      <L># .$ * # #</L>
      <L># $.$@$$.#</L>
      <L># $#.$.  #</L>
      <L>#  $  #$##</L>
      <L>#  #     #</L>
      <L>##########</L>
    </Level>
    <Level Id="11" Width="10" Height="10">
      <L>##########</L>
      <L># #      #</L>
      <L># $..#$*.#</L>
      <L># #.$..#.#</L>
      <L># .$ * #$#</L>
      <L># $.$@$$.#</L>
      <L># $#.$.  #</L>
      <L># .$  #$##</L>
      <L>#  #     #</L>
      <L>##########</L>
    </Level>
    <Level Id="13 Atroxija 11 rem-1" Width="10" Height="9">
      <L>##########</L>
      <L>#  @ #   #</L>
      <L>#  #   ###</L>
      <L># # $ $ ##</L>
      <L># $.$$   #</L>
      <L># ....$ ##</L>
      <L># *$$*$###</L>
      <L># ....   #</L>
      <L>##########</L>
    </Level>
    <Level Id="14 Atroxija 11 rem-2" Width="10" Height="9">
      <L>##########</L>
      <L>#  @ #   #</L>
      <L>#  #   ###</L>
      <L># # $.$$ #</L>
      <L># $.$$   #</L>
      <L># ....$  #</L>
      <L># *$$*$###</L>
      <L># ....   #</L>
      <L>##########</L>
    </Level>
    <Level Id="15 Atroxija 11 rem-3" Width="10" Height="9">
      <L>##########</L>
      <L>#  @ #   #</L>
      <L>#  #   # #</L>
      <L># # $.$$ #</L>
      <L># $.$$$. #</L>
      <L># .... $ #</L>
      <L># *$$*$###</L>
      <L># ....   #</L>
      <L>##########</L>
    </Level>
    <Level Id="16 Atroxija 11 rem-4" Width="10" Height="9">
      <L>##########</L>
      <L>#  @ #   #</L>
      <L># $#   # #</L>
      <L>#  #$.$$ #</L>
      <L># $.$$$. #</L>
      <L># .... $ #</L>
      <L># *$$*$###</L>
      <L># .... . #</L>
      <L>##########</L>
    </Level>
    <Level Id="17 Atroxija 11 rem-5" Width="10" Height="9">
      <L>##########</L>
      <L>#    . $ #</L>
      <L># $#   #.#</L>
      <L>#  #$.$$ #</L>
      <L># $.$$$.@#</L>
      <L># *...   #</L>
      <L># *$$*$###</L>
      <L># ....$. #</L>
      <L>##########</L>
    </Level>
    <Level Id="18" Width="8" Height="8">
      <L>########</L>
      <L>#@     #</L>
      <L>#$.$.$.#</L>
      <L># $.$. #</L>
      <L># $.$. #</L>
      <L>#.$.$$.#</L>
      <L>#      #</L>
      <L>########</L>
    </Level>
    <Level Id="19" Width="12" Height="11">
      <L>############</L>
      <L>#...#  #   #</L>
      <L>#.*.### $ ##</L>
      <L>#...#    $ #</L>
      <L>#+  $  #$  #</L>
      <L>#  ##      #</L>
      <L>#    $#$$$##</L>
      <L>#  ##      #</L>
      <L>## #   # $##</L>
      <L>#   #  #   #</L>
      <L>############</L>
    </Level>
    <Level Id="20" Width="12" Height="11">
      <L>############</L>
      <L>#...#  #   #</L>
      <L>#.*.### $ ##</L>
      <L>#...#    $ #</L>
      <L>#+. $  #$  #</L>
      <L>#  ##      #</L>
      <L>#    $#$$$##</L>
      <L>#  ##      #</L>
      <L>##  $  # $##</L>
      <L>#   #  #   #</L>
      <L>############</L>
    </Level>
    <Level Id="21" Width="12" Height="11">
      <L>############</L>
      <L>#...#      #</L>
      <L>#.*.# #$$ ##</L>
      <L>#...#    $ #</L>
      <L>#+. $  #$  #</L>
      <L>#. ##      #</L>
      <L>#    $#$$$##</L>
      <L>#  ##      #</L>
      <L>##  $  # $##</L>
      <L>#   #  #   #</L>
      <L>############</L>
    </Level>
    <Level Id="22" Width="12" Height="11">
      <L>############</L>
      <L>#...#      #</L>
      <L>#.*.#$#$$ ##</L>
      <L>#...#    $ #</L>
      <L>#+. $  #$  #</L>
      <L># .##      #</L>
      <L>#    $#$$$##</L>
      <L>#. ##      #</L>
      <L>##  $  # $##</L>
      <L>#   #  #   #</L>
      <L>############</L>
    </Level>
    <Level Id="23" Width="12" Height="11">
      <L>############</L>
      <L>#...#      #</L>
      <L>#.*.#$#$$ ##</L>
      <L>#...#    $ #</L>
      <L>#+. $  #$  #</L>
      <L># .## $    #</L>
      <L>#    $#$$$##</L>
      <L>#. ##      #</L>
      <L>##  $  # $##</L>
      <L># . #  #   #</L>
      <L>############</L>
    </Level>
    <Level Id="24" Width="12" Height="11">
      <L>############</L>
      <L>#...#      #</L>
      <L>#.*.#$#$$ ##</L>
      <L>#...#    $ #</L>
      <L>#+. $  #$$ #</L>
      <L># .## $    #</L>
      <L># ...$#$$$ #</L>
      <L>#. #$      #</L>
      <L>##  $ $  $##</L>
      <L># . # #    #</L>
      <L>############</L>
    </Level>
    <Level Id="25" Width="12" Height="10">
      <L>############</L>
      <L>#  .#   #  #</L>
      <L>#  ##.... ##</L>
      <L>## # . $.  #</L>
      <L>#  # .*.*  #</L>
      <L>## $  $$####</L>
      <L># $$$$$ .  #</L>
      <L>#@  $      #</L>
      <L>#   # # #  #</L>
      <L>############</L>
    </Level>
    <Level Id="26" Width="12" Height="10">
      <L>############</L>
      <L># ..   .   #</L>
      <L>#  ##.*..$##</L>
      <L>##*#.. $.  #</L>
      <L>#  # **.*  #</L>
      <L>#  $  $$####</L>
      <L># $$$#$ .. #</L>
      <L>#@$ $    $ #</L>
      <L>#   #   #  #</L>
      <L>############</L>
    </Level>
    <Level Id="27" Width="12" Height="10">
      <L>############</L>
      <L># ..   .   #</L>
      <L>#  ##.*..$##</L>
      <L># *$.. $.  #</L>
      <L>#$ #.**.*  #</L>
      <L>#  $  $$####</L>
      <L># $$$#$ .. #</L>
      <L>#@$ $ . $$ #</L>
      <L>#.  #   #  #</L>
      <L>############</L>
    </Level>
    <Level Id="28" Width="12" Height="10">
      <L>############</L>
      <L># ..   .   #</L>
      <L>#$ #$.*..$ #</L>
      <L>#.*$.. $.$ #</L>
      <L>#$ #.**.*. #</L>
      <L>#  $  $$####</L>
      <L># $$$#$ .. #</L>
      <L>#@$.$ . $$ #</L>
      <L>#.  #   #  #</L>
      <L>############</L>
    </Level>
    <Level Id="29" Width="10" Height="10">
      <L>##########</L>
      <L># #    # #</L>
      <L># . ..$  #</L>
      <L># $$.*$  #</L>
      <L>#.$.*..$ #</L>
      <L>#$$..*.# #</L>
      <L># .$.$ $ #</L>
      <L># $$+$## #</L>
      <L>#        #</L>
      <L>##########</L>
    </Level>
    <Level Id="30" Width="10" Height="10">
      <L>##########</L>
      <L># #    # #</L>
      <L># . ..$. #</L>
      <L># $$.*$$ #</L>
      <L>#.$.*..$ #</L>
      <L>#$$..*.# #</L>
      <L># .$.$ $ #</L>
      <L># $$+$## #</L>
      <L>#        #</L>
      <L>##########</L>
    </Level>
    <Level Id="31" Width="10" Height="10">
      <L>##########</L>
      <L>#*#    #*#</L>
      <L># $.*..$ #</L>
      <L>#.$ $.$. #</L>
      <L># $.*..$ #</L>
      <L># *.$$$. #</L>
      <L># *$$@$$ #</L>
      <L># . .$..##</L>
      <L>#*#    #*#</L>
      <L>##########</L>
    </Level>
    <Level Id="32" Width="10" Height="10">
      <L>##########</L>
      <L>#*      *#</L>
      <L># $.*..$ #</L>
      <L>#.* $.$. #</L>
      <L># $.*..$ #</L>
      <L># *.$$$. #</L>
      <L># *$$@$$ #</L>
      <L># . .$.* #</L>
      <L>#*      *#</L>
      <L>##########</L>
    </Level>
    <Level Id="33" Width="12" Height="9">
      <L>############</L>
      <L>#@  #.  $ .#</L>
      <L># $.$..*.$ #</L>
      <L>#.$...$$.. #</L>
      <L># $$$$.$.$ #</L>
      <L># ...$...$ #</L>
      <L># .$$*$$$$ #</L>
      <L>#*         #</L>
      <L>############</L>
    </Level>
    <Level Id="34" Width="12" Height="9">
      <L>############</L>
      <L>#@  #.  $ .#</L>
      <L># $.$..*.$ #</L>
      <L>#.$...$$.. #</L>
      <L># $$$$.$.$ #</L>
      <L># ...$...$ #</L>
      <L># .$$*$$$$ #</L>
      <L>#*   #     #</L>
      <L>############</L>
    </Level>
    <Level Id="35" Width="12" Height="9">
      <L>############</L>
      <L>#@  $. $ . #</L>
      <L># $..$...$ #</L>
      <L># $$$.$$$$ #</L>
      <L># .$...$.. #</L>
      <L># .$$..$$. #</L>
      <L># $..$$..$ #</L>
      <L>#          #</L>
      <L>############</L>
    </Level>
    <Level Id="36" Width="12" Height="9">
      <L>############</L>
      <L>#@. $. $ . #</L>
      <L># $..$...$ #</L>
      <L># $$$.$$$$ #</L>
      <L># .$...$.. #</L>
      <L># .$$..$$. #</L>
      <L># $*.$$..$ #</L>
      <L>#    #     #</L>
      <L>############</L>
    </Level>
    <Level Id="37" Width="11" Height="10">
      <L>   #####</L>
      <L> ###   #</L>
      <L>## *  $####</L>
      <L>#    .$   #</L>
      <L>#$*#$##.# #</L>
      <L>#  # @$ $ #</L>
      <L>#.$##.# ###</L>
      <L>#  . .. #</L>
      <L>####   ##</L>
      <L>   #####</L>
    </Level>
    <Level Id="38" Width="11" Height="10">
      <L>   #####</L>
      <L> ###   #</L>
      <L>## *  $####</L>
      <L>#    .$   #</L>
      <L>#$*#$##.# #</L>
      <L>#  # @$ $ #</L>
      <L>#.$##.# $##</L>
      <L>#  . ... #</L>
      <L>####   ###</L>
      <L>   #####</L>
    </Level>
    <Level Id="39" Width="11" Height="10">
      <L>   #####</L>
      <L> ###   #</L>
      <L>## *  $####</L>
      <L>#    .$   #</L>
      <L>#$*#$##.#.#</L>
      <L>#  # @$ $ #</L>
      <L>#.$##.# $$#</L>
      <L>#  . ...  #</L>
      <L>####   ####</L>
      <L>   #####</L>
    </Level>
    <Level Id="40" Width="9" Height="14">
      <L>  #####</L>
      <L>  #   ##</L>
      <L>### #$ #</L>
      <L>#@* .. #</L>
      <L># $$# ###</L>
      <L># # .   #</L>
      <L>#  $# # #</L>
      <L>#  .* * #</L>
      <L>###$# ###</L>
      <L># # $ # #</L>
      <L># . # * #</L>
      <L># $.. * #</L>
      <L>#   #   #</L>
      <L>#########</L>
    </Level>
    <Level Id="41" Width="8" Height="12">
      <L>####</L>
      <L>#. #</L>
      <L>#*@####</L>
      <L>#.* $.#</L>
      <L>#.* * #</L>
      <L>#.* $ #</L>
      <L>#.$ * #</L>
      <L># $ $ ##</L>
      <L># $ .$ #</L>
      <L># $$.. #</L>
      <L>#      #</L>
      <L>########</L>
    </Level>
    <Level Id="42" Width="13" Height="10">
      <L> ############</L>
      <L> #@.$ .$ .$ #</L>
      <L>##  . .$. $ #</L>
      <L># . * *  *. #</L>
      <L># $*$*$*$*$ #</L>
      <L># . * *  *. #</L>
      <L>## .$. $. $ #</L>
      <L> # .$ .$ .$ #</L>
      <L> ###   #    #</L>
      <L> ############</L>
    </Level>
    <Level Id="43" Width="13" Height="10">
      <L> ############</L>
      <L> #@.$ .$ .$ #</L>
      <L>##  . .$. $ #</L>
      <L># . * *  *. #</L>
      <L># $*$*$*$*$ #</L>
      <L># . * *  .. #</L>
      <L>## .$. $.$$ #</L>
      <L> # .$ .$ .$ #</L>
      <L> ### # #    #</L>
      <L> ############</L>
    </Level>
  </LevelCollection>
</SokobanLevels>
