<?xml version="1.0" encoding="utf-8"?>
<SokobanLevels xmlns:xsi="http://www.w3.org/2001/XMLSchema-instance" xsi:schemaLocation="SokobanLev.xsd">
  <Title>Piramida</Title>
  <Description>
Piramida by Zivojin Trifunovic
  </Description>
  <Email>zivojintrifunovic21@gmail.com</Email>
  <LevelCollection Copyright="Zivojin Trifunovic" MaxWidth="24" MaxHeight="18">
    <Level Id="1" Width="21" Height="12">
      <L>        #####</L>
      <L>#   ####     ####   #</L>
      <L> ###  $ $ $ $ $  ###</L>
      <L>  # .$.$.$.$.$.$. #</L>
      <L>   # .$.$.$.$.$. #</L>
      <L>    # .$.$.$.$. #</L>
      <L>     # .$.$.$. #</L>
      <L>      # .$.$. #</L>
      <L>       #  *  #</L>
      <L>        # @ #</L>
      <L>         # #</L>
      <L>          #</L>
    </Level>
    <Level Id="2" Width="21" Height="13">
      <L>          #</L>
      <L>          #</L>
      <L>         #.#</L>
      <L>        #   #</L>
      <L>       # .$. #</L>
      <L>      # .$.$. #</L>
      <L>     #  $.$.$  #</L>
      <L>    # .$.$.$.$. #</L>
      <L>   #  $.$$.$$ $  #</L>
      <L>  # .$.$ .$ .$.$. #</L>
      <L>##   #####@#####   ##</L>
      <L>#                   #</L>
      <L>#####################</L>
    </Level>
    <Level Id="3" Width="23" Height="18">
      <L>           #</L>
      <L>          #.#</L>
      <L>         #.$.#</L>
      <L>        # $.$ #</L>
      <L>       # $. .$ #</L>
      <L>      # $.$.$.$ #</L>
      <L>     #.$.$.$.$.$.#</L>
      <L>    # $ $ $@$ $   #</L>
      <L>   #   . . . .     #</L>
      <L>  # #### #########  #</L>
      <L> #                   #</L>
      <L>#. $$$ .###  ### ##   #</L>
      <L> #  $  #   #   $ $   #</L>
      <L>  #.$.#     # $.$.$ #</L>
      <L>   #.#       #.$.$.#</L>
      <L>    #         #.$.#</L>
      <L>               #.#</L>
      <L>                #</L>
    </Level>
    <Level Id="4" Width="21" Height="15">
      <L>          #</L>
      <L>          #</L>
      <L>          #</L>
      <L>         #.#</L>
      <L>        # . #</L>
      <L>       # . . #</L>
      <L>      # . . . #</L>
      <L>    ##.$.$.$.$.##</L>
      <L>    # .# # # #. #</L>
      <L>   #   $ $ $ $   #</L>
      <L>  # $ $ $ $ $ $ $ #</L>
      <L> # .#.#.#.#.#.#.#. #</L>
      <L>#   $ $ $ $ $ $ $   #</L>
      <L>#         @         #</L>
      <L>#####################</L>
    </Level>
    <Level Id="5" Width="22" Height="11">
      <L>          ##</L>
      <L>         #..#</L>
      <L>        # .$.#</L>
      <L>       # .$. .#</L>
      <L>      # . .$. .#</L>
      <L>     #.$$$$$$$$ #</L>
      <L>    #     $@     #</L>
      <L>   # .$.$ .$ $.$. #</L>
      <L>  # .   $ .$ $   . #</L>
      <L> # ################ #</L>
      <L>#   #             #  #</L>
    </Level>
    <Level Id="6" Width="21" Height="13">
      <L>          #</L>
      <L>         # #</L>
      <L>        # . #</L>
      <L>       # .$. #</L>
      <L>      # .$.$. #</L>
      <L>     # .$.$.$. #</L>
      <L>    # .$.$.$.$. #</L>
      <L>   # .$.$.$.$.$. #</L>
      <L>  # .$.$.$.$.$.$. #</L>
      <L> # .$.$.$.$.$.$.$. #</L>
      <L>#  $ $ $ $@$ $ $ $  #</L>
      <L>#                   #</L>
      <L>#####################</L>
    </Level>
    <Level Id="7" Width="21" Height="13">
      <L>          #</L>
      <L>         # #</L>
      <L>        # . #</L>
      <L>       # .$. #</L>
      <L>      # .$.$. #</L>
      <L>     # .$.$.$. #</L>
      <L>    # .$.$.$.$. #</L>
      <L>   # .$.$.$.$.$. #</L>
      <L>  # .$.$.$.$.$.$. #</L>
      <L> # .$.$.$.$.$.$.$. #</L>
      <L># $$ $ $ $@$ $ $ $. #</L>
      <L>#                   #</L>
      <L>#####################</L>
    </Level>
    <Level Id="8" Width="21" Height="13">
      <L>          #</L>
      <L>         # #</L>
      <L>        # . #</L>
      <L>       # .$. #</L>
      <L>      # .$.$. #</L>
      <L>     # .$.$.$. #</L>
      <L>    # .$.$.$.$. #</L>
      <L>   # .$.$.$.$.$. #</L>
      <L>  # .$.$.$.$.$.$. #</L>
      <L> # .$.$.$.$.$.$.$. #</L>
      <L># $$.$ $ $@$ $ $$$. #</L>
      <L>#                   #</L>
      <L>#####################</L>
    </Level>
    <Level Id="9" Width="21" Height="13">
      <L>          #</L>
      <L>         # #</L>
      <L>        # . #</L>
      <L>       # .$. #</L>
      <L>      # .$.$. #</L>
      <L>     # .$.$.$. #</L>
      <L>    # .$.$.$.$. #</L>
      <L>   # .$.$.$.$.$. #</L>
      <L>  # .$.$.$.$.$.$. #</L>
      <L> # .$.$.$.$.$.$.$. #</L>
      <L># $$.$.$ $$$ $ $$$. #</L>
      <L>#          @        #</L>
      <L>#####################</L>
    </Level>
    <Level Id="10" Width="21" Height="13">
      <L>          #</L>
      <L>         # #</L>
      <L>        # . #</L>
      <L>       # .$. #</L>
      <L>      # .$.$. #</L>
      <L>     # .$.$.$. #</L>
      <L>    # .$.$.$.$. #</L>
      <L>   # .$.$.$.$.$. #</L>
      <L>  # .$.$.$.$.$.$. #</L>
      <L> # .$.$.$.$.$.$.$. #</L>
      <L># $$.$.$$$$$ $.$$$. #</L>
      <L>#          @        #</L>
      <L>#####################</L>
    </Level>
    <Level Id="11" Width="21" Height="13">
      <L>          #</L>
      <L>         #.#</L>
      <L>        # . #</L>
      <L>       # .$. #</L>
      <L>      # .$.$. #</L>
      <L>     # .$.$.$. #</L>
      <L>    # .$.$.$.$. #</L>
      <L>   # .$.$.$.$.$. #</L>
      <L>  # .$.$.$.$.$.$. #</L>
      <L> # .$.$.$.$.$.$.$. #</L>
      <L># $$.$.$$$$$$$.$$$. #</L>
      <L>#          @        #</L>
      <L>#####################</L>
    </Level>
    <Level Id="12" Width="23" Height="18">
      <L>           #</L>
      <L>           #</L>
      <L>       ### # ###</L>
      <L> ##### # # # # # #####</L>
      <L> #   # ### # ### #   #</L>
      <L> # # #     #     # # #</L>
      <L> #   #    #.#    #   #</L>
      <L> #   #   #. .#   #   #</L>
      <L> #####  #.$.$.#  #####</L>
      <L>        # .$. #</L>
      <L>###    # .$.$. #    ###</L>
      <L># #   # .$.$.$. #   # #</L>
      <L>###  # $$.$.$.$  #  ###</L>
      <L>#   # $.$$.$.$.$. #   #</L>
      <L>   # $.$.$.$.$.$.  #</L>
      <L>  # $.$.$.$.$ $@$$  #</L>
      <L> #                   #</L>
      <L># ################### #</L>
    </Level>
    <Level Id="13" Width="23" Height="18">
      <L>           #</L>
      <L>           #</L>
      <L>       ### # ###</L>
      <L> ##### # # # # # #####</L>
      <L> #   # ### # ### #   #</L>
      <L> # # #     #     # # #</L>
      <L> #   #    #.#    #   #</L>
      <L> #   #   #. .#   #   #</L>
      <L> #####  #.$.$.#  #####</L>
      <L>        # .$. #</L>
      <L>###    # .$.$. #    ###</L>
      <L># #   # .$.$.$. #   # #</L>
      <L>###  # $$.$.$.$  #  ###</L>
      <L>#   # $.$$.$.$.$. #   #</L>
      <L>   # $.$.$.$.$.$.  #</L>
      <L>  # $.$.$.$.$.$$$$  #</L>
      <L> #              @    #</L>
      <L># ################### #</L>
    </Level>
    <Level Id="14" Width="23" Height="18">
      <L>           #</L>
      <L>           #</L>
      <L>       ### # ###</L>
      <L> ##### # # # # # #####</L>
      <L> #   # ### # ### #   #</L>
      <L> # # #     #     # # #</L>
      <L> #   #    #.#    #   #</L>
      <L> #   #   #. .#   #   #</L>
      <L> #####  #.$.$.#  #####</L>
      <L>        #$.$. #</L>
      <L>###    # .$.$. #    ###</L>
      <L># #   # .$.$.$. #   # #</L>
      <L>###  # $$.$.$.$  #  ###</L>
      <L>#   # $.$$.$.$.$. #   #</L>
      <L>   # $.$.$.$.$.$.  #</L>
      <L>  # $.$.$.$.$.$$$$. #</L>
      <L> #              @    #</L>
      <L># ################### #</L>
    </Level>
    <Level Id="15" Width="23" Height="18">
      <L>           #</L>
      <L>           #</L>
      <L>       ### # ###</L>
      <L> ##### # # # # # #####</L>
      <L> #   # ### # ### #   #</L>
      <L> # # #     #     # # #</L>
      <L> #   #    #.#    #   #</L>
      <L> #   #   #. .#   #   #</L>
      <L> #####  #.$.$.#  #####</L>
      <L>        #$.$. #</L>
      <L>###    # .$.$. #    ###</L>
      <L># #   # .$.$.$. #   # #</L>
      <L>###  # $$.$.$.$  #  ###</L>
      <L>#   # $.$$.$.$.$. #   #</L>
      <L>   # $.$.$.$.$.$.$ #</L>
      <L>  # $.$.$.$.$.$$$$..#</L>
      <L> #              @    #</L>
      <L># ################### #</L>
    </Level>
    <Level Id="16" Width="23" Height="18">
      <L>           #</L>
      <L>           #</L>
      <L>       ### # ###</L>
      <L> ##### # # # # # #####</L>
      <L> #   # ### # ### #   #</L>
      <L> # # #     #     # # #</L>
      <L> #   #    #.#    #   #</L>
      <L> #   #   #. .#   #   #</L>
      <L> #####  #.$.$.#  #####</L>
      <L>        #$.$.$#</L>
      <L>###    # .$.$. #    ###</L>
      <L># #   # .$.$.$. #   # #</L>
      <L>###  # $$.$.$.$  #  ###</L>
      <L>#   # $.$$.$.$.$. #   #</L>
      <L>   # $.$.$.$.$.$.$ #</L>
      <L>  #.$.$.$.$.$.$$$$..#</L>
      <L> #              @    #</L>
      <L># ################### #</L>
    </Level>
    <Level Id="17" Width="23" Height="18">
      <L>           #</L>
      <L>           #</L>
      <L>       ### # ###</L>
      <L> ##### # # # # # #####</L>
      <L> #   # ### # ### #   #</L>
      <L> # # #     #     # # #</L>
      <L> #   #    #.#    #   #</L>
      <L> #   #   #. .#   #   #</L>
      <L> #####  #.$.$.#  #####</L>
      <L>        #$.$.$#</L>
      <L>###    # .$.$. #    ###</L>
      <L># #   # .$.$.$. #   # #</L>
      <L>###  # $$.$.$.$  #  ###</L>
      <L>#   # $.$$.$.$.$. #   #</L>
      <L>   # $.$.$.$.$.$.$ #</L>
      <L>  #.$.$.$.$+$.$$$$..#</L>
      <L> #.        $         #</L>
      <L># ################### #</L>
    </Level>
    <Level Id="18" Width="19" Height="14">
      <L>         #</L>
      <L>        #@#</L>
      <L>       #   #</L>
      <L>      # $$$ #</L>
      <L> ##### $ $ $ #####</L>
      <L>#     $  $ $ $    #</L>
      <L># ...$...$ .$.$$  #</L>
      <L>#  $.$.$.$.. .  $ #</L>
      <L># $$.$.$.$ . .$.  #</L>
      <L>#  . $. .$ .$.... #</L>
      <L># .$$$.$.$$.$$$.$ #</L>
      <L># ...$...$ .   .  #</L>
      <L>#                 #</L>
      <L>###################</L>
    </Level>
    <Level Id="19" Width="15" Height="16">
      <L>       #</L>
      <L>      # #</L>
      <L>    ## . #</L>
      <L>   ## $.$ #</L>
      <L>  ## $. .$ #</L>
      <L> ## $.$$$.$ #</L>
      <L>## $.......$ ##</L>
      <L># $.$.$$$. .$ #</L>
      <L>#.. $. $ .$$..#</L>
      <L># $.$.$$$.$.$ #</L>
      <L>#  $.......$  #</L>
      <L> #  $.$$$.$  ##</L>
      <L>  #  $.$.$  #</L>
      <L>   #  $.$  ##</L>
      <L>    #  .@ ##</L>
      <L>     ######</L>
    </Level>
    <Level Id="20" Width="24" Height="16">
      <L>       #           #</L>
      <L>      # #         #.#</L>
      <L>    ## . #       #. .#</L>
      <L>   ## $.$ #     #.$.$.#</L>
      <L>  ## $. .$ #   # $ $ $ #</L>
      <L> ## $.$$$.$ # # $.$.$. #</L>
      <L>## $.......$ ## .$.$.$.#</L>
      <L># $.$.$$$. .$ # $.$.$.$#</L>
      <L>#.. $. $ .$$.. . $.$ $ #</L>
      <L># $.$.$$$.$.$ #        #</L>
      <L>#  $.......$  ##########</L>
      <L> #  $.$$$.$  ##</L>
      <L>  #  $.$.$  #</L>
      <L>   #  $.$  ##</L>
      <L>    #  .@ ##</L>
      <L>     ######</L>
    </Level>
    <Level Id="21" Width="24" Height="16">
      <L>       #           #</L>
      <L>      # #         #.#</L>
      <L>    ## . #       #. .#</L>
      <L>   ## $.$ #     #.$.$.#</L>
      <L>  ## $. .$ #   # $ $ $ #</L>
      <L> ## $.$$$.$ # # $.$.$. #</L>
      <L>## $.......$ ## .$.$.$.#</L>
      <L># $.$.$$$. .$ # $.$.$.$#</L>
      <L>#.. $. $ .$$.. .$$.$.$ #</L>
      <L># $.$.$$$.$.$ #        #</L>
      <L>#  $.......$  ##########</L>
      <L> #  $.$$$.$  ##</L>
      <L>  #  $.$.$  #</L>
      <L>   #  $.$  ##</L>
      <L>    #  .@ ##</L>
      <L>     ######</L>
    </Level>
    <Level Id="22" Width="24" Height="16">
      <L>       #           #</L>
      <L>      # #         #.#</L>
      <L>    ## . #       #.@.#</L>
      <L>   ## $.$ #     #.$.$.#</L>
      <L>  ## $. .$ #   # $ $ $ #</L>
      <L> ## $.$$$.$ # # $.$.$. #</L>
      <L>## $.......$ ## .$.$.$.#</L>
      <L># $.$.$$$. .$ # $.$.$.$#</L>
      <L>#.. $. $ .$$.. .$$.$.$ #</L>
      <L># $.$.$$$.$.$ #        #</L>
      <L>#  $.......$  ##########</L>
      <L> #  $.$$$.$  ##</L>
      <L>  #  $.$.$  #</L>
      <L>   #  $.$  ##</L>
      <L>    #  .  ##</L>
      <L>     ######</L>
    </Level>
  </LevelCollection>
</SokobanLevels>
