<?xml version="1.0" encoding="utf-8"?>
<SokobanLevels xmlns:xsi="http://www.w3.org/2001/XMLSchema-instance" xsi:schemaLocation="SokobanLev.xsd">
  <Title>Red Star</Title>
  <Description>
Red Star collection by Milutin Negovanovic.
  </Description>
  <Email>miltutinnegovanovic@gmail.com</Email>
  <LevelCollection Copyright="Milutin Negovanovic" MaxWidth="20" MaxHeight="19">
    <Level Id="1" Width="17" Height="10">
      <L>#################</L>
      <L>###### .# ##..$.#</L>
      <L>### $ $$..  #$# #</L>
      <L>#  ... .##.     #</L>
      <L># $*$* ###. * *$#</L>
      <L>#*#.$. .# # $ $ #</L>
      <L>#   $* #.*  # # #</L>
      <L># $$# $  #$#.$  #</L>
      <L>#     @# $     .#</L>
      <L>#################</L>
    </Level>
    <Level Id="2" Width="16" Height="10">
      <L>################</L>
      <L>## . . . . $  ##</L>
      <L>## #$..* #$$. .#</L>
      <L>#    *#.   #$ ##</L>
      <L># $ $... # $  .#</L>
      <L># #$*# # #$*#  #</L>
      <L># $ $ #       $#</L>
      <L>#     $$ #$#$ .#</L>
      <L>##.# # .##@.$ .#</L>
      <L>################</L>
    </Level>
    <Level Id="3" Width="18" Height="13">
      <L>##################</L>
      <L>###*...# ##.  ..##</L>
      <L>##*.$ $..##.#.#. #</L>
      <L>#  $ $ $$.# * $$ #</L>
      <L>##$ $ $ $.#.# #..#</L>
      <L>#  $ $ $ $  $ $$ #</L>
      <L>#*. # * #  $#$#..#</L>
      <L>#  $ $ $.$  $ $$ #</L>
      <L>#*$ $ $ $.#+# #..#</L>
      <L># .$ *$$ .# * $$ #</L>
      <L>##*.$ $..##.#.#  #</L>
      <L>## *... ###.  ...#</L>
      <L>##################</L>
    </Level>
    <Level Id="4" Width="15" Height="14">
      <L>###############</L>
      <L>#. . . . . . .#</L>
      <L>#.@#$*$ $*$# .#</L>
      <L>#.#   # #   #.#</L>
      <L># $ *$ *  *$  #</L>
      <L>#$#  #  $# #$$#</L>
      <L>#... . * . ...#</L>
      <L>######   ######</L>
      <L># . . # # ..$ #</L>
      <L># $.$ #   $$$ #</L>
      <L># $$$   $  $. #</L>
      <L># $.$ $ #.$$$ #</L>
      <L>#     ###  .  #</L>
      <L>###############</L>
    </Level>
    <Level Id="6" Width="12" Height="9">
      <L>############</L>
      <L>#@#.     ###</L>
      <L>#.*   $ $ ##</L>
      <L># *#$.$#. ##</L>
      <L>#.*. $ $$ ##</L>
      <L># *#$.$#. ##</L>
      <L>#.*  $ $ .##</L>
      <L># #.     ###</L>
      <L>############</L>
    </Level>
    <Level Id="7" Width="17" Height="19">
      <L>#################</L>
      <L>###. #.#.#.#..###</L>
      <L>##.. . . .$. $.##</L>
      <L>##.$ $ $ $ $ $.##</L>
      <L>##$#$#$#$#$#$#$##</L>
      <L>##             ##</L>
      <L>## $ $ $ $ $ $@##</L>
      <L>##.# # # # # # ##</L>
      <L>## $ $ $ $ $ * ##</L>
      <L>##* * * * * * *##</L>
      <L>## * * * * * * ##</L>
      <L>##* * * * * * *##</L>
      <L>## * * * * * * ##</L>
      <L>##*.*.*.$.*.*.*##</L>
      <L>## * * * * * * ##</L>
      <L>##* * * * * * *##</L>
      <L>## . . . . * . ##</L>
      <L>#################</L>
      <L>#################</L>
    </Level>
    <Level Id="8" Width="20" Height="16">
      <L>###  ## ## ## ##  ##</L>
      <L>####################</L>
      <L>### #         #. ###</L>
      <L>##. $ $ #$#$#   $.##</L>
      <L>##.# .# $ $  # $# ##</L>
      <L>## $.#        # ..##</L>
      <L>##$ # $ **** $ #.###</L>
      <L>## *  $ *..* $   .##</L>
      <L>##    $ *.+*   $* ##</L>
      <L>### # $ **** $ #  ##</L>
      <L>##.  # #    # #...##</L>
      <L>## #$ # $ $  * $# ##</L>
      <L>##..$   * #$*   ..##</L>
      <L>### .#        #. ###</L>
      <L>####################</L>
      <L>###  ## ## ## ##  ##</L>
    </Level>
    <Level Id="9" Width="14" Height="12">
      <L># # # # # # #</L>
      <L> #*#*#*#*#*# #</L>
      <L># # #  * * *#</L>
      <L> #**  $$ # # #</L>
      <L># #* $... **#</L>
      <L> #*  #.#$  # #</L>
      <L># #   .. #**#</L>
      <L> #*# $ $ * # #</L>
      <L># #  *  *@ *#</L>
      <L> #* * * * *# #</L>
      <L># #*#*#*#*# #</L>
      <L> # # # # # # #</L>
    </Level>
    <Level Id="10" Width="14" Height="13">
      <L># # # # # # #</L>
      <L> #*#*#*#*#*#*#</L>
      <L>#*#@ * * * *#</L>
      <L> #*$...    #*#</L>
      <L>#*.*.#.$$#**#</L>
      <L> #* $.#    #*#</L>
      <L>#*#..# $   *#</L>
      <L> #     $# *#*#</L>
      <L>#* $*#$ $ #*#</L>
      <L> #   *   #*#*#</L>
      <L>#*#*#*#*#*#*#</L>
      <L> #*#*#*#*#*#*#</L>
      <L># # # # # # #</L>
    </Level>
    <Level Id="11" Width="15" Height="10">
      <L>###############</L>
      <L>#  ..# *      #</L>
      <L>#  #$#   #$$ *#</L>
      <L>##   $ #* $ $ #</L>
      <L>#* #$#  * #*  #</L>
      <L>##   .    * $ #</L>
      <L>#*$# #*.# .$  #</L>
      <L>## $.# *.*.#$*#</L>
      <L># .#.#...   $@#</L>
      <L>###############</L>
    </Level>
    <Level Id="12" Width="17" Height="11">
      <L># # # # # # # # #</L>
      <L> #*#*#*#*#*#*#*#</L>
      <L>#*#@  #*#*#   #*#</L>
      <L> #  #  #    #  #</L>
      <L>#* *$* . * *$* *#</L>
      <L> # . . # * .$. #</L>
      <L>#* *$* *#* *$* *#</L>
      <L> #  #  #*#  #  #</L>
      <L>#*#   #*#*#   #*#</L>
      <L> #*#*#*#*#*#*#*#</L>
      <L># # # # # # # # #</L>
    </Level>
    <Level Id="13" Width="13" Height="11">
      <L> #######</L>
      <L> ##.#.#*#</L>
      <L> #.$$. # #</L>
      <L>## @ $ .. #</L>
      <L>#  #. #$#  #</L>
      <L># $$$ *.*   #</L>
      <L>#  #..#.# #.#</L>
      <L>#$$$$$   $$ #</L>
      <L>#  $   # $ .#</L>
      <L>#.#.#.#*#*###</L>
      <L>#############</L>
    </Level>
    <Level Id="14" Width="11" Height="11">
      <L>###########</L>
      <L>#+  #  . ##</L>
      <L>#$  $ $#  #</L>
      <L>#. #.#. $ #</L>
      <L>#$ ****#  #</L>
      <L>#. #. .  ##</L>
      <L>#$  #$# #.#</L>
      <L>#.      $.#</L>
      <L>#$ #$ $#$ #</L>
      <L>#. $   .$.#</L>
      <L>###########</L>
    </Level>
    <Level Id="15" Width="9" Height="9">
      <L>#########</L>
      <L>#.$.# @ #</L>
      <L>#   $ # #</L>
      <L>#.$ #.*$#</L>
      <L>##$ *.$.#</L>
      <L>#   *.$ #</L>
      <L>#$$ # #.#</L>
      <L>#.#     #</L>
      <L>#########</L>
    </Level>
    <Level Id="16" Width="12" Height="13">
      <L>    # # # #</L>
      <L>   #.#.#.#*#</L>
      <L>  #  $  $ #</L>
      <L> #.# #$#.#*#</L>
      <L># $$ . *. #</L>
      <L>#$@* $# $ .#</L>
      <L>#...    $$#</L>
      <L># $$#*# $ .#</L>
      <L>#   *  $*.#</L>
      <L>##### $ .$.#</L>
      <L>     #  $ #</L>
      <L>     #.#.#</L>
      <L>      # #</L>
    </Level>
    <Level Id="17" Width="13" Height="9">
      <L>#############</L>
      <L>#+$  #  #  .#</L>
      <L>#   *$$ $ #.#</L>
      <L># # .$.   * #</L>
      <L># .#** #.$# #</L>
      <L>#   .$. # * #</L>
      <L># $ **$   # #</L>
      <L># #  #  #   #</L>
      <L>#############</L>
    </Level>
    <Level Id="18" Width="9" Height="9">
      <L>#########</L>
      <L>#@  #  ##</L>
      <L>#  $*$  #</L>
      <L>#  . . ##</L>
      <L># #.$ # #</L>
      <L>## .$.  #</L>
      <L>#   *$  #</L>
      <L>##  #   #</L>
      <L>#########</L>
    </Level>
    <Level Id="19" Width="13" Height="8">
      <L>   ########</L>
      <L>  #        #</L>
      <L> #.$.#.$$.$ #</L>
      <L>#  * ## .$. #</L>
      <L># *$* # $+$ #</L>
      <L>#  *  # .$. #</L>
      <L> #    #    #</L>
      <L>  #### ####</L>
    </Level>
    <Level Id="20" Width="9" Height="9">
      <L>#########</L>
      <L>#@#     #</L>
      <L>#   $##.#</L>
      <L>#$#$$ #.#</L>
      <L># #    .#</L>
      <L># #  ## #</L>
      <L>#  ## $.#</L>
      <L>#.      #</L>
      <L>#########</L>
    </Level>
    <Level Id="21" Width="11" Height="11">
      <L>     #</L>
      <L>    # #</L>
      <L>   # . #</L>
      <L>  #.$ $.#</L>
      <L> # $ * $ #</L>
      <L># . *@* . #</L>
      <L> # $ * $ #</L>
      <L>  #.$ $.#</L>
      <L>   # . #</L>
      <L>    # #</L>
      <L>     #</L>
    </Level>
    <Level Id="22" Width="9" Height="12">
      <L>#########</L>
      <L>#########</L>
      <L>##.#   ##</L>
      <L>## $@$ ##</L>
      <L>##  *. ##</L>
      <L>###$*.$##</L>
      <L>### .. ##</L>
      <L>##.# *  #</L>
      <L>##$#$#  #</L>
      <L>##     ##</L>
      <L>#########</L>
      <L>#########</L>
    </Level>
  </LevelCollection>
</SokobanLevels>
