<?xml version="1.0" encoding="utf-8"?>
<SokobanLevels xmlns:xsi="http://www.w3.org/2001/XMLSchema-instance" xsi:schemaLocation="SokobanLev.xsd">
  <Title>Remodeling</Title>
  <Description>
Remodel set by many authors, Level 1 - Li Jin You and M Dzekic (MD),
Level 2 - Li Jin You and MD, Level 3 - Li Jin You and MD, Level 4 -
Francois Marques and Jgw and MD, Level 5 - Francois Marques and Jgw
and MD, Level 6 - Francois Marques and York Shen and Jgw and MD, Level
7 - Big Panda and MD, Level 8 - Big Panda and MD, Level 9 - Big Panda
and MD, Level 10 - Big Panda and MD, Level 11 - Big Panda and MD,
Level 12 - Big Panda and MD, Level 13 - Big Panda and MD, Level 14 -
Big Panda and MD, Level 15 - Zhenying and MD, Level 16 - Gyjgw and
Stopheart and MD, Level 17 - Unknown and MD, Level 18 - Unknown and
MD, Level 19 - Unknown and MD, Level 20 - Unknown and MD, Level 21 -
Unknown and MD, Level 22 - Sven Egevad and MD, Level 23 - David W
Skinner and York Shen and LZY and Gyjgw and MD, Level 24 - David W
Skinner and York Shen and MD, Level 25 - Jgw and MD, Level 26 - Jgw
and MD, Level 27 - Dries de Clercq and MD
  </Description>
  <Email>marko.dzekic@windowslive.com</Email>
  <LevelCollection Copyright="Marko Dzekic" MaxWidth="45" MaxHeight="37">
    <Level Id="Li Jin You re-1" Width="10" Height="15">
      <L>##########</L>
      <L>####  ####</L>
      <L>#    $ . #</L>
      <L>#   .#.$ #</L>
      <L>#*#$. #@##</L>
      <L># #    $##</L>
      <L>#  ###  ##</L>
      <L>#   $.# ##</L>
      <L>#  ###  ##</L>
      <L># # $ $$##</L>
      <L>#*#   # ##</L>
      <L># ..*#.  #</L>
      <L>#    $ . #</L>
      <L>####  ####</L>
      <L>##########</L>
    </Level>
    <Level Id="Li Jin You re-2" Width="11" Height="15">
      <L> ##########</L>
      <L> ####  ####</L>
      <L> #    $ . #</L>
      <L> # ..*#.  #</L>
      <L> #*#   # ##</L>
      <L>## # $ $$##</L>
      <L>#  #*##   #</L>
      <L>#  . $.**@#</L>
      <L>#  #*##   #</L>
      <L>## # $ $$##</L>
      <L> #*#   # ##</L>
      <L> # ..$#.  #</L>
      <L> #    $ . #</L>
      <L> ####  ####</L>
      <L> ##########</L>
    </Level>
    <Level Id="Li Jin You re-3" Width="11" Height="15">
      <L> ##########</L>
      <L> ####  ####</L>
      <L> #    $ . #</L>
      <L> # ..*#.  #</L>
      <L> #*#   # ##</L>
      <L>## # $ $$##</L>
      <L>#   #*#   #</L>
      <L>#   .$.*#@#</L>
      <L>#   #*#   #</L>
      <L>## # $ $$##</L>
      <L> #*#   # ##</L>
      <L> # ..$#.  #</L>
      <L> #    $ . #</L>
      <L> ####  ####</L>
      <L> ##########</L>
    </Level>
    <Level Id="The Square re-1" Width="15" Height="13">
      <L> ####</L>
      <L> #  ##########</L>
      <L> #$ $ $ $ $  #</L>
      <L> # ......... #</L>
      <L>##$.$#$#$#$*$##</L>
      <L>#  . . @ . .  #</L>
      <L># $*$#$#$#$*$ #</L>
      <L>#  . . * . .  #</L>
      <L>##$*$#$#$#$.$##</L>
      <L> # ......... #</L>
      <L> #$ $ $ $ $  #</L>
      <L> #  ##########</L>
      <L> ####</L>
    </Level>
    <Level Id="The Square re-2" Width="15" Height="13">
      <L> ####</L>
      <L> #  ##########</L>
      <L> #$ $ $ $ $  #</L>
      <L> # ......... #</L>
      <L>##$.$#$#$#$*$##</L>
      <L>#  . . @ . .  #</L>
      <L># $*$#$$$#$*$ #</L>
      <L>#  .       .###</L>
      <L>##$*$#####$. #</L>
      <L> # ......... #</L>
      <L> #$ $ $ $ $  #</L>
      <L> #  ##########</L>
      <L> ####</L>
    </Level>
    <Level Id="The Square re-3" Width="15" Height="13">
      <L> ####</L>
      <L> #  ##########</L>
      <L> #$ $ $ $ $  #</L>
      <L> # ......... #</L>
      <L>##$.$#$#$#$*$##</L>
      <L>#  . . . . .  #</L>
      <L># $*$#$@$#$*$ #</L>
      <L>#  . . * . .  #</L>
      <L>##$*$#$#$#$.$##</L>
      <L> # ......... #</L>
      <L> #$ $ $ $ $ $#</L>
      <L> #  #######  #</L>
      <L> ####     ####</L>
    </Level>
    <Level Id="Submarine re-1" Width="26" Height="23">
      <L> ####</L>
      <L> #  ##</L>
      <L>##   ##  ###############</L>
      <L>#  $  #  #.            #</L>
      <L>#  $  #  #** .######## #</L>
      <L>###$$ ####...#.*.....# #</L>
      <L>  #    #  .* #  ###### #</L>
      <L>  ###.**$.#.## *#..### ###</L>
      <L>#####$ . *..*.*.#$   $   #</L>
      <L>#    *.#.* $    $  # ##  #</L>
      <L>#   #* ..$.######### ## ##</L>
      <L>### #.$**.###.  ###  ## #</L>
      <L> ##$ ##.### $$$ ##  ### #</L>
      <L> #   ## ###.$@$.        #</L>
      <L> # $ ##     $$$ #$#$##  #</L>
      <L> # $###  ##  .  # # #####</L>
      <L> #  # ########### # ####</L>
      <L> # $#                  #</L>
      <L>##  # $ $ $ $ $ $    $ #</L>
      <L>#  $#################  #</L>
      <L>#   #               ####</L>
      <L>#  ##</L>
      <L>####</L>
    </Level>
    <Level Id="Submarine re-2" Width="26" Height="23">
      <L> ####</L>
      <L> #  ##</L>
      <L>##   ##  ###############</L>
      <L>#  $  #  #.            #</L>
      <L>#  $  #  #.* .######## #</L>
      <L>###$$ ####.*.#.*.....# #</L>
      <L>  #    #  .*##  ###### #</L>
      <L>  ###.**$.#.   *#..### ###</L>
      <L>#####$ . *..*.*.#$   $   #</L>
      <L>#    *.#.* $    $  # ##  #</L>
      <L>#   #* ..$.######### ## ##</L>
      <L>### #.$**.###.  ###  ## #</L>
      <L> ##$ ##.### $$$ ##  ### #</L>
      <L> #   ## ###.$@$.        #</L>
      <L> # $ ##     $$$ #$#$##  #</L>
      <L> # $###  ##  .  # # #####</L>
      <L> #  # ########### # ####</L>
      <L> # $#                  #</L>
      <L>##  # $ $ $ $ $ $    $ #</L>
      <L>#  $#################  #</L>
      <L>#   #               ####</L>
      <L>#  ##</L>
      <L>####</L>
    </Level>
    <Level Id="Submarine re-3" Width="27" Height="23">
      <L>  ####</L>
      <L>  #  ##</L>
      <L> ##   ##  ###############</L>
      <L> #  $  #  #.            #</L>
      <L> # $ $ # ##..$.######## #</L>
      <L> ###$  ### ***#.*....## #</L>
      <L>   #   #  $..##..###### #</L>
      <L>######..*$.#.##.*#  ### ###</L>
      <L>#  ###$...*..*.*.#*   $   #</L>
      <L># $   *.#.* $   $   # ##  #</L>
      <L>#    #*...$ ######### ## ##</L>
      <L>#### #.$**.##    # #  ## #</L>
      <L>  ##$ ## ### $$$ ### ### #</L>
      <L>  #   ## ### $@$ #     $ #</L>
      <L>  # $ ##     $$$   # #   #</L>
      <L>  # $###  ##  .  #$#$#####</L>
      <L>  #  # ########### # ####</L>
      <L>  # $#       #          #</L>
      <L> ##  #       # $ $    $ #</L>
      <L> #  $#       #########  #</L>
      <L> #   #               ####</L>
      <L> #  ##</L>
      <L> ####</L>
    </Level>
    <Level Id="Big Submarine re-1" Width="31" Height="23">
      <L>  ####</L>
      <L>  #  ##</L>
      <L> ##   ##  ###############</L>
      <L> #  $  #  #.            #</L>
      <L> # $ $ # ##..$.######## #</L>
      <L> ###$  ### ***#.*....#  #######</L>
      <L>   #   #  $..##..######   #   #</L>
      <L>######..*$.#.##.*#   #  $  $  #</L>
      <L>#  # #$...*..*.*.#$    # # # ##</L>
      <L># $   *.#.* $   $...# ## ##   #</L>
      <L>#    #*...$ #######.#$  $  $  #</L>
      <L>####.#.$**.##     #.# #  ## ###</L>
      <L>  ##$ ## ### $$$ #### ## ##  #</L>
      <L>  # . #  # # $@$ #      $    #</L>
      <L>  # $  #     $$$   #   #  ####</L>
      <L>  # $###  ##  .  #$#$#  ###</L>
      <L>  #  # # # ####### # ####</L>
      <L>  # $# # $ $ #          #</L>
      <L> ##  # #     # $ $    $ #</L>
      <L> #  $# ###############  #</L>
      <L> #   #               ####</L>
      <L> #  ##</L>
      <L> ####</L>
    </Level>
    <Level Id="Big Submarine re-2" Width="31" Height="23">
      <L>  ####</L>
      <L>  #  ##</L>
      <L> ##   ##  ###############</L>
      <L> #  $  #  #.            #</L>
      <L> # $ $ # ##..$.########.#</L>
      <L> ###$  ### ***#.*.......#######</L>
      <L>   #   #  $..##..######.  #   #</L>
      <L>######..*$.#.##.*#   #  $  $  #</L>
      <L>#  ###$...*..*.*.#$    # ### ##</L>
      <L># $   *.#.* $   $...# ## ##   #</L>
      <L>#    #*...$ #######.#$  $  $  #</L>
      <L>####.#.$**.##    ##.# #  ## ###</L>
      <L>  ##$ ## ### $$$ #### ## ##  #</L>
      <L>  # . ## ### $@$ #      $    #</L>
      <L>  # $ ##     $$$   #   #  ####</L>
      <L>  # $###  ##  .  #$#$######</L>
      <L>  #  # # ######### # ####</L>
      <L>  # $# # $ $ #          #</L>
      <L> ##  # # $ $ # $ $    $ #</L>
      <L> #  $# # $ $ #########  #</L>
      <L> #   # #  $  #       ####</L>
      <L> #  ## ##   ##</L>
      <L> ####   #####</L>
    </Level>
    <Level Id="Big Submarine re-3" Width="35" Height="27">
      <L> #####</L>
      <L> #   #</L>
      <L> #$  ##</L>
      <L>## $  ##  ###############</L>
      <L>#   $  #  #.            #</L>
      <L>#  $ $ # ##.* .#### ###.#</L>
      <L>####$  ### **##.*.. ....##########</L>
      <L>   #   #  $..##..## ###.  #   #  #</L>
      <L>######..*$.#.##.*#...#. $  $   $ #</L>
      <L>#  ###$...*..*.*.#*... # ### ##  #</L>
      <L># $   *.#.*.*...*.  #.## ##   #$ #</L>
      <L>#    #* ..*.######..#*  $  $  #  #</L>
      <L>####.#.$**.##    #..#.#  ## ### ###</L>
      <L>  ##$ ##.### $$$ ####.## ##  ##   #</L>
      <L>  # . ## ### $@$ #   .  $    # $  #</L>
      <L>  # $ ##     $$$   #   #  #### # ##</L>
      <L>  # $###  ##  .  #$#$# # ##      #</L>
      <L>  #  # # ######$## # ########## ##</L>
      <L>  # $# # $ $ #  #                #</L>
      <L> ##  # # $ $   ##      $  $ $ $  #</L>
      <L> #  $# # $ $ #################   #</L>
      <L> #   # # $ $               # #####</L>
      <L> #  ## # $ $ $ $ $ $ $ $ $ #</L>
      <L> ####  # $ $ ###############</L>
      <L>       #  $  #</L>
      <L>       ##   ##</L>
      <L>        #####</L>
    </Level>
    <Level Id="Big Submarine re-X" Width="35" Height="27">
      <L> #####</L>
      <L> #   #</L>
      <L> #$  ##</L>
      <L>## $  ##  ###############</L>
      <L>#   $  #  #.            #</L>
      <L>#  $ $ # ##.* .#### ###.#</L>
      <L>####$  ### **##.*.. ....##########</L>
      <L>   #   #  $..##..## ###.  #   #  #</L>
      <L>######..*$.#.##.*#...#. $  $   $ #</L>
      <L>#  ###$...*..*.*.#*... # ### ##  #</L>
      <L># $   *.#.*.*...*.  #.## ##   #$ #</L>
      <L>#    #* ..*.######..#*  $  $  #  #</L>
      <L>####.#.$**.##     ..#.#  ## ### ###</L>
      <L>  ##$ ##.### $$$ ####.## ##  ##   #</L>
      <L>  # . ## ### $@$ #   .  $    # $  #</L>
      <L>  # $ ##     $$$ # #   #  #### # ##</L>
      <L>  # $###  ##  .  #$#$# # #####   #</L>
      <L>  #  # # ######$## # ########## ##</L>
      <L>  # $# # $ $ ##                  #</L>
      <L> ##  # # $ $ ####      $  $ $ $  #</L>
      <L> #  $# # $ $ #################   #</L>
      <L> #   # # $ $               # #####</L>
      <L> #  ## # $ $ $ $ $ $ $ $ $ #</L>
      <L> ####  # $ $ ###############</L>
      <L>       #  $  #</L>
      <L>       ##   ##</L>
      <L>        #####</L>
    </Level>
    <Level Id="Big Submarine re-Y" Width="35" Height="27">
      <L> #####</L>
      <L> #   #</L>
      <L> #$  ##</L>
      <L>##    ##  ###############</L>
      <L># $$   #  #.            #</L>
      <L>#   $  # ##.* .#### ###.#</L>
      <L>####$$ ### **##.*.. ....##########</L>
      <L>   #   #  $..##..## ###.  #   #  #</L>
      <L>######..*$.#.##.*#...#. $  $   $ #</L>
      <L>#  ###$...*..*.*.#*... # ### ##  #</L>
      <L># $   *.#.*.....*.  #.## ##   #$ #</L>
      <L>#  . #* ..*.######*.#*. *  $  #  #</L>
      <L>####.#.$**.#     ...#.#  ## ### ###</L>
      <L>  ##$ ##.### $$$ ####.## ##  ##   #</L>
      <L>  #   ##.### $@$ #   .  $    # $  #</L>
      <L>  # $ ##   $ $$$ # #   #  #### # ##</L>
      <L>  # $###  ##     #$#$# # #####   #</L>
      <L>  #  # # #####$### # ########## ##</L>
      <L>  # $# #   $ #                   #</L>
      <L> ##  # # $ $ ####   $   $ $ $ $  #</L>
      <L> #  $# # $ $ #################   #</L>
      <L> #   # # $$       $    #     #####</L>
      <L> #  ## # $  $ $ #  $$  #</L>
      <L> ####  # $ $ ####$$  $ #</L>
      <L>       # $ $ #  #   #$##</L>
      <L>       #    ##  ##    #</L>
      <L>       ######    ######</L>
    </Level>
    <Level Id="Hanghang re" Width="33" Height="21">
      <L> ####</L>
      <L>##..#                         ###</L>
      <L>#.**###########################.#</L>
      <L>#.$                           # #</L>
      <L>#.$ ************************* # #</L>
      <L>### *                       * # #</L>
      <L>  # * ********************* * * #</L>
      <L>  # * *                   * * # #</L>
      <L>  # * * ***************** * * * #</L>
      <L>  # * * *       .       * * * # #</L>
      <L>  # * * * $$$$$#@#$$$$$ * * * * #</L>
      <L>  # * * *       .       * * * * #</L>
      <L>  # * * ***************** * * * #</L>
      <L>  # * *                   * * # #</L>
      <L>  # * ********************* * # #</L>
      <L>### *                       * # #</L>
      <L>#.$ ************************* * #</L>
      <L>#.$                           * #</L>
      <L>#.**#####################*#****.#</L>
      <L>##..                            #</L>
      <L> ################################</L>
    </Level>
    <Level Id="Gyjgw re" Width="25" Height="21">
      <L>    ####################</L>
      <L>#####            #     #</L>
      <L>#   $ # # # *$* $# # # ##</L>
      <L># $$ $ # # # * * #  * * #</L>
      <L># *.*.*.#.#.*.#.*# # *  #</L>
      <L># .# * $ $ $ $ $  .#* # #</L>
      <L>#  #   ##.*.*.*.*# * *$ #</L>
      <L>## ####   $  $ $ #  * # #</L>
      <L> # $@ *.###$*### ##* *  #</L>
      <L> # $ ##.*.*.*.*.$.# * # #</L>
      <L> # $ # .#.*.......#  *  #</L>
      <L> # # ##.#.*#*####.#** # #</L>
      <L> # # #..*.*.*...... * # #</L>
      <L> # # ##.*.....#.* #  *  #</L>
      <L> # #*########### ########</L>
      <L> #.  #             $ $  #</L>
      <L> # #.# $$$$$$$$$$$      #</L>
      <L> #* ##$           #$#$###</L>
      <L> #  $ $$$$$$$$$$$ $ $ $ #</L>
      <L> #                      #</L>
      <L> ########################</L>
    </Level>
    <Level Id="Confused" Width="33" Height="25">
      <L>#################################</L>
      <L>#.*.#.#.#.#.#.#.#.#.#.#.#.#.#.*.#</L>
      <L>## $ $.$ $ * $ $.$ $ * $ $.$ $ ##</L>
      <L>#.$ $ # $ $.$ $ * $ $.$ $ * $ $.#</L>
      <L>## $ $.$ $ * $ $.$ $ * $ $.$ $ ##</L>
      <L>#.$ $ # $ $.$ $ * $ $.$ $ # $ $.#</L>
      <L>## *.*.#.*.*.*.*.*.*.*.*.*.*.* ##</L>
      <L>#.* $ * $ $.$ $ * $ $.$ $ * $ *.#</L>
      <L>##.* $.$ $ * $ $.$ $ * $ $.$ *.##</L>
      <L>#.*.* * $ $.$ $ * $ $.$ $ * *.*.#</L>
      <L>## *.*.*.*.*.*.*.*.*.*.*.*.*.* ##</L>
      <L>#.$ *.* $ $.$ $ * $ $.$ $ *.* $.#</L>
      <L>## $ *.* $ * $ $@$ $ * $ *.* $ ##</L>
      <L>#.$ $ *.* $.$ $ * $ $.$ *.* $ $.#</L>
      <L>##.*.*.*.*.*.*.*.*.*.*.*.*.*.*.##</L>
      <L>#.$ $ * *.*.$ $ * $ $.*.* * $ $.#</L>
      <L>## $ $.$ *.* $ $.$ $ *.* $.$ $ ##</L>
      <L>#.$ $ * $ *.* $ * $ *.* $ * $ $.#</L>
      <L>##.*.*.#.*.*.*.*.*.*.*.*.*.*.*.##</L>
      <L>#.$ $ # $ $.*.* * *.*.$ $ # $ $.#</L>
      <L>## $ $.$ $ * *.*.*.* * $ $.$ $ ##</L>
      <L>#.$ $ * $ $.$ *.*.* $.$ $ * $ $.#</L>
      <L>## $ $.$ $ * $ *.* $ * $ $.$ $ ##</L>
      <L>#.*.#.#.#.#.#.#.#.#.#.#.#.#.#.*.#</L>
      <L>#################################</L>
    </Level>
    <Level Id="31" Width="25" Height="20">
      <L>#########################</L>
      <L>#@                      #</L>
      <L># * * * * * * * * * * # #</L>
      <L># *###### # *.* #### *  #</L>
      <L>#  #    # #* ###   #* # #</L>
      <L># * * # ##  *  * * # *  #</L>
      <L>#  * *  #  * * # # #* * #</L>
      <L># *$*  #  * * * *  # *  #</L>
      <L>#  *  #  * * # * # #* * #</L>
      <L># ***##.* * * * *  # *  #</L>
      <L>#  *  #  * * $ * * #* * #</L>
      <L># * *  #  * ### *  # *  #</L>
      <L>#  * *  #  * # * # #$ * #</L>
      <L># *$* *  #  * * *  # *  #</L>
      <L>#  # # # ##. * * #### * #</L>
      <L># *#     #  * * .# * #  #</L>
      <L>#  ######  * * *#  * *  #</L>
      <L># * * * * * * * * * * * #</L>
      <L>#           #           #</L>
      <L>#########################</L>
    </Level>
    <Level Id="Garden" Width="33" Height="20">
      <L>#################</L>
      <L>#  #  ##    ##  ####</L>
      <L># *$ *   * $   *   #</L>
      <L>#  #  **#   ****** #  ########</L>
      <L>## #*     *      * ####   #  ###</L>
      <L>#  #    * * * *  *@*   *#  . * #</L>
      <L># *$ #** * * * *  ### * #* *   #</L>
      <L>#  # #  * * * * * *   *    *** #</L>
      <L>## # # * * * * * * * **** * * ##</L>
      <L> # #    * * * * * * *     * *  #</L>
      <L>## #* ** * * * * * * *****     #</L>
      <L>#   *   * * * * * * *    *# ## #</L>
      <L>#   *#*  * * *.* * * * *  ## # #</L>
      <L>##*#  * $  #    # #    *#* #   #</L>
      <L>#  # # *    # *# ##*## *     * #</L>
      <L># *# # ######**     *  ##### * #</L>
      <L># *    *       **** *.*# # #*# #</L>
      <L># ## ### ######  *  *    # # # ##</L>
      <L>#        #    #  *    *  # #   .#</L>
      <L>##########    ############ ######</L>
    </Level>
    <Level Id="Around" Width="32" Height="20">
      <L>################################</L>
      <L>#              @               #</L>
      <L>#  *.*.*.*.*.*.*.*.*.*.*.*.*.$ #</L>
      <L># #$$$$$$$$$$$$$$$$$$$$$$$#.$* #</L>
      <L># $.......................$.$  #</L>
      <L># #.#$$$$$$$$$$$$$$$$$$$#.$.$* #</L>
      <L># $.$...................$.$.$  #</L>
      <L># #.$.#$$$$$$$$$$$$$$$#.$.$.$* #</L>
      <L># $.$.$...............$.$.$.$  #</L>
      <L># #.$.$.#$$$$$$$$$$$$$#.$.$.$* #</L>
      <L># $.$.$.$...............$.$.$  #</L>
      <L># #.$.$.#$$$$$$$$$$$$$$$#.$.$* #</L>
      <L># $.$.$...................$.$  #</L>
      <L># #.$.#$$$$$$$$$$$$$$$$$$$#.$* #</L>
      <L># $.$.......................$  #</L>
      <L># #.#$$$$$$$$$$$$$$$$$$$$$$$#* #</L>
      <L># $........................... #</L>
      <L># #$$$$#$$*$$#$$#$$#$$#$$#$$$# #</L>
      <L>#                              #</L>
      <L>################################</L>
    </Level>
    <Level Id="Turtle" Width="23" Height="24">
      <L>#######################</L>
      <L>#                     #</L>
      <L># ## #$##* $  #* * ** #</L>
      <L># #   * * *  #  * * * #</L>
      <L># # #   ##  ## * # *  #</L>
      <L>#  # # #   ##  # # ** #</L>
      <L># *  *** ##  * *  #   #</L>
      <L>#  * # ## * * * *  #* #</L>
      <L># * #  #   *   * * *  #</L>
      <L>#* # * # .*###*#  *#* #</L>
      <L># * *  ### # .  #* .  #</L>
      <L># * *  #    * # # *#* #</L>
      <L># **  ## # # * *#$ .  #</L>
      <L># *  ## * *# ## # *#* #</L>
      <L>#   #    * # #  #* .  #</L>
      <L># *#  *#*  # # #   #* #</L>
      <L>#   ** # * * * * *$#  #</L>
      <L># # #  #* * * * * * * #</L>
      <L># #   #  * * * *  **  #</L>
      <L>#  ###  * * * *  *  * #</L>
      <L># $ #  * * * * ## **  #</L>
      <L># * * * # # * * # # # #</L>
      <L>#                    @#</L>
      <L>#######################</L>
    </Level>
    <Level Id="SE 1584 re" Width="19" Height="17">
      <L>###################</L>
      <L>#  #          #   #</L>
      <L>#    # $.#. #  *  #</L>
      <L># *##  # # * ### ##</L>
      <L>## #  * * * *  #  #</L>
      <L>#  # * * * * *  # #</L>
      <L># # * * * # * *   #</L>
      <L># $* * * *## # ## #</L>
      <L># . * * *#* * * # #</L>
      <L># ## * ##* * * *  #</L>
      <L># # * * # * * * * #</L>
      <L># #  * * * * * * *#</L>
      <L>#  #  * * * *  *  #</L>
      <L>## ### * # *  * * #</L>
      <L>#  *  # ## $ * * *#</L>
      <L>#   #      @ #* * #</L>
      <L>###################</L>
    </Level>
    <Level Id="Sasquatch III re" Width="27" Height="19">
      <L>     #################</L>
      <L> #####   #   #   #   #####</L>
      <L> #    * $ * * * * * $    #</L>
      <L> # $*# # # # # # # # # $$#</L>
      <L> #  * * * * * * * * * *  #</L>
      <L>## # # # # # # # # # # # ##</L>
      <L># $ * * .*. ...$.*. * * $ #</L>
      <L>#  # #.######.######.# #  #</L>
      <L># * * .#     $     #. * * #</L>
      <L>## # #* $$$$.+.$$$$ *# # ##</L>
      <L># * * .#     $     #. * * #</L>
      <L>#  * #.######*######.# #  #</L>
      <L># $ * * .*. .*. .*. * * $ #</L>
      <L>## # # # # # # # # # # # ##</L>
      <L> #  * * * * * * * * * *  #</L>
      <L> #$$ # # # # # # # # #*$ #</L>
      <L> #    $ * * * * * $ *    #</L>
      <L> #####   #   #   #   #####</L>
      <L>     #################</L>
    </Level>
    <Level Id="Sasquatch VII re" Width="37" Height="37">
      <L>              #### ####</L>
      <L>             ##  ###  ##</L>
      <L>             #  * $ *  #</L>
      <L>           ### * $#$ * ###</L>
      <L>          ##  . * $ * .  #</L>
      <L>         ##  * * * * * # ###</L>
      <L>        ##  * * . # . * *  ##</L>
      <L>        #  * $ *  #  * $ #  #</L>
      <L>      ### * $#$ *   # $#$ * ###</L>
      <L>      #  . * $ *  #  * $ * .  ##</L>
      <L>    ### * . * * . * . * * . *  ##</L>
      <L>   ##  * * . *#. * * . # . * *  ##</L>
      <L>   #  # $ * * *#* * *  #  * $ *  #</L>
      <L> ### # $#$ *#*#* *#* ##### $#$ * ###</L>
      <L>##  . * $ *  #  * $ *  #  * $ * .  ##</L>
      <L>#  # * * * . # . * * . # . * * * *  #</L>
      <L># * * . * . * * . # . * * . * . * * #</L>
      <L>## $ *     * * * * * * # *     * $ ##</L>
      <L> #$#$ *# #* ##$ * @ * $## *# #* $#$#</L>
      <L>## $ *     * # * # # # # *     * $ ##</L>
      <L># * * . * . * * . * . * * . * . * * #</L>
      <L>#  * * * * . # . * * . # . * * * #  #</L>
      <L>##  . * $ *  *#*# $ *  #  * $ * .  ##</L>
      <L> ### # $#$ #* * * ** ##### $#$ * ###</L>
      <L>   #  * $ *  *#*#*# *  #  * $ *  #</L>
      <L>   ##  * * . # . * * . # . * # ###</L>
      <L>    ##  * . * * . * . * * . *  #</L>
      <L>     ##  . * $ *  #  * $ * .  ##</L>
      <L>      ### * $#$ *   * $#$ # ###</L>
      <L>        #  * $ *  #  * $ *  #</L>
      <L>        ##  # * . * . * *  ##</L>
      <L>         ##  * * * * * * ###</L>
      <L>          ##  . * $ * .  #</L>
      <L>           ### * $#$ # ###</L>
      <L>             #  * $ *  #</L>
      <L>             ##  ###  ##</L>
      <L>              #### ####</L>
    </Level>
    <Level Id="Jgw re-1" Width="28" Height="28">
      <L>############################</L>
      <L>#                          #</L>
      <L># #*****##*##..****##*##*# #</L>
      <L># #    *    *..#    #    * #</L>
      <L># # $$ *  $ *..# $$ #  $ * #</L>
      <L># #  $ *$$$ *. #  $ #$$$ * #</L>
      <L># *  $ *    *$ #  $ #    * #</L>
      <L># ###*#.**#*. $.*#**.***** #</L>
      <L># #    * $  #$ *    * $  # #</L>
      <L># * $$$* $  #..* $$$* $  # #</L>
      <L># # $  * $$ #..* $  * $$ # #</L>
      <L># *    *    #..*    *    # #</L>
      <L># #*###.*****..*####.****# #</L>
      <L># ...  $ .....+....$ $.... #</L>
      <L># ....$ $.......... $  ... #</L>
      <L># *##*#.*****..*####.****# #</L>
      <L># #    *    #..*    *    # #</L>
      <L># # $  * $$ #..* $  # $$ # #</L>
      <L># * $$$* $  #..* $$$# $  # #</L>
      <L># *    # $  # $*    * $  # #</L>
      <L># #****.****.$ .****.***** #</L>
      <L># *  $ #    * $#  $ *    * #</L>
      <L># #  $ #$$$ *. #  $ *$$$ * #</L>
      <L># # $$ *  $ #..# $$ *  $ * #</L>
      <L># *    *    *..#    #    * #</L>
      <L># #*###*###*#..****##*###* #</L>
      <L>#                          #</L>
      <L>############################</L>
    </Level>
    <Level Id="Jgw re-2" Width="33" Height="30">
      <L>#################################</L>
      <L>#                            #  #</L>
      <L># #$* *$* *$* *$* *$* *$* *  $ .#</L>
      <L>#  * * * * * * * * * * * * * #$.#</L>
      <L># # * * * * * * * * * * * *$ # .#</L>
      <L># $* * * * * * * * * * * * * # .#</L>
      <L># # * * * * * * * * * * * *  # .#</L>
      <L>#  * * * * * * * * * * * * * # .#</L>
      <L># # * * * * * * * * * * * *$ # .#</L>
      <L># $* * * * * * * * * * * * * # .#</L>
      <L># # * * * * * * * * * * * *  # .#</L>
      <L>#  * * * * * * * * * * * # # # .#</L>
      <L># # * * * * * * * * * * * *$ # .#</L>
      <L># $* * * * * * * * * * * # # # .#</L>
      <L># # * * * * * *@* * * * * *  # .#</L>
      <L>#  * * * * * * # * * # # # # # .#</L>
      <L># # * * * * * * * * * * * *$ # .#</L>
      <L># $* * * * * * * # * # # # # # .#</L>
      <L># # * * * * * * * * * * * *  # .#</L>
      <L>#  * * * * * * # * * # # # # # .#</L>
      <L># # * * * * * * * * * * * *$ # .#</L>
      <L># $* * * * * * * * # # # # # # .#</L>
      <L># # * * * * * * * * * * * *  # .#</L>
      <L>#  * * * * * * * # # # # # # # .#</L>
      <L># # * * * * * * * * * * * *$ # .#</L>
      <L># $* * # * * * # # # # # # # # .#</L>
      <L># # * * * * * * * * * * * *  # .#</L>
      <L>#  * #$# #$# #$# #$# #$# #$# # .#</L>
      <L>#                            #  #</L>
      <L>#################################</L>
    </Level>
    <Level Id="Orimaze6x4 re" Width="45" Height="27">
      <L>    #####################################</L>
      <L>    #     *   *   *     *   *   *       #</L>
      <L>  ###  *.*.  *.*  .**  *.  *.*  .*.*.** ###</L>
      <L>  #     $ $ * $ * $     $ * $ * $ $ $     #</L>
      <L>### ## ############## ################ ## ###</L>
      <L>#   # $ . * * * *   *   *   * * * * *   #   #</L>
      <L>#    .# #$  #    *# ## ## #*    #   # #*    #</L>
      <L># * #     #######           #######     # * #</L>
      <L>#*.*#$# #*    #  .# # # # #   #    *# #*#$.*#</L>
      <L>#   # .   * * * * $ * * * * * * * *     #   #</L>
      <L>#  $#* # *##$#$##* # ##### *##$#$##* # *#*  #</L>
      <L># * #  #  #  . .#  # $ ..#  #  . .#  #  # * #</L>
      <L>#*.$#* ##*$ #$# $* # * ####*  #$# $* ##*#$.*#</L>
      <L># * #  #  #. ...#  # $ $ #  #. ...#  #  # * #</L>
      <L>#  *#*## *$ #$. $*##  $*.# *$ #$# $*## *#*  #</L>
      <L>#   #  #  #. . .#  #  # .#  #. . .#  #  #   #</L>
      <L>#*.$#* # *##$#$##* ##### # *##$#$##* # *#$.*#</L>
      <L># * # * $ * * * * . * * * * * * * *     # * #</L>
      <L># .$# # #.    #  $# # # # #   #    *# # #$. #</L>
      <L># * #     #######           #######  @  # * #</L>
      <L># *  *# #   #     # ## ## #     #   # #   * #</L>
      <L>#   #   * * * * * * *   * * * * * * * * #   #</L>
      <L>### ## ################ ############## ## ###</L>
      <L>  #     $ $ $ * $ * $     $ * $ * $ $     #</L>
      <L>  ### **.*.*.  *.*  .*  **.  *.*  .*.** ###</L>
      <L>    #       *   *   *     *   *   *     #</L>
      <L>    #####################################</L>
    </Level>
  </LevelCollection>
</SokobanLevels>
