<?xml version="1.0" encoding="utf-8"?>
<SokobanLevels xmlns:xsi="http://www.w3.org/2001/XMLSchema-instance" xsi:schemaLocation="SokobanLev.xsd">
  <Title>Revenge Collection 02</Title>
  <Description>
The second part of the Revenge-Collection is a mixture of easy and
medium levels. But how difficult they are for you ? That is what you
must decide for yourself. But don't worry if you get stuck - they are
all solvable and not that hard that it would take hours to find a
solution. Have fun and keep thinking like a Sokoban. ;-)
  </Description>
  <Email>mhof1@freenet.de</Email>
  <LevelCollection Copyright="Marcus Hof" MaxWidth="31" MaxHeight="17">
    <Level Id="1" Width="9" Height="13">
      <L> ###</L>
      <L> #@#</L>
      <L>##$###</L>
      <L>#    #</L>
      <L>#  # #</L>
      <L>#  $ #</L>
      <L># $$##</L>
      <L>##$  ##</L>
      <L>## # .###</L>
      <L>#   #.. #</L>
      <L>#   $.. #</L>
      <L>###  .  #</L>
      <L>  #######</L>
    </Level>
    <Level Id="2" Width="10" Height="13">
      <L>######</L>
      <L>#    #</L>
      <L># $# #</L>
      <L># $  #</L>
      <L>#   ##</L>
      <L>#  ####</L>
      <L>##$#  ####</L>
      <L>#  $.*.  #</L>
      <L>#    .*  #</L>
      <L>###  #..##</L>
      <L>  #####$#</L>
      <L>      #@#</L>
      <L>      ###</L>
    </Level>
    <Level Id="3" Width="8" Height="8">
      <L>########</L>
      <L>#..    #</L>
      <L># $ $  #</L>
      <L>####$ .#</L>
      <L>  # *  #</L>
      <L>  #  $##</L>
      <L>  #. @#</L>
      <L>  #####</L>
    </Level>
    <Level Id="4" Width="8" Height="8">
      <L>########</L>
      <L>#+*  . #</L>
      <L># $ $  #</L>
      <L>####$ .#</L>
      <L> #. .  #</L>
      <L> # $$ ##</L>
      <L> # *  #</L>
      <L> ######</L>
    </Level>
    <Level Id="5" Width="12" Height="9">
      <L>#####</L>
      <L> #   #######</L>
      <L> #    $  $+#</L>
      <L> #.$ #    ##</L>
      <L>###$##### #</L>
      <L>#. * #    #</L>
      <L>##.  $*####</L>
      <L> #####.#</L>
      <L>     ###</L>
    </Level>
    <Level Id="6" Width="11" Height="9">
      <L>#####</L>
      <L>#   #######</L>
      <L># $ $ $ $ #</L>
      <L>##.  .$@$ #</L>
      <L>### ##### #</L>
      <L>#. . #    #</L>
      <L>##    .####</L>
      <L> #####.#</L>
      <L>     ###</L>
    </Level>
    <Level Id="7" Width="10" Height="8">
      <L>#######</L>
      <L>#.   .#</L>
      <L>## # #####</L>
      <L> #.    $@#</L>
      <L> # #$## ##</L>
      <L> #  $ # #</L>
      <L> ###    #</L>
      <L>   ######</L>
    </Level>
    <Level Id="8" Width="11" Height="9">
      <L>###########</L>
      <L>#+*.      #</L>
      <L>## ###$$  #</L>
      <L> # $  ..###</L>
      <L> #### $ $ #</L>
      <L>    ##$.  #</L>
      <L>     #  ###</L>
      <L>     ##.#</L>
      <L>      ###</L>
    </Level>
    <Level Id="9" Width="10" Height="10">
      <L> ########</L>
      <L>##   ##.##</L>
      <L>#  #  ...#</L>
      <L># ### .  #</L>
      <L># ###$$  #</L>
      <L># $@$   ##</L>
      <L>#### $###</L>
      <L>   #   #</L>
      <L>   #   #</L>
      <L>   #####</L>
    </Level>
    <Level Id="10" Width="8" Height="8">
      <L>######</L>
      <L>#.##.#</L>
      <L>#. # #</L>
      <L># $# ###</L>
      <L>#$$    #</L>
      <L>#@$$*$ #</L>
      <L>##  ...#</L>
      <L> #######</L>
    </Level>
    <Level Id="11" Width="8" Height="7">
      <L>######</L>
      <L>#  #@#</L>
      <L>#  *$###</L>
      <L># $$ . #</L>
      <L>#. .$$ #</L>
      <L>## ..  #</L>
      <L> #######</L>
    </Level>
    <Level Id="12" Width="8" Height="8">
      <L>###</L>
      <L>#+#####</L>
      <L>#$##  ##</L>
      <L># $. . #</L>
      <L># $$$* #</L>
      <L>#.     #</L>
      <L>#.$.*  #</L>
      <L>########</L>
    </Level>
    <Level Id="13" Width="8" Height="11">
      <L> #####</L>
      <L> #   ###</L>
      <L> #$#  .#</L>
      <L> #@# ..#</L>
      <L> #$  ..#</L>
      <L>##   * #</L>
      <L>#   # ##</L>
      <L># $#  #</L>
      <L># $ $ #</L>
      <L>###   #</L>
      <L>  #####</L>
    </Level>
    <Level Id="14" Width="8" Height="7">
      <L> #######</L>
      <L> #. .. #</L>
      <L> # $# .#</L>
      <L>##$  $ #</L>
      <L># $$$..#</L>
      <L>#@$  . #</L>
      <L>########</L>
    </Level>
    <Level Id="15" Width="9" Height="8">
      <L>  #######</L>
      <L>  #..$ .#</L>
      <L>###.$$.##</L>
      <L>#.$$ . .#</L>
      <L>#. $$####</L>
      <L>#$    $@#</L>
      <L>#   #####</L>
      <L>#####</L>
    </Level>
    <Level Id="16" Width="8" Height="6">
      <L> ### ###</L>
      <L>##.###@#</L>
      <L>#.   $*#</L>
      <L>#.$$$$ #</L>
      <L>#.    .#</L>
      <L>########</L>
    </Level>
    <Level Id="17" Width="8" Height="6">
      <L>########</L>
      <L># . .$ #</L>
      <L>#. $ *.#</L>
      <L>#$  $$ #</L>
      <L>#.#  $+#</L>
      <L>########</L>
    </Level>
    <Level Id="18" Width="7" Height="7">
      <L> ######</L>
      <L>##. *@#</L>
      <L>#.#$ ##</L>
      <L># $ $ #</L>
      <L>#*$ . #</L>
      <L>#.   ##</L>
      <L>######</L>
    </Level>
    <Level Id="19" Width="7" Height="7">
      <L> ######</L>
      <L>##. . #</L>
      <L>#.#$ .#</L>
      <L># $  $#</L>
      <L>#*$$$ #</L>
      <L>#+$ ..#</L>
      <L>#######</L>
    </Level>
    <Level Id="20" Width="8" Height="9">
      <L>  ####</L>
      <L> ##  ##</L>
      <L> #@$  #</L>
      <L>##$*$ ##</L>
      <L>#..*.$ #</L>
      <L>## $*. #</L>
      <L># $ .. #</L>
      <L>#    ###</L>
      <L>######</L>
    </Level>
    <Level Id="21" Width="9" Height="9">
      <L>   ####</L>
      <L>  ##  ##</L>
      <L>  # $  #</L>
      <L>### .$ ##</L>
      <L>#..**.$ #</L>
      <L>### $** #</L>
      <L> # $ .*@#</L>
      <L> #    ###</L>
      <L> ######</L>
    </Level>
    <Level Id="22" Width="11" Height="9">
      <L>###########</L>
      <L>#     ..$@#</L>
      <L>#  $$$.$###</L>
      <L>##$ # ...#</L>
      <L> #   *.###</L>
      <L>### #  #</L>
      <L># $ ####</L>
      <L>#   #</L>
      <L>#####</L>
    </Level>
    <Level Id="23" Width="8" Height="8">
      <L> #####</L>
      <L>##   ###</L>
      <L># $$   #</L>
      <L>#  .$  #</L>
      <L>## .*.##</L>
      <L> # * *#</L>
      <L> ## $+#</L>
      <L>  #####</L>
    </Level>
    <Level Id="24" Width="8" Height="9">
      <L>  ###</L>
      <L> ##@##</L>
      <L>## $ ###</L>
      <L># $ $$ #</L>
      <L>#  $   #</L>
      <L>##$....#</L>
      <L> #.*$.##</L>
      <L> ##  .#</L>
      <L>  #####</L>
    </Level>
    <Level Id="25" Width="9" Height="10">
      <L> #####</L>
      <L>##   ###</L>
      <L># $  $@#</L>
      <L>#  $$$$#</L>
      <L>##$..*.#</L>
      <L> #..$*.##</L>
      <L> ##. *. #</L>
      <L>  ####  #</L>
      <L>     #  #</L>
      <L>     ####</L>
    </Level>
    <Level Id="26" Width="9" Height="10">
      <L> #####</L>
      <L>##   ###</L>
      <L>#   $  #</L>
      <L># $$  $#</L>
      <L>##@.*..#</L>
      <L> #**$.###</L>
      <L> #   .. #</L>
      <L> #####$ #</L>
      <L>     #  #</L>
      <L>     ####</L>
    </Level>
    <Level Id="27" Width="13" Height="6">
      <L>   ##########</L>
      <L>   #...     #</L>
      <L>#### **$ #  #</L>
      <L>#   $..$$#$##</L>
      <L>#   ###   @#</L>
      <L>##### ######</L>
    </Level>
    <Level Id="28" Width="13" Height="8">
      <L>    ###</L>
      <L>  ###.#</L>
      <L>  #  *#######</L>
      <L>  # ...   $@#</L>
      <L>#### *$$$#  #</L>
      <L>#   $..$ #$##</L>
      <L>#   # .    #</L>
      <L>############</L>
    </Level>
    <Level Id="29" Width="13" Height="6">
      <L>  ###########</L>
      <L>###..*..  $@#</L>
      <L>#  #  .$$#  #</L>
      <L># $#$#.$ #$##</L>
      <L>#     .    #</L>
      <L>############</L>
    </Level>
    <Level Id="30" Width="9" Height="12">
      <L>  ###</L>
      <L>  #@#</L>
      <L>###$#</L>
      <L>#   ##</L>
      <L># $  #</L>
      <L>##  $####</L>
      <L> # $.$  #</L>
      <L> ## .*. #</L>
      <L>  # $.. #</L>
      <L>  ###.# #</L>
      <L>    #   #</L>
      <L>    #####</L>
    </Level>
    <Level Id="31" Width="10" Height="8">
      <L> ######</L>
      <L> # $ .##</L>
      <L>## .*..#</L>
      <L># $.*$$###</L>
      <L>#   .  $@#</L>
      <L>###  $####</L>
      <L>  ##  #</L>
      <L>   ####</L>
    </Level>
    <Level Id="32" Width="13" Height="9">
      <L>     ######</L>
      <L>######    ###</L>
      <L># @$    $$$ #</L>
      <L>#   ##  *.. #</L>
      <L>########...##</L>
      <L>       #.$##</L>
      <L>       # $ #</L>
      <L>       #   #</L>
      <L>       #####</L>
    </Level>
    <Level Id="33" Width="13" Height="13">
      <L>  #####</L>
      <L> ##   # #####</L>
      <L> #  # ###   #</L>
      <L> #$#@$.     #</L>
      <L>## ##### ####</L>
      <L>#  ####  #</L>
      <L>#$.##.$ ##</L>
      <L>#  ######</L>
      <L>#. ####</L>
      <L># $  .#</L>
      <L>##$  ##</L>
      <L> #.###</L>
      <L> ###</L>
    </Level>
    <Level Id="34" Width="13" Height="13">
      <L>  ######</L>
      <L> ##@$ .######</L>
      <L> #.$# ###   #</L>
      <L> # .$.$     #</L>
      <L>## ##########</L>
      <L>#  #</L>
      <L>#$.#</L>
      <L>#  #</L>
      <L>#. ###</L>
      <L># $  #</L>
      <L>## $ ###</L>
      <L> #.$  .#</L>
      <L> #######</L>
    </Level>
    <Level Id="35" Width="13" Height="13">
      <L>#####</L>
      <L>#   #</L>
      <L># # #</L>
      <L># # #####</L>
      <L>#   #   #</L>
      <L>##$ $   #</L>
      <L> #  ##$###</L>
      <L> ## #   .#</L>
      <L> ##$#  ######</L>
      <L> # .## .$@#.#</L>
      <L> # #    ###$#</L>
      <L> # .       .#</L>
      <L> ############</L>
    </Level>
    <Level Id="36" Width="12" Height="12">
      <L>    ###</L>
      <L>    #@#</L>
      <L> ####$##</L>
      <L> # . . #</L>
      <L> # $  .#</L>
      <L> #  # ##</L>
      <L> # ## #</L>
      <L>## ## ######</L>
      <L># .##$     #</L>
      <L># # $  ### #</L>
      <L># *      $.#</L>
      <L>############</L>
    </Level>
    <Level Id="37" Width="10" Height="14">
      <L>    #####</L>
      <L>    #   #</L>
      <L> ####   #</L>
      <L>##@##$ $#</L>
      <L># $$    #</L>
      <L>#  $ #  #</L>
      <L>#  #### #</L>
      <L>#### ## #</L>
      <L>     #  ##</L>
      <L>   ###$..#</L>
      <L>   # ..*.#</L>
      <L>   #  $..#</L>
      <L>   ####  #</L>
      <L>      ####</L>
    </Level>
    <Level Id="38" Width="11" Height="12">
      <L>  ######</L>
      <L>###..  #</L>
      <L>#   .  #</L>
      <L># # ..#####</L>
      <L>#  ##     #</L>
      <L># $##  #$ #</L>
      <L>#     $ $ #</L>
      <L>#######  ##</L>
      <L>      #  #</L>
      <L>      ##$#</L>
      <L>       #@#</L>
      <L>       ###</L>
    </Level>
    <Level Id="39" Width="11" Height="10">
      <L>########</L>
      <L>#      ###</L>
      <L>#   .  #@#</L>
      <L># # .###$##</L>
      <L>#  ... $  #</L>
      <L>#  .#$ #  #</L>
      <L># $  $ $ ##</L>
      <L>#######  #</L>
      <L>      #  #</L>
      <L>      ####</L>
    </Level>
    <Level Id="40" Width="11" Height="11">
      <L>   ###</L>
      <L>  ##.###</L>
      <L>###..  ###</L>
      <L>#   .  #@#</L>
      <L># # ..##$##</L>
      <L>#  ##  $  #</L>
      <L># $##  #  #</L>
      <L># $     $ #</L>
      <L>####### $##</L>
      <L>      #  #</L>
      <L>      ####</L>
    </Level>
    <Level Id="41" Width="11" Height="11">
      <L>      ###</L>
      <L>      #@#</L>
      <L> ###  #$#</L>
      <L> #.## # ###</L>
      <L>##*.###   #</L>
      <L># $.$ # # #</L>
      <L># $.    $ #</L>
      <L># .. ######</L>
      <L># $###</L>
      <L>#  #</L>
      <L>####</L>
    </Level>
    <Level Id="42" Width="11" Height="8">
      <L> #####</L>
      <L>##...##</L>
      <L>#  .*.####</L>
      <L>#   $*#  #</L>
      <L>## #  $$ ##</L>
      <L> #  $   $@#</L>
      <L> ####  ####</L>
      <L>    ####</L>
    </Level>
    <Level Id="43" Width="12" Height="7">
      <L> ##########</L>
      <L> #      #@#</L>
      <L>##$$$ $ #$##</L>
      <L>#.*.**. #  #</L>
      <L>##.* .     #</L>
      <L> ##.$ ######</L>
      <L>  #####</L>
    </Level>
    <Level Id="44" Width="21" Height="11">
      <L>        #############</L>
      <L>        #          ##</L>
      <L>    #####  $ $#$ $###</L>
      <L>#####..## #$ $ $    #</L>
      <L>#.....  #  $$   $$# #</L>
      <L>#........  # $#$  # #</L>
      <L>##... .## $$     $$ #</L>
      <L>#########  ###@ $  ##</L>
      <L>        ##   $  #   #</L>
      <L>         #    #######</L>
      <L>          ##########</L>
    </Level>
    <Level Id="45" Width="17" Height="12">
      <L>          #####</L>
      <L>       #####  ##</L>
      <L>       #    $  ##</L>
      <L>     ### ##$ $  #</L>
      <L>########  $ $ $ #</L>
      <L>#   .. #  $ # $ #</L>
      <L># ..... $$  # # #</L>
      <L># .... #   $#$  #</L>
      <L>#  ..  # #    $ #</L>
      <L>### #### ## #####</L>
      <L>  ######  @ #####</L>
      <L>       ######</L>
    </Level>
    <Level Id="46" Width="16" Height="11">
      <L>############</L>
      <L>#     ###  #</L>
      <L># .#... $  #####</L>
      <L># .*.*# #* #   #</L>
      <L>#     # . $    #</L>
      <L>####### ########</L>
      <L>#     # #</L>
      <L># $ $ $ #</L>
      <L># $#$ # #</L>
      <L>#     @ #</L>
      <L>#########</L>
    </Level>
    <Level Id="47" Width="13" Height="14">
      <L>#############</L>
      <L>#    ###   ##</L>
      <L>#  $    $$ ##</L>
      <L># $ $ #$$  @#</L>
      <L>#     #    ##</L>
      <L>#####$#######</L>
      <L>#      # .. #</L>
      <L>#  $   # .. #</L>
      <L>## $$$$$  * #</L>
      <L>#      #  $ #</L>
      <L>########..*.#</L>
      <L>########....#</L>
      <L>########....#</L>
      <L>#############</L>
    </Level>
    <Level Id="48" Width="24" Height="11">
      <L>   ############    #####</L>
      <L>   #  #    #  #    # . #</L>
      <L>   #  .*.$.#.$#    # * #</L>
      <L>   #  #  $ #. #    # . #</L>
      <L>  ###@## $    ###### $ #</L>
      <L>### $$ # $ $$$ .  $  $ #</L>
      <L># ... .#  . .  .#  . $ #</L>
      <L># .$$$ #################</L>
      <L># # #  #</L>
      <L>#   ####</L>
      <L>#####</L>
    </Level>
    <Level Id="49" Width="14" Height="11">
      <L>       ######</L>
      <L>       #    #</L>
      <L>       #$$$ #</L>
      <L>########    ##</L>
      <L>#.. $@  $$ $.#</L>
      <L>####  #. . ..#</L>
      <L>#..$  ###  ###</L>
      <L>###$$## $ * #</L>
      <L>#.$  ## #$  #</L>
      <L>#   ...    ##</L>
      <L>#############</L>
    </Level>
    <Level Id="50" Width="15" Height="11">
      <L>##############</L>
      <L>#####. .     #</L>
      <L>######@$ $*# #</L>
      <L>########## #.#</L>
      <L>#          # #</L>
      <L># $.$.$.$.*# #</L>
      <L># ########## #</L>
      <L># # .        #</L>
      <L># $$ ###### $##</L>
      <L># .  #    # $.#</L>
      <L>######    #####</L>
    </Level>
    <Level Id="51" Width="19" Height="11">
      <L>#######</L>
      <L>#.    #</L>
      <L>##  $ #####</L>
      <L>## $$ #   #</L>
      <L>##$# ##$$ #</L>
      <L>#....  $  #</L>
      <L>######## #######</L>
      <L>#@    .#  ###  #</L>
      <L>#*$$.  $      .####</L>
      <L>#.  .## $.#*   $ .#</L>
      <L>###################</L>
    </Level>
    <Level Id="52" Width="17" Height="12">
      <L> #######</L>
      <L>##     #</L>
      <L>#  *## #########</L>
      <L># #   *   #    #</L>
      <L># * + # $ #.#. #</L>
      <L># *   #   # # $#</L>
      <L>#  ##### ## #  ##</L>
      <L>####  #     # $ #</L>
      <L>      # $ $ #   #</L>
      <L>      # $ #####.#</L>
      <L>      #    .*.# #</L>
      <L>      ###########</L>
    </Level>
    <Level Id="53" Width="10" Height="9">
      <L>     #####</L>
      <L>#######.##</L>
      <L>#.$  ##$##</L>
      <L>#.$ ## $.#</L>
      <L>#.$    $.#</L>
      <L>#.$    $.#</L>
      <L>#+$#######</L>
      <L>#  #</L>
      <L>####</L>
    </Level>
    <Level Id="54" Width="31" Height="10">
      <L>##############################</L>
      <L># $. $. $. $. $. $. $. $. $. #</L>
      <L># .$ .$ .$ .$ .$ .$ .$ .$ .$ ##</L>
      <L># $..$. $. $. $..$. $. $. $. @#</L>
      <L># .$ .$ .$ .$ .$ .$ .$ .$ .$ ##</L>
      <L>#    *  . . . . . . . . . .  #</L>
      <L>#####  ### # # # #############</L>
      <L>    #$ # # $$$$#$$ $ $ $ $ $ #</L>
      <L>    #  # #                   #</L>
      <L>    #### #####################</L>
    </Level>
    <Level Id="55" Width="24" Height="13">
      <L>   ########</L>
      <L>####      ###</L>
      <L>#    $ $    #</L>
      <L>#    #.# $  #</L>
      <L># $$ #.# $$ #</L>
      <L>#  ###.###   #</L>
      <L># $.......   #</L>
      <L>#  ###.###  ##</L>
      <L># $$ #*#    #</L>
      <L>#  $ #.# $# ############</L>
      <L># $$ #.# $       $ $ $ #</L>
      <L>#..  #.#+# .####       #</L>
      <L>#############  #########</L>
    </Level>
    <Level Id="56" Width="26" Height="13">
      <L>      #####</L>
      <L>      #   #</L>
      <L>   ####$$ #</L>
      <L>   # $   .#</L>
      <L>#### $ $###</L>
      <L>#   $    #####</L>
      <L># $........  #</L>
      <L>#  ###.### $ #</L>
      <L># $$ #*#    ##</L>
      <L># $  #.# $# #############</L>
      <L># $$ #.# $ .   $    $ $ #</L>
      <L>#... #.#@# .#### $      .#</L>
      <L>#############  ###########</L>
    </Level>
    <Level Id="57" Width="26" Height="9">
      <L>##########################</L>
      <L>#..                      #</L>
      <L># ####  ## # #  ## $$$$$ #</L>
      <L># #     #..# #$ .# $ $ $ #</L>
      <L># $$$$$  ..# #   $ $     #</L>
      <L>#  @$ ###..# #$$ ######  #</L>
      <L># $$#    ..# #   ......  #</L>
      <L>#            #   .. . .  #</L>
      <L>##########################</L>
    </Level>
    <Level Id="58" Width="15" Height="9">
      <L>####</L>
      <L>#  #####</L>
      <L>#  ...+#</L>
      <L>#  # ###</L>
      <L>## #   ########</L>
      <L>#  # $ $   $  #</L>
      <L># $ $#  $   .##</L>
      <L>#  #  .########</L>
      <L>########</L>
    </Level>
    <Level Id="59" Width="23" Height="15">
      <L>   ###</L>
      <L>   #+#####</L>
      <L>   #.  $ #</L>
      <L>   #.#$# # ############</L>
      <L>   #.#   # #        .##</L>
      <L>   #.## ## #  $. $. $.#</L>
      <L>   #.## ## ## #########</L>
      <L>   #.## ##  # #</L>
      <L>####.## ##  # #</L>
      <L>#  $ $ $ #  # #</L>
      <L>#      # #  # #</L>
      <L># $$#$## #### #</L>
      <L>#        $    #</L>
      <L>############  #</L>
      <L>           ####</L>
    </Level>
    <Level Id="60" Width="25" Height="12">
      <L>   #######</L>
      <L>   #     ######</L>
      <L>   # ##     $@#</L>
      <L>   #     # $ $##</L>
      <L>   ##....###$  #</L>
      <L>###########    ####</L>
      <L>#.  ...       ##  #######</L>
      <L>## .  ######### $ $     #</L>
      <L> # .    $   $ $       $ #</L>
      <L> # # ####      ##########</L>
      <L> #   #  ########</L>
      <L> #####</L>
    </Level>
    <Level Id="61" Width="12" Height="8">
      <L>  ########</L>
      <L> ##      #</L>
      <L>##  ## #$###</L>
      <L>#  $#. $ ..#</L>
      <L># $ $. #####</L>
      <L>##@$#..#</L>
      <L> #  ####</L>
      <L> ####</L>
    </Level>
    <Level Id="62" Width="16" Height="8">
      <L>#######</L>
      <L>#@ .  # ########</L>
      <L># .$.$# #  #   #</L>
      <L>#.$#$ # # $$$$ #</L>
      <L># .#..# #  # # #</L>
      <L>#$$ $ ### *. # #</L>
      <L>#.         .  .#</L>
      <L>################</L>
    </Level>
    <Level Id="63" Width="16" Height="8">
      <L>################</L>
      <L>#   .    # $ ..#</L>
      <L># ##$.$$$#@#*.##</L>
      <L># # $ .$ # $..#</L>
      <L># #   $* # .*.#</L>
      <L># ###$ $.* *###</L>
      <L>#           #</L>
      <L>#############</L>
    </Level>
    <Level Id="64" Width="16" Height="9">
      <L>########</L>
      <L>#      ##</L>
      <L>#.*.*.  ########</L>
      <L>#***** $ $ $ $ #</L>
      <L>#.*.*.@#.#.#.#.#</L>
      <L>#***** $ $ $ $ #</L>
      <L>######    $  $ #</L>
      <L>     #####     #</L>
      <L>         #######</L>
    </Level>
    <Level Id="65" Width="29" Height="12">
      <L>                 ######</L>
      <L>                 #    #</L>
      <L>##################$ $$#######</L>
      <L>#                    .#...*.#</L>
      <L># *$####$ $ $ $ $####.##....#</L>
      <L>#   $  #  ####   $ ##......##</L>
      <L># *    # $#  ### $ ####* .$.#</L>
      <L># $$####  #$ $ $   $ $ .....#</L>
      <L># *    $$ # $   #$     ##$###</L>
      <L># *#     $     ##  $###..  .#</L>
      <L>########.    ######  @     .#</L>
      <L>       #######    ###########</L>
    </Level>
    <Level Id="66" Width="16" Height="9">
      <L>       #####</L>
      <L>########   ##</L>
      <L>#  $.# $  $#####</L>
      <L># $  $  # .....#</L>
      <L># #$    #$######</L>
      <L>#   $###.. #.###</L>
      <L>####  @    $.$ #</L>
      <L>   ########    #</L>
      <L>          ######</L>
    </Level>
    <Level Id="67" Width="18" Height="10">
      <L>###############</L>
      <L>#       *     #</L>
      <L># $*# #...# $ #</L>
      <L>### $.....# ######</L>
      <L>  #. #$# $#$ $ $ #</L>
      <L>  #     .       .#</L>
      <L>  ##$##### $ #@###</L>
      <L>  #    $   ####</L>
      <L>  #   #######</L>
      <L>  #####</L>
    </Level>
    <Level Id="68" Width="27" Height="9">
      <L>###########################</L>
      <L># @                     #.#</L>
      <L># $###################### #</L>
      <L>#  #                      #</L>
      <L>#  #  ##################  #</L>
      <L>#  #  #                ####</L>
      <L># $   #</L>
      <L>##.#  #</L>
      <L>#######</L>
    </Level>
    <Level Id="69" Width="18" Height="15">
      <L>################</L>
      <L>#.         .   #</L>
      <L># $$###*$$$#####</L>
      <L>#   #@..$ $ . ##</L>
      <L># $$# $    .$ ##</L>
      <L>#   ####$*$#####</L>
      <L># $ ...*    ...#</L>
      <L>#** $..  $ #####</L>
      <L>########$  #</L>
      <L>       #  $#######</L>
      <L>       # $ ......#</L>
      <L>       ##  *######</L>
      <L>       ###  $ #</L>
      <L>       ####   #</L>
      <L>       ########</L>
    </Level>
    <Level Id="70" Width="12" Height="10">
      <L>####</L>
      <L>#. #</L>
      <L>#.$#</L>
      <L>#. #</L>
      <L>#.$##</L>
      <L>#   ########</L>
      <L># $$   $ **#</L>
      <L>#.   #   ###</L>
      <L>##@#######</L>
      <L> ###</L>
    </Level>
    <Level Id="71" Width="9" Height="11">
      <L> #######</L>
      <L>##  #  ##</L>
      <L>#  $@$  #</L>
      <L># #$#$# #</L>
      <L># #...# #</L>
      <L># $.*.# #</L>
      <L># #.*.# #</L>
      <L>#   $   #</L>
      <L>## #$# ##</L>
      <L> #    $.#</L>
      <L> ########</L>
    </Level>
    <Level Id="72" Width="14" Height="9">
      <L>##########</L>
      <L>#  ..#   ###</L>
      <L># #... $$  #</L>
      <L># #..#  ## ###</L>
      <L># ## # $## $.#</L>
      <L>#  $$# $ # ###</L>
      <L>#### $   # #</L>
      <L>   # @ #   #</L>
      <L>   #########</L>
    </Level>
    <Level Id="73" Width="14" Height="11">
      <L>    #######</L>
      <L>    #     #</L>
      <L>    # ## $####</L>
      <L>  ### #   $  #</L>
      <L>###.# $ $$   #</L>
      <L>#  .#$$$  #  #</L>
      <L>#... @ #  # ##</L>
      <L>#...#$###   #</L>
      <L>#...  $  $###</L>
      <L>####### $  .#</L>
      <L>      #######</L>
    </Level>
    <Level Id="74" Width="14" Height="9">
      <L>        #####</L>
      <L>#########@  ##</L>
      <L>#      $   $ #</L>
      <L># $###$ .##$ #</L>
      <L># ...#....#  #</L>
      <L># # ### ###$ #</L>
      <L># # $   $    #</L>
      <L>#    ##   ####</L>
      <L>###########</L>
    </Level>
    <Level Id="75" Width="24" Height="17">
      <L>###############</L>
      <L>#...#         #</L>
      <L>#...# $ $#### #</L>
      <L>#.$ .#$  #@ # #</L>
      <L># $$ #  $   # #</L>
      <L>###  #####    #</L>
      <L># ...$.#.#$ ############</L>
      <L>#*#   $  $  $ $ $   $  #</L>
      <L>#####  $          $   *#</L>
      <L>#...#  #################</L>
      <L>#...#  $  $  $   *#</L>
      <L>##..##   #   #   ##</L>
      <L>##..## ############</L>
      <L># $$ $ $ #</L>
      <L>#        #</L>
      <L>## .######</L>
      <L> ####</L>
    </Level>
    <Level Id="76" Width="26" Height="10">
      <L>#########################</L>
      <L>#. .##  ##....#         #</L>
      <L>#.....*... $### $$#$$$ $#</L>
      <L>#..$.# ..#  ### $  $@$$ ##</L>
      <L>#..$.# $.# $###          #</L>
      <L>#....#$#$#  ### $$###$$$ #</L>
      <L>#..# $ $ $ $$ $ $ $ $  $ #</L>
      <L>#.##$$ $ $           #  ##</L>
      <L>#...     ..#########.  ###</L>
      <L>############       #######</L>
    </Level>
  </LevelCollection>
</SokobanLevels>
