<?xml version="1.0" encoding="utf-8"?>
<SokobanLevels xmlns:xsi="http://www.w3.org/2001/XMLSchema-instance" xsi:schemaLocation="SokobanLev.xsd">
  <Title>Saquarema</Title>
  <Description>
Saquarema is my beautiful city in the State of Rio de Janeiro, Brazil
  </Description>
  <Email>jhogloria@hotmail.com</Email>
  <LevelCollection Copyright="Jorge Gloria" MaxWidth="30" MaxHeight="27">
    <Level Id="001" Width="13" Height="8">
      <L>#############</L>
      <L>#  . . . .  #</L>
      <L>#  #$#$#$#  #</L>
      <L># $# . $ #$ #</L>
      <L>#  . $ + .  #</L>
      <L># $#$#$#$#$ #</L>
      <L>#  . . . .  #</L>
      <L>#############</L>
    </Level>
    <Level Id="002" Width="15" Height="10">
      <L>     #####</L>
      <L>  ####   ####</L>
      <L>###         ###</L>
      <L># $ $##.##$$  #</L>
      <L>#             #</L>
      <L>#######.#######</L>
      <L>#   $ $$* $ #</L>
      <L>#.  . .+. . #</L>
      <L>######   ####</L>
      <L>     #####</L>
    </Level>
    <Level Id="003" Width="9" Height="9">
      <L>     ####</L>
      <L>######@ #</L>
      <L># $ $ $ #</L>
      <L># * * * #</L>
      <L>#.# #.# #</L>
      <L># * . $ #</L>
      <L>#.#$#.# #</L>
      <L>#       #</L>
      <L>#########</L>
    </Level>
    <Level Id="004" Width="13" Height="13">
      <L>#############</L>
      <L>#           #</L>
      <L># #$###$### #</L>
      <L># #       $ #</L>
      <L># # #$### # #</L>
      <L># $ #...# # #</L>
      <L># # $..+#$# #</L>
      <L># # #....   #</L>
      <L># # #$### # #</L>
      <L># $       # #</L>
      <L># ###$### # #</L>
      <L>#           #</L>
      <L>#############</L>
    </Level>
    <Level Id="005" Width="14" Height="8">
      <L>   ########</L>
      <L>   #      #</L>
      <L>   #$ *..$#</L>
      <L>#### *#+# ####</L>
      <L>#    $...$   #</L>
      <L># $#### # #$ #</L>
      <L>#            #</L>
      <L>##############</L>
    </Level>
    <Level Id="006" Width="13" Height="11">
      <L>############</L>
      <L>#          #</L>
      <L># ######## ##</L>
      <L># $ $ $ $   #</L>
      <L>#  . . . * .#</L>
      <L># ########+ #</L>
      <L># # . . . . #</L>
      <L>#  $ $ $ $$ #</L>
      <L># ######## ##</L>
      <L>#          #</L>
      <L>############</L>
    </Level>
    <Level Id="007" Width="12" Height="10">
      <L>  #######</L>
      <L>  #     ##</L>
      <L>  # #.#. ###</L>
      <L>###$..#$$$ #</L>
      <L># @$*... # #</L>
      <L># #$ ## $# #</L>
      <L># #. .#. # #</L>
      <L>#  $ $$$ . #</L>
      <L>####     ###</L>
      <L>   #######</L>
    </Level>
    <Level Id="008" Width="8" Height="13">
      <L>######</L>
      <L>#    ##</L>
      <L># $$  ##</L>
      <L>#..#.. #</L>
      <L># *#.$##</L>
      <L># .#.$ #</L>
      <L>#  # $ #</L>
      <L># *#.$ #</L>
      <L>#$.#.$ #</L>
      <L>#.*##* #</L>
      <L>#$ $ $ #</L>
      <L>#  @   #</L>
      <L>########</L>
    </Level>
    <Level Id="009" Width="11" Height="12">
      <L>######</L>
      <L>#    #</L>
      <L>#    #</L>
      <L># .########</L>
      <L># $$.#. .##</L>
      <L>#  # $ $  #</L>
      <L>#  . . #$ #</L>
      <L># $#$###@ #</L>
      <L>#  . # ####</L>
      <L>##.#$#</L>
      <L> #   #</L>
      <L> #####</L>
    </Level>
    <Level Id="010" Width="11" Height="12">
      <L>     ####</L>
      <L>     #  #</L>
      <L>   ###  #</L>
      <L>   #    #</L>
      <L>####$#$ #</L>
      <L># ...   ###</L>
      <L>#.*$###$  #</L>
      <L>##.   $ $ #</L>
      <L> # ..#$ ###</L>
      <L> ####@* #</L>
      <L>    #   #</L>
      <L>    #####</L>
    </Level>
    <Level Id="011" Width="16" Height="10">
      <L>      ######</L>
      <L>#######@   #</L>
      <L># $.$.$$#$ #</L>
      <L># . .      #####</L>
      <L>#######.#$##   #</L>
      <L>  #   $ *  $$$ #</L>
      <L>  ## ###.#.#.# #</L>
      <L>  #    *    .. #</L>
      <L>  #    #   ##  #</L>
      <L>  ##############</L>
    </Level>
    <Level Id="012" Width="11" Height="12">
      <L>       ####</L>
      <L>########  #</L>
      <L>#         #</L>
      <L>#  $*#$#  #</L>
      <L>#### #@#$ #</L>
      <L>   # # #  #</L>
      <L>   # # #$.#</L>
      <L>   # *    #</L>
      <L>   #... ###</L>
      <L>   #### $ #</L>
      <L>      #.  #</L>
      <L>      #####</L>
    </Level>
    <Level Id="013" Width="11" Height="14">
      <L> #####</L>
      <L> #   ######</L>
      <L> #   ##   #</L>
      <L> ##  $    #</L>
      <L>  # # # ###</L>
      <L>### # #$###</L>
      <L>#   # #   #</L>
      <L>#    .$   #</L>
      <L>#####.#####</L>
      <L>    #*$@$ #</L>
      <L>    #.    #</L>
      <L>    #.#####</L>
      <L>    #.#</L>
      <L>    ###</L>
    </Level>
    <Level Id="014" Width="12" Height="8">
      <L> ##########</L>
      <L> #        ##</L>
      <L>##. . . .  #</L>
      <L>#  $#$#$#  #</L>
      <L># $. .@. . #</L>
      <L># $#$#$#$# #</L>
      <L>##         #</L>
      <L> ###########</L>
    </Level>
    <Level Id="015" Width="9" Height="10">
      <L>  #######</L>
      <L>  #     #</L>
      <L>  #$#.#.#</L>
      <L>  # .   #</L>
      <L>  #$#+# #</L>
      <L>  #  $. #</L>
      <L>###$#.#.#</L>
      <L># $ $ $ #</L>
      <L>#       #</L>
      <L>#########</L>
    </Level>
    <Level Id="016" Width="15" Height="9">
      <L>##### #########</L>
      <L>#.+.# #       #</L>
      <L>#...# #$ $ $  #</L>
      <L>#...###  # #$ #</L>
      <L>#        $$$  #</L>
      <L>#  #  #$$# ####</L>
      <L>#          #</L>
      <L>############</L>
      <L>############</L>
    </Level>
    <Level Id="017" Width="15" Height="10">
      <L>###############</L>
      <L>#             #</L>
      <L># #$#$#$#$#$# #</L>
      <L>#      @      #</L>
      <L>####$## ##$####</L>
      <L>   # $   $ #</L>
      <L>   #  ...  #</L>
      <L>   ###...###</L>
      <L>     #...#</L>
      <L>     #####</L>
    </Level>
    <Level Id="018" Width="19" Height="10">
      <L>  #################</L>
      <L>  #     #        ##</L>
      <L>  #     # $ $$ $  #</L>
      <L>### #  ## ### $   #</L>
      <L>#    # ##   #$ $  #</L>
      <L>#.  .# ##$# # $ $@#</L>
      <L>#....#      #$ $  #</L>
      <L>#....#$## ### $   #</L>
      <L>#....#    ###    ##</L>
      <L>###################</L>
    </Level>
    <Level Id="019" Width="11" Height="9">
      <L> ########</L>
      <L>##      #</L>
      <L>#  **##*###</L>
      <L>#      .$@#</L>
      <L># $$$###$ #</L>
      <L>#$.$.# #.##</L>
      <L>#.* .# ###</L>
      <L>#.####</L>
      <L>###</L>
    </Level>
    <Level Id="020" Width="8" Height="9">
      <L>   ###</L>
      <L> ###.#</L>
      <L> #.#.###</L>
      <L> #   *@#</L>
      <L>## $$$##</L>
      <L>#.* $  #</L>
      <L>## $   #</L>
      <L> #. ####</L>
      <L> ####</L>
    </Level>
    <Level Id="021" Width="10" Height="10">
      <L>   ###</L>
      <L>   #.#</L>
      <L>   #.#</L>
      <L>   #.#####</L>
      <L>   #.$   #</L>
      <L> ###.$$  #</L>
      <L>## $     #</L>
      <L># .$  $$ #</L>
      <L>#@#####. #</L>
      <L>###   ####</L>
    </Level>
    <Level Id="022" Width="9" Height="10">
      <L>     ####</L>
      <L> #####  #</L>
      <L>## $ $  #</L>
      <L>#@*     #</L>
      <L>###*$$ $#</L>
      <L>  #.$ $ #</L>
      <L>  #.##..#</L>
      <L>  #.##.##</L>
      <L>  ####.#</L>
      <L>     ###</L>
    </Level>
    <Level Id="023" Width="11" Height="9">
      <L>      #####</L>
      <L> ######  .#</L>
      <L>##@$    # #</L>
      <L># $*$##.# #</L>
      <L>#  $ $ .  #</L>
      <L># $* $##  #</L>
      <L># ..*.#####</L>
      <L>###. ##</L>
      <L>  ####</L>
    </Level>
    <Level Id="024" Width="17" Height="13">
      <L>#################</L>
      <L>#       #       #</L>
      <L># $$#$$   $$#$$ #</L>
      <L>#   $   #   $   #</L>
      <L># $$#$$ # $$#$$ #</L>
      <L>#       #       #</L>
      <L>## ####### ### ##</L>
      <L>#       #.......#</L>
      <L># $$#$$ #.......#</L>
      <L>#   $   #.......#</L>
      <L># $$#$$ #   .   #</L>
      <L>#       # ..+.. #</L>
      <L>#################</L>
    </Level>
    <Level Id="025" Width="23" Height="20">
      <L>#######################</L>
      <L>#    #     #          #</L>
      <L># #     #             #</L>
      <L>#   # #    #  # #  #  #</L>
      <L>#   #    # #          #</L>
      <L>##     #   # # # #  # #</L>
      <L>#    #     #       ## #</L>
      <L>#  #   # # #  # #     #</L>
      <L>#    #     #      #   #</L>
      <L>##     #   # #      # #</L>
      <L>#  #     # #   # #    #</L>
      <L>#          #          #</L>
      <L>##### ############## ##</L>
      <L>#          #          #</L>
      <L># ........ # $$$$$$$$ #</L>
      <L># .      . # $      $ #</L>
      <L># .      . # $      $ #</L>
      <L># ........ # $$$$$$$$ #</L>
      <L>#     @    #          #</L>
      <L>#######################</L>
    </Level>
    <Level Id="026" Width="19" Height="9">
      <L>            #######</L>
      <L>      #######     #</L>
      <L>#######     #$$$$ #</L>
      <L>#     # $ $       #</L>
      <L>#....   $$$ #$$$$ #</L>
      <L>#.... # $ $$#     #</L>
      <L>#.... #     #######</L>
      <L>#..+. #######</L>
      <L>#######</L>
    </Level>
    <Level Id="027" Width="10" Height="11">
      <L>     #####</L>
      <L>######   #</L>
      <L>#      @ #</L>
      <L>#  ###...#</L>
      <L># $$ #...#</L>
      <L>#  # #####</L>
      <L>## $   #</L>
      <L> # $ $ #</L>
      <L> ### $ #</L>
      <L>   #   #</L>
      <L>   #####</L>
    </Level>
    <Level Id="028" Width="22" Height="20">
      <L>       ####</L>
      <L>       #  #####</L>
      <L>       #      #</L>
      <L> ####  # ###  #</L>
      <L> #  ####  ## ##</L>
      <L> #        ## #</L>
      <L> # ######### #</L>
      <L> # ###       #</L>
      <L> # #+#  ###  #</L>
      <L> # #.## # ####</L>
      <L> # #..# #</L>
      <L> # #..# ##</L>
      <L> # #..#  #############</L>
      <L> # #..#  $           #</L>
      <L>## #..# ####### $$$$ #</L>
      <L>#       #     # $    #</L>
      <L>#  #  # #     # $  $ #</L>
      <L>## # ####     # $$$$ #</L>
      <L> #   #        #      #</L>
      <L> #####        ########</L>
    </Level>
    <Level Id="029" Width="15" Height="15">
      <L>  ########</L>
      <L>  #      #</L>
      <L>  # $$ $ #####</L>
      <L>  #  $$$ #  #</L>
      <L>  #  $      #</L>
      <L>  ##$$$$ #$ #</L>
      <L>  #      #  ###</L>
      <L>  # ######    #</L>
      <L>  # ###### ## #</L>
      <L>  #           #</L>
      <L>  # ######## ##</L>
      <L>### ....+### #</L>
      <L>#   .......# #</L>
      <L>#            #</L>
      <L>##############</L>
    </Level>
    <Level Id="030" Width="27" Height="17">
      <L>       ########## #########</L>
      <L>       #        # #       #</L>
      <L>    #### #$#$#  # # $ $#  #</L>
      <L>    #  #       ## # $# $  #</L>
      <L>#####    $ $ $ #  # $  # ##</L>
      <L>#  ##  # ##### ## # $  $ #</L>
      <L>#      #        ######   #</L>
      <L>#    ### $ $ $           #</L>
      <L>#### # ####### $ $ $ ### #</L>
      <L>   # #       #######  $  #</L>
      <L>   # #####         ####  #</L>
      <L>  ##  ...#            ####</L>
      <L>  #   ...#</L>
      <L>  #   ...#</L>
      <L>  ##.....#</L>
      <L>   #..+..#</L>
      <L>   #######</L>
    </Level>
    <Level Id="031" Width="19" Height="19">
      <L>       #####</L>
      <L>       #   #</L>
      <L>      ##   ##</L>
      <L>     ## $ $ ##</L>
      <L>    ##       ##</L>
      <L>   ##   #*#   ##</L>
      <L>  ##   #. .#   ##</L>
      <L> ##   #.   .#   ##</L>
      <L>## $ #.  $  .# $ ##</L>
      <L>#    *  $@$  *    #</L>
      <L>## $ #.  $  .# $ ##</L>
      <L> ##   #.   .#   ##</L>
      <L>  ##   #. .#   ##</L>
      <L>   ##   #*#   ##</L>
      <L>    ##       ##</L>
      <L>     ## $ $ ##</L>
      <L>      ##   ##</L>
      <L>       ## ##</L>
      <L>        ###</L>
    </Level>
    <Level Id="032" Width="19" Height="19">
      <L>       #####</L>
      <L>       # + #</L>
      <L>      ##   ##</L>
      <L>     ##     ##</L>
      <L>    ##   $   ##</L>
      <L>   ##   $*$   ##</L>
      <L>  ##   $*.*$   ##</L>
      <L> ##   $*...*$   ##</L>
      <L>##   $*..$..*$   ##</L>
      <L>#.  $*..$ $..*$  .#</L>
      <L>##   $*..$..*$   ##</L>
      <L> ##   $*...*$   ##</L>
      <L>  ##   $*.*$   ##</L>
      <L>   ##   $*$   ##</L>
      <L>    ##   $   ##</L>
      <L>     ##     ##</L>
      <L>      ##   ##</L>
      <L>       ##.##</L>
      <L>        ###</L>
    </Level>
    <Level Id="033" Width="19" Height="19">
      <L>       #####</L>
      <L>       #.+.#</L>
      <L>      ##...##</L>
      <L>     ##.   .##</L>
      <L>    ##.  $  .##</L>
      <L>   ##.  $$$  .##</L>
      <L>  ##.  $$ $$  .##</L>
      <L> ##.  $$   $$  .##</L>
      <L>##.  $$  $  $$  .##</L>
      <L>#.. $$  * *  $$ ..#</L>
      <L>##.  $$  $  $$  .##</L>
      <L> ##.  $$   $$  .##</L>
      <L>  ##.  $$ $$  .##</L>
      <L>   ##.  $$$  .##</L>
      <L>    ##.  $  .##</L>
      <L>     ##.   .##</L>
      <L>      ##...##</L>
      <L>       ##.##</L>
      <L>        ###</L>
    </Level>
    <Level Id="034" Width="17" Height="17">
      <L>     #######</L>
      <L>     ## + ##</L>
      <L>     ##   ##</L>
      <L>    ##. $ .##</L>
      <L>   ##. $$$ .##</L>
      <L>  ##. $$.$$ .##</L>
      <L> ##. $$. .$$ .##</L>
      <L>##. $$. $ .$$ .##</L>
      <L>#. $$. * * .$$ .#</L>
      <L>##. $$. $ .$$ .##</L>
      <L> ##. $$. .$$ .##</L>
      <L>  ##. $$.$$ .##</L>
      <L>   ##. $$$ .##</L>
      <L>    ##. $ .##</L>
      <L>     ##. .##</L>
      <L>      ##.##</L>
      <L>       ###</L>
    </Level>
    <Level Id="035" Width="30" Height="14">
      <L>     ####################</L>
      <L>     ####               #</L>
      <L>     #  #$#$#$#$#$#$##  #</L>
      <L>     #               #  #</L>
      <L>     #  ##$#$#$#$#$#$#  #</L>
      <L>######  #               ######</L>
      <L>#    #  #$#$#$#$#$#$##  #    #</L>
      <L>#    #               #  #    #</L>
      <L>#    #  ##$#$#$#$#$#$#  #    #</L>
      <L>#                       #    #</L>
      <L>#    ################# ##    #</L>
      <L>#    ####............        #</L>
      <L>#        ......+.....####    #</L>
      <L>##############################</L>
    </Level>
    <Level Id="036" Width="28" Height="27">
      <L>    ####################</L>
      <L>    #  #               #</L>
      <L>    #  #$#$#$#$#$#$##  #</L>
      <L>    #               #  #</L>
      <L>    #  ##$#$#$#$#$#$#  #</L>
      <L>    #  #               #</L>
      <L>    #  #$#$#$#$#$#$##  #</L>
      <L>#####               #  #####</L>
      <L>#   #  ##$#$#$#$#$#$#  #   #</L>
      <L>#             $        #   #</L>
      <L>#   ################# ##   #</L>
      <L>#   ####............       #</L>
      <L>#       ............#  #   #</L>
      <L>##### ########+####### #####</L>
      <L>#   #  #............       #</L>
      <L>#       ............####   #</L>
      <L>#   ## #################   #</L>
      <L>#   #         $            #</L>
      <L>#   #  #  $ $ $ $ $  # #   #</L>
      <L>#####   #  $ $ $ $  #  #####</L>
      <L>    #    #  $ $ $  #   #</L>
      <L>    #  $  #  $ $  #  $ #</L>
      <L>    #  $   #  $  #   $ #</L>
      <L>    #  $    #   #    $ #</L>
      <L>    #  $     ###     $ #</L>
      <L>    #                  #</L>
      <L>    ####################</L>
    </Level>
    <Level Id="037" Width="17" Height="20">
      <L>#################</L>
      <L>#               #</L>
      <L># $$$$$$$$$$$$$ #</L>
      <L>#               #</L>
      <L># ######### $ $ #</L>
      <L># . + .   # $ $ #</L>
      <L># #.#.# # # $ $ #</L>
      <L># . . .   # $ $ #</L>
      <L># #.#.# # # $ $ #</L>
      <L># . . . # # $ $ #</L>
      <L>#       # ### ###</L>
      <L>#### #### ### ###</L>
      <L>#    ####      #</L>
      <L># ## #### #### #</L>
      <L># #  #### #  # #</L>
      <L># #          # #</L>
      <L># #  ####### # #</L>
      <L># ####......   #</L>
      <L>#     ......   #</L>
      <L>################</L>
    </Level>
    <Level Id="038" Width="18" Height="15">
      <L>        #####</L>
      <L>       ## + ##</L>
      <L>      ##  *  ##</L>
      <L>     ##  * *  ##</L>
      <L>######  * * *  ##</L>
      <L>#      * * * *  ##</L>
      <L>#   # * * * * *  #</L>
      <L>### #* * *$* * * #</L>
      <L>#   # * * * * *  #</L>
      <L>#      * * * *  ##</L>
      <L>######  * * *  ##</L>
      <L>     ##  * *  ##</L>
      <L>      ##  *  ##</L>
      <L>       ##   ##</L>
      <L>        #####</L>
    </Level>
    <Level Id="039" Width="19" Height="19">
      <L>       #####</L>
      <L>       #   #</L>
      <L>       # # #</L>
      <L>      ## + ##</L>
      <L>     ##  *  ##</L>
      <L>    ##  * *  ##</L>
      <L>   ##  * * *  ##</L>
      <L>####  * * * *  ####</L>
      <L>#    * * * * *    #</L>
      <L># #.*$*$* *$*$*.# #</L>
      <L>#    * * * * *    #</L>
      <L>####  * * * *  ####</L>
      <L>   ##  * * *  ##</L>
      <L>    ##  * *  ##</L>
      <L>     ##  *  ##</L>
      <L>      ## . ##</L>
      <L>       # # #</L>
      <L>       #   #</L>
      <L>       #####</L>
    </Level>
    <Level Id="040" Width="23" Height="19">
      <L>         #############</L>
      <L>         # .         #</L>
      <L>         # # ######  #</L>
      <L>        ## * ##   # ##</L>
      <L>       ##  *  ##  # #</L>
      <L>      ##  * *  ## # #</L>
      <L>    ###  * * *  ### #</L>
      <L>######  * * * *  ## ###</L>
      <L>#      * * * * *      #</L>
      <L># #.#**$*$*@*$*$**#.# #</L>
      <L>#      * * * * *      #</L>
      <L>### ##  * * * *  ######</L>
      <L>  # ###  * * *  ##</L>
      <L>  # # ##  * *  ##</L>
      <L>  # #  ##  *  ##</L>
      <L> ## #   ## * ##</L>
      <L> #  ###### # #</L>
      <L> #         . #</L>
      <L> #############</L>
    </Level>
  </LevelCollection>
</SokobanLevels>
