<?xml version="1.0" encoding="utf-8"?>
<SokobanLevels xmlns:xsi="http://www.w3.org/2001/XMLSchema-instance" xsi:schemaLocation="SokobanLev.xsd">
  <Title>Sokobet</Title>
  <Description>
Right through the alfabet. Because it is the danish alfabet, you will
get a few bonus levels.
Can be shared at your sokoban site, if you ask and show this text and
the above information.
Enjoy.
  </Description>
  <Email>bjertrup58@gmail.com</Email>
  <Url>http://www.sokoban.dk/</Url>
  <LevelCollection Copyright="DrFogh" MaxWidth="32" MaxHeight="21">
    <Level Id="A" Width="20" Height="11">
      <L>####################</L>
      <L>########  #   #   ##</L>
      <L>##        #     # ##</L>
      <L>##  $ ### ## #.    #</L>
      <L>###$#$    ## . .   #</L>
      <L>#  $ $ #     .#.   #</L>
      <L>#@$   $#####.###.###</L>
      <L># $$$$$    #.....###</L>
      <L># $   $ ##  .## . ##</L>
      <L>#   ##  #######   ##</L>
      <L>####################</L>
    </Level>
    <Level Id="B" Width="15" Height="21">
      <L>###############</L>
      <L>##       ######</L>
      <L>## # # # ######</L>
      <L>## #$$$$  #####</L>
      <L>##  $   $ #####</L>
      <L>## #$   $ #####</L>
      <L>##  $$$$  ##  #</L>
      <L>## #$   $###  #</L>
      <L>##  $   $ ## @#</L>
      <L>## #$$$$     ##</L>
      <L>##   # ### #  #</L>
      <L>####   ###    #</L>
      <L>########## # ##</L>
      <L>####.... # # ##</L>
      <L>##  .   .# # ##</L>
      <L>#   .  #.    ##</L>
      <L>#   .... # ####</L>
      <L>#   .#  .  ####</L>
      <L>##  .   .# ####</L>
      <L>####....   ####</L>
      <L>###############</L>
    </Level>
    <Level Id="C" Width="10" Height="11">
      <L>##########</L>
      <L>#   #  ###</L>
      <L># # #   ##</L>
      <L>#   **#  #</L>
      <L># #*  *  #</L>
      <L>#  .##$#@#</L>
      <L># #*  *  #</L>
      <L># # **   #</L>
      <L>#  #  #  #</L>
      <L>##   #####</L>
      <L>##########</L>
    </Level>
    <Level Id="D" Width="12" Height="13">
      <L>############</L>
      <L>####     ###</L>
      <L>#### ### ###</L>
      <L>#### ...  ##</L>
      <L>##  #.##. ##</L>
      <L>## $$* #. ##</L>
      <L>#  $ .$#.  #</L>
      <L># #$ .*.   #</L>
      <L>#  $  $#####</L>
      <L>#  $$$ #####</L>
      <L>### # ######</L>
      <L>### @ ######</L>
      <L>############</L>
    </Level>
    <Level Id="E" Width="15" Height="10">
      <L>###############</L>
      <L>######  #######</L>
      <L>#       #     #</L>
      <L># # ....#$$$$ #</L>
      <L># # .##     $ #</L>
      <L># # ...## $$$ #</L>
      <L># # .####   $ #</L>
      <L>#   .... $$$$ #</L>
      <L>##  ######   @#</L>
      <L>###############</L>
    </Level>
    <Level Id="F" Width="18" Height="9">
      <L>##################</L>
      <L>###   #  #########</L>
      <L># $$$    #... #  #</L>
      <L># @ $ #   .#     #</L>
      <L>###$$  ###..  #  #</L>
      <L>### $  ###.####  #</L>
      <L>### $ ##  .      #</L>
      <L>###      ##   #  #</L>
      <L>##################</L>
    </Level>
    <Level Id="G" Width="15" Height="17">
      <L>###############</L>
      <L>#             #</L>
      <L># $########$$ #</L>
      <L>#     ...## # #</L>
      <L># $ #.#  .$ # #</L>
      <L># # *$#$##. $ #</L>
      <L># #.  #   $.# #</L>
      <L># #.# #  $#.# #</L>
      <L># #.#$### # # #</L>
      <L># #*   .*..*# #</L>
      <L># #. # $###.  #</L>
      <L># ##*# $  .$$ #</L>
      <L># #  . ##.$#  #</L>
      <L>#@$  #.*.  $  #</L>
      <L>####$# #$ #$###</L>
      <L>####        ###</L>
      <L>###############</L>
    </Level>
    <Level Id="H" Width="13" Height="11">
      <L>#############</L>
      <L>#   ####  ###</L>
      <L>#     #     #</L>
      <L>##.##*$$$$  #</L>
      <L>##.##. $@####</L>
      <L># .... $  ###</L>
      <L># .##*$$$$###</L>
      <L># .  .#    ##</L>
      <L>#  ##      ##</L>
      <L>#  ##########</L>
      <L>#############</L>
    </Level>
    <Level Id="I" Width="8" Height="12">
      <L>########</L>
      <L>####  ##</L>
      <L>###@* ##</L>
      <L>####* ##</L>
      <L>#   * ##</L>
      <L># # * ##</L>
      <L>#  #* ##</L>
      <L>## #   #</L>
      <L>## #   #</L>
      <L>##  #  #</L>
      <L>###   ##</L>
      <L>########</L>
    </Level>
    <Level Id="J" Width="9" Height="13">
      <L>#########</L>
      <L>#####   #</L>
      <L>##### . #</L>
      <L>##### * #</L>
      <L>###   * #</L>
      <L>##  # * #</L>
      <L>##  # *##</L>
      <L>##$ # * #</L>
      <L># *@# * #</L>
      <L>#  ***  #</L>
      <L>##  #  ##</L>
      <L>##    ###</L>
      <L>#########</L>
    </Level>
    <Level Id="K" Width="10" Height="9">
      <L>##########</L>
      <L>#  ###  ##</L>
      <L># *  *  ##</L>
      <L># .$.$#  #</L>
      <L>##.+$$   #</L>
      <L># .$.$#  #</L>
      <L># *  *  ##</L>
      <L>#  #######</L>
      <L>##########</L>
    </Level>
    <Level Id="L" Width="10" Height="11">
      <L>##########</L>
      <L>#     ####</L>
      <L>#  *  ####</L>
      <L>#  *######</L>
      <L>## *  ####</L>
      <L>## *  ####</L>
      <L>## *  #@##</L>
      <L>## ***** #</L>
      <L>##       #</L>
      <L>##  ######</L>
      <L>##########</L>
    </Level>
    <Level Id="M" Width="10" Height="10">
      <L>##########</L>
      <L>##      ##</L>
      <L>## .#  .##</L>
      <L>###** **##</L>
      <L>#  * * * #</L>
      <L>#  * # * #</L>
      <L>#  *   * #</L>
      <L>## $## $@#</L>
      <L>##     ###</L>
      <L>##########</L>
    </Level>
    <Level Id="N" Width="14" Height="17">
      <L>##############</L>
      <L>#   ##########</L>
      <L># # ##########</L>
      <L>#   ######  ##</L>
      <L>###*  #@*   ##</L>
      <L>## ** # * # ##</L>
      <L>## * * #* # ##</L>
      <L>#  *  * * # ##</L>
      <L># #* # **## ##</L>
      <L>#  * #  * # ##</L>
      <L># #  ##   # ##</L>
      <L>#   ###   # ##</L>
      <L>### ###  ## ##</L>
      <L>### #######  #</L>
      <L>###          #</L>
      <L>###  ##   ####</L>
      <L>##############</L>
    </Level>
    <Level Id="O" Width="20" Height="19">
      <L>####################</L>
      <L>###########  #######</L>
      <L>########  #  #   ###</L>
      <L>########  #      ###</L>
      <L>########  ##   #####</L>
      <L>######### .....#####</L>
      <L>####  #   .## .#####</L>
      <L>####  # ##.###.#####</L>
      <L>##    # ##.###.#   #</L>
      <L>#  # #  ##.###.    #</L>
      <L># $$$$$ ##. # .  ###</L>
      <L># $   $ # .....   ##</L>
      <L># $ # $##   ####  ##</L>
      <L># $ # $      ### @##</L>
      <L># $ # $####  #######</L>
      <L># $   $ ###  #######</L>
      <L># $$$$$ ############</L>
      <L>#       ############</L>
      <L>####################</L>
    </Level>
    <Level Id="P" Width="10" Height="13">
      <L>##########</L>
      <L>#        #</L>
      <L># ...### #</L>
      <L>##.# .## #</L>
      <L>##.#$*$  #</L>
      <L>##..*  $ #</L>
      <L>##.#$  $ #</L>
      <L>##. $$$###</L>
      <L>##.#$    #</L>
      <L>##  $ ## #</L>
      <L>## @$    #</L>
      <L>#####  ###</L>
      <L>##########</L>
    </Level>
    <Level Id="Q" Width="12" Height="12">
      <L>############</L>
      <L>#####  #####</L>
      <L>#####    ###</L>
      <L>#####**   ##</L>
      <L>### *  *# ##</L>
      <L>#   *# *  ##</L>
      <L>#   *  *####</L>
      <L>## # ***   #</L>
      <L>##   #@**  #</L>
      <L>#######    #</L>
      <L>#######  ###</L>
      <L>############</L>
    </Level>
    <Level Id="R" Width="15" Height="19">
      <L>###############</L>
      <L>########  #####</L>
      <L>##   ###  #####</L>
      <L>## $      #####</L>
      <L>#  $ ####$   ##</L>
      <L># $$#### $$$ ##</L>
      <L># # .... # $ ##</L>
      <L>#  #.###.#   ##</L>
      <L>## #.  #.### ##</L>
      <L>## #....  ## ##</L>
      <L>## #*#.## ## ##</L>
      <L>## #.  .   # ##</L>
      <L>## #.# @.  # ##</L>
      <L>## $$####### ##</L>
      <L>## $   $  $   #</L>
      <L>## $ $    #   #</L>
      <L>## $ ##########</L>
      <L>##   ##########</L>
      <L>###############</L>
    </Level>
    <Level Id="S" Width="15" Height="17">
      <L>###############</L>
      <L>##  ###########</L>
      <L>##  ###########</L>
      <L>##  ###########</L>
      <L>###     #######</L>
      <L>##  ##  #######</L>
      <L>##  #  ########</L>
      <L>#   ** ########</L>
      <L># #*# *########</L>
      <L>#  *   ########</L>
      <L>####** ########</L>
      <L>####  *  ######</L>
      <L>##@*  *#      #</L>
      <L>####**    #   #</L>
      <L>###  # #  #####</L>
      <L>###    ########</L>
      <L>###############</L>
    </Level>
    <Level Id="T" Width="9" Height="14">
      <L>#########</L>
      <L>##  ##  #</L>
      <L>#.....  #</L>
      <L># #. #  #</L>
      <L># #. #  #</L>
      <L># #.   ##</L>
      <L>#  . ####</L>
      <L>####$####</L>
      <L>#   $   #</L>
      <L># # $#  #</L>
      <L># # $   #</L>
      <L># $$$$$##</L>
      <L>#   @  ##</L>
      <L>#########</L>
    </Level>
    <Level Id="U" Width="10" Height="9">
      <L>##########</L>
      <L>###    ###</L>
      <L>##   # ###</L>
      <L>## #* * ##</L>
      <L>##  * * ##</L>
      <L>#   * *  #</L>
      <L># # ***  #</L>
      <L>#   #@ ###</L>
      <L>##########</L>
    </Level>
    <Level Id="V" Width="12" Height="14">
      <L>############</L>
      <L>#######  ###</L>
      <L>#        ###</L>
      <L># # ###  ###</L>
      <L># # *@# *  #</L>
      <L># # * ##*# #</L>
      <L># ## * *   #</L>
      <L>#  # * *## #</L>
      <L>##   #*    #</L>
      <L>## #  * # ##</L>
      <L>##   #  # ##</L>
      <L>###### ## ##</L>
      <L>######    ##</L>
      <L>############</L>
    </Level>
    <Level Id="W" Width="15" Height="17">
      <L>###############</L>
      <L>#   ######    #</L>
      <L># $ $     $ $ #</L>
      <L>#  $ $ $ $ $  #</L>
      <L># $ $ $ $ $ $ #</L>
      <L>#  $ $ $ $ $  #</L>
      <L># $ $ $ $ $ $@#</L>
      <L>## ####### ## #</L>
      <L># .   . .   . #</L>
      <L># . ##. .###.##</L>
      <L>###.## .#  . ##</L>
      <L>## .## .  #. ##</L>
      <L>##  .#. . . ###</L>
      <L>#  #.#.#.#. ###</L>
      <L>#    .   . ####</L>
      <L>###  .#  . ####</L>
      <L>###############</L>
    </Level>
    <Level Id="X" Width="14" Height="14">
      <L>##############</L>
      <L>##    ########</L>
      <L>## $#      ###</L>
      <L>##  #.###.   #</L>
      <L>##$$#. # . # #</L>
      <L>##  # . .# # #</L>
      <L>#  $ # .   # #</L>
      <L># $#  .#.#   #</L>
      <L>#   #.   . ###</L>
      <L>#  $ .###.  ##</L>
      <L>#  $   $  # ##</L>
      <L>## $$#$$$#  ##</L>
      <L>##   #@    ###</L>
      <L>##############</L>
    </Level>
    <Level Id="Y" Width="19" Height="21">
      <L>###################</L>
      <L>##  #    #  #     #</L>
      <L>## $  $$ $$ #$ $$ #</L>
      <L>##..#$ $##..# $ $ #</L>
      <L># ..#   $ ..#$ $  #</L>
      <L># #..#  #...# $ $ #</L>
      <L># #..#$$ ..##  $  #</L>
      <L>#  #.. #..### $ $ #</L>
      <L>## $..##..#   # $ #</L>
      <L>#  ##.... # $ # $ #</L>
      <L>#  ##....## $  #  #</L>
      <L>#   ##.. $ #  $ # #</L>
      <L>#   ##..# $ # $ $ #</L>
      <L>#   ##..#  $ # $. #</L>
      <L>#   ##..#$  $ #...#</L>
      <L># # ##..#  $ $ #.##</L>
      <L>#     ..#$@ $ $   #</L>
      <L>#    #  # $$ $ $$ #</L>
      <L>#       #$  $$  $ #</L>
      <L>#####  ##         #</L>
      <L>###################</L>
    </Level>
    <Level Id="Z" Width="14" Height="15">
      <L>##############</L>
      <L>#    #########</L>
      <L># $$ $  $  $ #</L>
      <L># @$$## # ## #</L>
      <L>##$#         #</L>
      <L>## # #  ### ##</L>
      <L>## # # ...#  #</L>
      <L>## # ### .   #</L>
      <L>## # ###.## ##</L>
      <L>## #   ...   #</L>
      <L>## ### ####  #</L>
      <L>## ###  ###  #</L>
      <L>#       ######</L>
      <L>#   ##  ######</L>
      <L>##############</L>
    </Level>
    <Level Id="Æ" Width="32" Height="15">
      <L>################################</L>
      <L>#####################  #########</L>
      <L>###############        ##    ###</L>
      <L>###############  ##### ##    ###</L>
      <L>################ #   # ### #  ##</L>
      <L>####   ####  ### #   ..... #  ##</L>
      <L>###  $   ##  ### ## .#.###    ##</L>
      <L>### $#$    $$$   ##.# .#   #  ##</L>
      <L>##  $ $  # $  ## ##.# ...#    ##</L>
      <L>## $   $###$$    ##....### #  ##</L>
      <L>#  $$$$$ # $  ## ##.##. ##     #</L>
      <L>#  $   $   $$$   ##. #....   # #</L>
      <L>##   #   #   ######     ##     #</L>
      <L>################### @###########</L>
      <L>################################</L>
    </Level>
    <Level Id="Ø" Width="10" Height="12">
      <L>##########</L>
      <L>##      ##</L>
      <L># $ #  . #</L>
      <L>#  ****  #</L>
      <L># * $.#* #</L>
      <L># * $. * #</L>
      <L># * .$ * #</L>
      <L># *#.$ * #</L>
      <L>#  ****  #</L>
      <L># .  # $ #</L>
      <L>##   @   #</L>
      <L>##########</L>
    </Level>
    <Level Id="Å" Width="9" Height="13">
      <L>#########</L>
      <L>#   .   #</L>
      <L># ## ## #</L>
      <L>#   *   #</L>
      <L>## * * ##</L>
      <L>#  *#*  #</L>
      <L># * @ * #</L>
      <L># ***** #</L>
      <L># * # * #</L>
      <L># # $ # #</L>
      <L>#       #</L>
      <L>###   ###</L>
      <L>#########</L>
    </Level>
  </LevelCollection>
</SokobanLevels>
