<?xml version="1.0" encoding="utf-8"?>
<SokobanLevels xmlns:xsi="http://www.w3.org/2001/XMLSchema-instance" xsi:schemaLocation="SokobanLev.xsd">
  <Title>Sokolasse 2</Title>
  <Description>
Sokolasse 2 collection by Lars Nilsson
  </Description>
  <Email>lasse.n@glocalnet.net</Email>
  <LevelCollection Copyright="Lars Nilsson" MaxWidth="33" MaxHeight="25">
    <Level Id="1" Width="21" Height="17">
      <L>#########</L>
      <L>#       ##</L>
      <L># $  $   #</L>
      <L>## ## $  #</L>
      <L>#   #  $$###</L>
      <L># $ # $    #</L>
      <L># $ #    $ ####</L>
      <L>#   #####  $  #######</L>
      <L>##$     #  $  ##    #</L>
      <L> #      #  $$ ## $  #</L>
      <L> #####  ###     $ $ #</L>
      <L>     #  #.######    #</L>
      <L>     #  #......# $  #</L>
      <L>     ## #...+..## ###</L>
      <L>      #  ....   $   #</L>
      <L>      ##     ..#    #</L>
      <L>       ##############</L>
    </Level>
    <Level Id="2" Width="13" Height="11">
      <L>#####   #####</L>
      <L>#   #####   #</L>
      <L># $  $@$  $ #</L>
      <L># # $$$$$ # #</L>
      <L>#.##  $  ##.#</L>
      <L>#..# $$  #..#</L>
      <L>#..#     #..#</L>
      <L>#.. ## ###..#</L>
      <L>##$       $##</L>
      <L> #         #</L>
      <L> ###########</L>
    </Level>
    <Level Id="3" Width="26" Height="14">
      <L>                     #####</L>
      <L>######################...#</L>
      <L>#     $  $  $       ..*..#</L>
      <L>#  $  $     $ $ $ $  #   #</L>
      <L># $$$ $    $ $ $@$ $ #   #</L>
      <L>#    #################   #</L>
      <L>#   $#   #............   #</L>
      <L>##   # $ #.....          #</L>
      <L> #  $# $ ##....#######  ##</L>
      <L> #   # $  #####      ####</L>
      <L> #  $# $$     #</L>
      <L> #      $$    #</L>
      <L> ##  #        #</L>
      <L>  #############</L>
    </Level>
    <Level Id="4" Width="23" Height="12">
      <L>       ##############</L>
      <L>########            #</L>
      <L>#...... $           #</L>
      <L>#.*############ #####</L>
      <L>#.......          #</L>
      <L>#..######### ######</L>
      <L>#..#@  ##         #</L>
      <L>#  # $$ #$$$$$$$$ #####</L>
      <L># $ $   $      $      #</L>
      <L>#       #   ##### $$$ #</L>
      <L>#############   #     #</L>
      <L>                #######</L>
    </Level>
    <Level Id="5" Width="20" Height="20">
      <L>             ######</L>
      <L>##############    #</L>
      <L># @      $        #</L>
      <L># $ $  #######  $ #</L>
      <L># #  $   #   ### ##</L>
      <L># #$  $  ##       #</L>
      <L># # $  $  ### $$  #</L>
      <L># # $$ $  $ #     #</L>
      <L># #    $    #### ##</L>
      <L>#   ############  ##</L>
      <L> ####  $  $       ##</L>
      <L> #     $    # ##$ #</L>
      <L> ##  $$$$$ ##.....#</L>
      <L>  # $$    ##......#</L>
      <L>  #  $  $##......##</L>
      <L>  #  $   #......##</L>
      <L>  # $$  ##.....###</L>
      <L>  #    ##....###</L>
      <L>  #   ########</L>
      <L>  #####</L>
    </Level>
    <Level Id="6" Width="17" Height="17">
      <L>#################</L>
      <L>#@              #</L>
      <L>#   # #   # #   #</L>
      <L>#  #.#.#.#.#.#  #</L>
      <L>#  . $ # # $ .  #</L>
      <L>#  # $ # # $ #  #</L>
      <L>#  . $ # # $ .  #</L>
      <L>#  # $ # # $ #  #</L>
      <L>#  . $   # $ .  #</L>
      <L>#  # $ # # $ #  #</L>
      <L># $. $ # # $ .$ #</L>
      <L>#  # $ # # $ #  #</L>
      <L>#  . $ #   $ .  #</L>
      <L>#  #.#.#.#.#.#  #</L>
      <L>#   # #   # #   #</L>
      <L>#               #</L>
      <L>#################</L>
    </Level>
    <Level Id="7" Width="26" Height="16">
      <L>    ##################</L>
      <L>    #          #     #</L>
      <L>    #   $ $    # $   #</L>
      <L>    #### $ $  $#.   ##</L>
      <L>    #.+# ## $  #.##$#</L>
      <L>    #. # .# $$ #.#  #####</L>
      <L>### #. #$.#  $ #.#   $  #</L>
      <L># ###. # .##   #.#  $ $ ##</L>
      <L>#    .  ...#   ###  $ $  #</L>
      <L>##  #.  ...##       $ $  #</L>
      <L> #  #####..##  #### $    #</L>
      <L> #   $  #### ## # ###    #</L>
      <L> #      $ $     #   #### #</L>
      <L> #####        ###      ###</L>
      <L>     ####     #</L>
      <L>        #######</L>
    </Level>
    <Level Id="8" Width="29" Height="16">
      <L>                 ######</L>
      <L>                 #    # #####</L>
      <L>##################    # #   #</L>
      <L>#...              $ $ ### $ #</L>
      <L>## .#####   $  ###  $     $ #</L>
      <L> #..    #      #  #$  #$ $$ #</L>
      <L> ##.# $ ##$$$$ #  # $ #     #</L>
      <L> #  $ $  #     #  #   ## ####</L>
      <L> # @$ $  #######. #####  #</L>
      <L> #    $$      ........#  #</L>
      <L> #    $   $  #........#  #</L>
      <L> ########### ##### ####  #</L>
      <L>           #             ###</L>
      <L>           #        #      #</L>
      <L>           ##########      #</L>
      <L>                     #######</L>
    </Level>
    <Level Id="9" Width="19" Height="21">
      <L>######</L>
      <L>#    ##############</L>
      <L># $$$    $ $      #</L>
      <L>#   $$$$     $    #</L>
      <L>#   $      #      #</L>
      <L># $ # #$  #.###   #</L>
      <L>#   # # $ #...#$  #</L>
      <L>#@$ # # $ #...# $ #</L>
      <L># $ # # $ #...# $ #</L>
      <L># $ # # $$#...# $ #</L>
      <L># $ # # $ #...# $ #</L>
      <L># $$# # $ #...# $ #</L>
      <L>#   # # $ #...#$  #</L>
      <L>#   # # $ #...#   #</L>
      <L>#   # # $ #...#   #</L>
      <L>#   #$#   #...#   #</L>
      <L>#   # #   #...# ###</L>
      <L>##### ######..# ###</L>
      <L>#            .  ###</L>
      <L>#             # ###</L>
      <L>###################</L>
    </Level>
    <Level Id="10" Width="9" Height="25">
      <L> #######</L>
      <L> #.....#</L>
      <L> #.....#</L>
      <L> ##$ $##</L>
      <L>#   $   #</L>
      <L># #$  # #</L>
      <L># # $ # #</L>
      <L># #  $# #</L>
      <L># # $ # #</L>
      <L># #$  # #</L>
      <L># # $ # #</L>
      <L>#    $  #</L>
      <L># #$ $# #</L>
      <L># # $ # #</L>
      <L># #$  # #</L>
      <L># #   # #</L>
      <L># #   # #</L>
      <L># #$$$# #</L>
      <L># #   # #</L>
      <L># #$  # #</L>
      <L>#   $$  #</L>
      <L> ##   ##</L>
      <L> #+....#</L>
      <L> #.....#</L>
      <L> #######</L>
    </Level>
    <Level Id="11" Width="25" Height="13">
      <L>  ######</L>
      <L>  #    #     #########</L>
      <L>###    #######       #</L>
      <L>#       $      $  $ @#</L>
      <L># ## ############# ######</L>
      <L># #....# $    $     $   #</L>
      <L># #....  $  $ $  $  $   #</L>
      <L>#  ....# $  $ $$$$$$$   #</L>
      <L>###....# $    $     $   #</L>
      <L>  #....########## ##### #</L>
      <L>  #....# $ $ $ $   $    #</L>
      <L>  #....#              # #</L>
      <L>  #######################</L>
    </Level>
    <Level Id="12" Width="32" Height="13">
      <L>          ###</L>
      <L>          #.#</L>
      <L>          #.#</L>
      <L>          #.#         ##########</L>
      <L>###       #.#         #        #</L>
      <L># #       #.#         # $  $   #</L>
      <L># #########.########### $$$$   #</L>
      <L>#  .................... $      #</L>
      <L># ####### # ########### $$$$####</L>
      <L># #  $ $ $  $   $ $ $ # $   #</L>
      <L>#     $ $ $@ $ $ $ $  #     #</L>
      <L> ###                 ########</L>
      <L>   ###################</L>
    </Level>
    <Level Id="13" Width="26" Height="15">
      <L>#######              #####</L>
      <L>#     ################   #</L>
      <L>#   #          $         #</L>
      <L>#...# #######  #######...#</L>
      <L>#...$    $    $#######...#</L>
      <L>#. ##########  ###########</L>
      <L>#..#  $ $@ $ $ $ $ $  #..#</L>
      <L>#..$  $ $  $  $ $ $ $ #..#</L>
      <L>#..#  $ $  $  $ $ $ $ #..#</L>
      <L>#..#                  #..#</L>
      <L>####################$#   #</L>
      <L>                 ##  #$  #</L>
      <L>                 #   $   #</L>
      <L>                 #   #   #</L>
      <L>                 #########</L>
    </Level>
    <Level Id="14" Width="16" Height="20">
      <L> ###########</L>
      <L> #.#   .   #</L>
      <L> # .##     #</L>
      <L> #  . ..   #</L>
      <L> #   . .  ##</L>
      <L> # #  .. # #</L>
      <L> #  #  .#  #</L>
      <L> ##### #####</L>
      <L>     #.#</L>
      <L>######*#########</L>
      <L># $   $ $ *.*..#</L>
      <L># *...$  .*.*$ #</L>
      <L># $.$ $.$ *.$  #</L>
      <L># $.$$$. $.$$  #</L>
      <L># $ ..$@.*  $  #</L>
      <L># $$$$**$$$$$  #</L>
      <L>#              #</L>
      <L>######   #######</L>
      <L>     #   #</L>
      <L>     #####</L>
    </Level>
    <Level Id="15" Width="17" Height="18">
      <L>        ########</L>
      <L>        #      #</L>
      <L>     ####   #$##</L>
      <L>     #  #...#  #</L>
      <L>     #  ....#  #</L>
      <L>     #  #...#$ #</L>
      <L>     ## #...# ##</L>
      <L>      # #...#  #</L>
      <L>      # #...#$ #</L>
      <L>####### #####  #</L>
      <L>#           #  #</L>
      <L>#     $ $   #  #</L>
      <L>### ######### ###</L>
      <L>#       $ $ $$  #</L>
      <L># $ $   $  $ $$ #</L>
      <L>########$$ $ $  #</L>
      <L>    #      @    #</L>
      <L>    #############</L>
    </Level>
    <Level Id="16" Width="21" Height="16">
      <L>#######</L>
      <L>#     ###</L>
      <L>###  $  #</L>
      <L>#....#$ ########</L>
      <L>#....#         #</L>
      <L>#....# $ $ $   #</L>
      <L>#....######   #######</L>
      <L>#....#    ### #     #</L>
      <L>#....#      # #@$$$ #</L>
      <L>#....###$ $ #$#  $  #</L>
      <L>###### # $  # #  ####</L>
      <L>#      # $$ # #  #</L>
      <L># $$$$$#  $ # #  #</L>
      <L>#  $ $   $$$$ $  #</L>
      <L>#      #         #</L>
      <L>##################</L>
    </Level>
    <Level Id="17" Width="22" Height="15">
      <L>###############</L>
      <L>#   #         #</L>
      <L>#   # $$$$$$$ #</L>
      <L># $$#    $    #</L>
      <L>#    $ $$  $  ######</L>
      <L>#   # $  $$   #    #</L>
      <L>#  $#  $ $ ## #    #</L>
      <L>#   #       # #$$$ #</L>
      <L>#  $######  ###    #</L>
      <L>##  #......... $ $ #</L>
      <L># $$ #........#    ###</L>
      <L>#   $ #.......#$$$   #</L>
      <L>#  @ $ #......#  $$  #</L>
      <L>#       #.....#      #</L>
      <L>######################</L>
    </Level>
    <Level Id="18" Width="18" Height="19">
      <L>###</L>
      <L>#.#</L>
      <L>#.#</L>
      <L>#.#</L>
      <L>#.###</L>
      <L>#   #  ###</L>
      <L># $ #  #+#</L>
      <L># $ #  #.#</L>
      <L>#  $#  #.#     ###</L>
      <L>#$  ## #.#     #.#</L>
      <L># $  # #.#     #.#</L>
      <L>#$  $# #.#     #.#</L>
      <L># $  # #.#     #.#</L>
      <L>#$  $# #.#     #.#</L>
      <L># $  ###.#     #.#</L>
      <L>#$  $  $ #######.#</L>
      <L># $$$$$  $       #</L>
      <L>#                #</L>
      <L>##################</L>
    </Level>
    <Level Id="19" Width="22" Height="17">
      <L>######################</L>
      <L>#                    #</L>
      <L>##                   #</L>
      <L>  #  $$$$$#$$$$$     #</L>
      <L>   #   $  #  $       #</L>
      <L>    ## $  #  $      ##</L>
      <L>     # $@ # $$$$$$ ##</L>
      <L>     #  $ #    $  ##</L>
      <L>     ### ##   $   #</L>
      <L>     # #  ##  $  ##</L>
      <L>     # #$..## $ ##</L>
      <L>     # # ...#  ##</L>
      <L>     # #$...## ##</L>
      <L>     # # .......#</L>
      <L>     #  $.......#</L>
      <L>     #   .......#</L>
      <L>     ############</L>
    </Level>
    <Level Id="20" Width="20" Height="18">
      <L>####################</L>
      <L>#...#  #      #   ##</L>
      <L>#...#  #  $ $ #$$ ##</L>
      <L>#...# $#      #   ##</L>
      <L>#...#  # $$$$ #$$ ##</L>
      <L>#...# $# $  $ #   ##</L>
      <L>#...#  # $  $ #$$ ##</L>
      <L>#...#  # $  $ #   ##</L>
      <L>#...#  ###$####$$ ##</L>
      <L>#...# $         $ ##</L>
      <L>#.   @$###$####   ##</L>
      <L>#   #  # $  $ #$$ ##</L>
      <L>#...# $# $  $ #   ##</L>
      <L>#...#  # $  $ #$$ ##</L>
      <L>#...#  # $$$  #   ##</L>
      <L>#...#  #      #$$ ##</L>
      <L>#...#  #          ##</L>
      <L>####################</L>
    </Level>
    <Level Id="21" Width="15" Height="10">
      <L>########</L>
      <L>#      #######</L>
      <L># $$ @  $    ##</L>
      <L>#  ###$$$$$$  #</L>
      <L>#....# $   $  #</L>
      <L>#....# $   $  #</L>
      <L>#....# $$$$$ ##</L>
      <L>#....# $  $  #</L>
      <L>#....#       #</L>
      <L>##############</L>
    </Level>
    <Level Id="22" Width="19" Height="13">
      <L>    ##########</L>
      <L>    #   #    #</L>
      <L>    #$  #   $#</L>
      <L> #### $ #@ $ ######</L>
      <L> #  # $ # $  #    #</L>
      <L>##     $#$$$ #$ $ #</L>
      <L>#   #   $    $ $  #</L>
      <L>#  $#        #  $ #</L>
      <L># $ ##########    #</L>
      <L>#  $#.......### ###</L>
      <L>#    .......# $ $ #</L>
      <L>#   #.......      #</L>
      <L>###################</L>
    </Level>
    <Level Id="23" Width="28" Height="15">
      <L>    ######################</L>
      <L>#####                    ###</L>
      <L>#   ### #####  #########$  #</L>
      <L># $$#........$$    $   $   #</L>
      <L>#   #......##..##      #$$ #</L>
      <L># $$## #####....########   #</L>
      <L># $ $   $  #....#      $   #</L>
      <L># $  $ $   #.+..#     $ $  #</L>
      <L>#     $   $#....#  $ $ $   #</L>
      <L>#######$ $ #....#   $ $    #</L>
      <L>      # $  #....#  $ $     #</L>
      <L>      #  $ ###### $  #######</L>
      <L>      #   $$ $ $ $ $ #</L>
      <L>      #              #</L>
      <L>      ################</L>
    </Level>
    <Level Id="24" Width="13" Height="14">
      <L>       ####</L>
      <L>########  #</L>
      <L>#         #</L>
      <L>#   $  #  #</L>
      <L># $$$$$#$ #</L>
      <L>#      #  ###</L>
      <L>###$####$ $ #</L>
      <L>#......# $  #</L>
      <L>#..+...#$ $ #</L>
      <L>#......# $  #</L>
      <L>## #####$ $ #</L>
      <L>#   $    $  #</L>
      <L>#      #    #</L>
      <L>#############</L>
    </Level>
    <Level Id="25" Width="12" Height="16">
      <L>############</L>
      <L>#   #@     #</L>
      <L>#   ###$## #</L>
      <L>#     #  ..#</L>
      <L># $   #$ #.#</L>
      <L>#  $$$#  ..#</L>
      <L># $   $$ #.#</L>
      <L>#   $$#  ..#</L>
      <L># $   #$ #.#</L>
      <L>#  $$$#  ..#</L>
      <L>#     #$ #.#</L>
      <L>#     #  ..#</L>
      <L>#######  #.#</L>
      <L>      #$ ..#</L>
      <L>      #  #.#</L>
      <L>      ######</L>
    </Level>
    <Level Id="26" Width="31" Height="9">
      <L>############################</L>
      <L>#                          #</L>
      <L># # # # # #   # # # # # #  ####</L>
      <L>#   $ $ $ $ $#  $ $ $ $ $  #  #</L>
      <L>#  $ $ $ $ $   $ $ $ $ $ $  $ #</L>
      <L>#############$$#############  #</L>
      <L>            # @............#  #</L>
      <L>            ## ............   #</L>
      <L>            ###################</L>
    </Level>
    <Level Id="27" Width="20" Height="18">
      <L>########</L>
      <L>#..    #</L>
      <L>#..#   #</L>
      <L>#..#   #</L>
      <L>#..#   ####</L>
      <L>#......#  #</L>
      <L>#...... $ #</L>
      <L>## ####$  #</L>
      <L>#       $ #</L>
      <L>#######  $#</L>
      <L>      ##$ #########</L>
      <L>       #     $    ##</L>
      <L>       #$@$ $ $ $  #</L>
      <L>       #   $   $   #</L>
      <L>       #######$ $$ #</L>
      <L>       #  $ $ $$  ##</L>
      <L>       #          #</L>
      <L>       ############</L>
    </Level>
    <Level Id="28" Width="15" Height="23">
      <L>  ############</L>
      <L>  #          #</L>
      <L>  #  $ $$$ # #</L>
      <L>#### # # ### #</L>
      <L>#    $ #..   #</L>
      <L>#  $ $ #...$ #</L>
      <L>#  $ $ #...# #</L>
      <L>#  $ $ #. .# ##</L>
      <L>#  $ $ #. .#@ #</L>
      <L>#### #####.   #</L>
      <L>#   $ $  #..  #</L>
      <L>#     $  #..  #</L>
      <L>#### ### #..###</L>
      <L>#  $$$ # #..#</L>
      <L>#  $ $ # #..#</L>
      <L>#  $ $ # #..#</L>
      <L>#  $ $ # #.##</L>
      <L>#  $ $ # #.#</L>
      <L>#      # #.#</L>
      <L>### #### # #</L>
      <L> #         #</L>
      <L> #         #</L>
      <L> ###########</L>
    </Level>
    <Level Id="29" Width="24" Height="20">
      <L>#########</L>
      <L>#.......#</L>
      <L>###.....####</L>
      <L>  #.....   #</L>
      <L>  #....... #############</L>
      <L>  ### ###       #......#</L>
      <L>  # $ $ #$   $ $#......#</L>
      <L>  #  $  # $ $ $  ..    #</L>
      <L>  #  $$ #  $ $ $#      #</L>
      <L>  ## $  #  $$   # ######</L>
      <L>   # $  # $  $ $#$#    #</L>
      <L>   # $  #$   $  # # $  #</L>
      <L>   #    # $$   $# #$$  #</L>
      <L>   #@   #     $      $ #</L>
      <L>   ##############   $  #</L>
      <L>                #$ $ $ #</L>
      <L>                # $    #</L>
      <L>                #      #</L>
      <L>                #####  #</L>
      <L>                    ####</L>
    </Level>
    <Level Id="30" Width="33" Height="13">
      <L>#######################</L>
      <L>#                     #</L>
      <L># $#$#$#$#$#$#$#$#$#$ #########</L>
      <L>#  $ $ $ $ $ $ $ $ $          ###</L>
      <L>#                     #######   #</L>
      <L># $#$#$#$#$#$#$#$#$#$ #..... $$ #</L>
      <L>#                     $.....#   #</L>
      <L>#######################.....#$  #</L>
      <L>                      #.....#   #</L>
      <L>                      #.....#@  #</L>
      <L>                      #.*...#$  #</L>
      <L>                      #.....#   #</L>
      <L>                      ###########</L>
    </Level>
    <Level Id="31" Width="31" Height="15">
      <L>#########</L>
      <L>#       ###########</L>
      <L>#    $  $  $ $ $  ##</L>
      <L>#    $  #          #</L>
      <L>#    $  #########  #</L>
      <L>#    $  #          #     ######</L>
      <L>#### $  $ @$$$#########  #....#</L>
      <L>   #######  $  #      #  #....#</L>
      <L>         #$ $  # $    # ##....#</L>
      <L>         #     #  $$$$###.....#</L>
      <L>         #     # $       .....#</L>
      <L>         #     #####  #       #</L>
      <L>         #            #       #</L>
      <L>         #            #########</L>
      <L>         ##############</L>
    </Level>
  </LevelCollection>
</SokobanLevels>
