<?xml version="1.0" encoding="utf-8"?>
<SokobanLevels xmlns:xsi="http://www.w3.org/2001/XMLSchema-instance" xsi:schemaLocation="SokobanLev.xsd">
  <Title>Takaken collection</Title>
  <Description>
These levels are copyright Ken'ichiro Takahashi (takaken).
  </Description>
  <Email>takaken@ic-net.or.jp</Email>
  <Url>http://www.ic-net.or.jp/home/takaken/e/index.html</Url>
  <LevelCollection Copyright="Ken'ichiro Takahashi (takaken)" MaxWidth="25" MaxHeight="15">
    <Level Id="scrambled egg" Width="8" Height="8">
      <L> #####</L>
      <L> # @ ###</L>
      <L>## #$  #</L>
      <L># *. . #</L>
      <L>#  $$ ##</L>
      <L>### #.#</L>
      <L>  #   #</L>
      <L>  #####</L>
    </Level>
    <Level Id="a point" Width="9" Height="8">
      <L>#####</L>
      <L>#   #####</L>
      <L># # #   #</L>
      <L># $   $ #</L>
      <L>#..#$#$##</L>
      <L>#.@$   #</L>
      <L>#..  ###</L>
      <L>######</L>
    </Level>
    <Level Id="twins" Width="16" Height="10">
      <L> ######</L>
      <L>#   $. #  #####</L>
      <L>#.$    # #    .#</L>
      <L>#### .## #.  $ #</L>
      <L> ###  #  ###  ##</L>
      <L>  ##  #   ## $#</L>
      <L>   #  #    #. #</L>
      <L>####$#######$###</L>
      <L>#       @      #</L>
      <L>################</L>
    </Level>
    <Level Id="rescue in the bay" Width="12" Height="7">
      <L>     ####</L>
      <L>   ###  ####</L>
      <L>#### $  #  #</L>
      <L># $  $ $   #</L>
      <L># # #$#$#  #</L>
      <L># ....@.. ##</L>
      <L>###########</L>
    </Level>
    <Level Id="baby classic" Width="7" Height="7">
      <L>#######</L>
      <L>#...  #</L>
      <L># # $ #</L>
      <L>#  $  #</L>
      <L>###$ ##</L>
      <L>  # @#</L>
      <L>  ####</L>
    </Level>
    <Level Id="key" Width="14" Height="8">
      <L>  #####</L>
      <L>###  @#</L>
      <L>#  $  #</L>
      <L>#    #########</L>
      <L># #$   ....  #</L>
      <L>#  $ ######$ #</L>
      <L>##  ##    #  #</L>
      <L> ####     ####</L>
    </Level>
    <Level Id="Love" Width="25" Height="15">
      <L>   #####</L>
      <L>  ## @ #</L>
      <L>  #    #  #####    ######</L>
      <L> ##   #####   ######    #</L>
      <L>##   ##  .#   #   #  ## #</L>
      <L># . ## $#.## *$  ## ##  #</L>
      <L>#   ##  $  # .#  #     ##</L>
      <L>#   ###    ##   ## $$#. #</L>
      <L>#  $  #  ####   ####  . #</L>
      <L># .$  ## #  ## ##  ## ###</L>
      <L>### #### #   # #    # #</L>
      <L>  # #  # #   # #    # #</L>
      <L>### #### ##### ###### ###</L>
      <L>#                       #</L>
      <L>#########################</L>
    </Level>
  </LevelCollection>
</SokobanLevels>
