<?xml version="1.0" encoding="utf-8"?>
<SokobanLevels xmlns:xsi="http://www.w3.org/2001/XMLSchema-instance" xsi:schemaLocation="SokobanLev.xsd">
  <Title>Tammy Rock</Title>
  <Description>
tammy rocks 29 to honor vipul
  </Description>
  <Email>serenata@setarnet.aw</Email>
  <LevelCollection Copyright="Eric F Tchong" MaxWidth="50" MaxHeight="40">
    <Level Id="tammy rock 01" Width="11" Height="16">
      <L>  ###</L>
      <L>  #.#</L>
      <L>  #.#</L>
      <L>  #.#</L>
      <L>  #.#</L>
      <L>  #.######</L>
      <L> ##$ *   #</L>
      <L>## @# ## #</L>
      <L>#  ##  # ##</L>
      <L># $  $  $ #</L>
      <L>#  #  ##  #</L>
      <L>## ## ## ##</L>
      <L># $# $   #</L>
      <L>#  .  ####</L>
      <L>#  #  #</L>
      <L>#######</L>
    </Level>
    <Level Id="tammy rock 02" Width="11" Height="14">
      <L>########</L>
      <L>#....  #</L>
      <L>#####  #</L>
      <L>  ### ####</L>
      <L> ##  *   #</L>
      <L>## @# ## #</L>
      <L>#  ##  # ##</L>
      <L># $  $  $ #</L>
      <L>#  #  ##  #</L>
      <L>## ## ## ##</L>
      <L># $# $   #</L>
      <L>#  .  ####</L>
      <L>#  #  #</L>
      <L>#######</L>
    </Level>
    <Level Id="tammy rock 03" Width="11" Height="9">
      <L> #### ####</L>
      <L> #  ###  #</L>
      <L> #$     $#</L>
      <L> #  ###  #</L>
      <L> # #..## #</L>
      <L>## #.*.# ##</L>
      <L>#   $   $ #</L>
      <L>#  @  #   #</L>
      <L>###########</L>
    </Level>
    <Level Id="tammy rock 04" Width="16" Height="13">
      <L>    #####</L>
      <L> ####   ###</L>
      <L> # $  $   ##</L>
      <L>## $# # #  #####</L>
      <L># $   # #  $ @ #</L>
      <L># $ ###$#   ## #</L>
      <L>#   #      ### #</L>
      <L>##$   #### ....#</L>
      <L> #  # # #   ##.#</L>
      <L> #$$$ # #  ...##</L>
      <L> #  # # #...###</L>
      <L> ##   # #####</L>
      <L>  #####</L>
    </Level>
    <Level Id="tammy rock 05" Width="34" Height="20">
      <L>############################</L>
      <L>#  . . . . . . . . . . .   #</L>
      <L>#  $ $ $ $ $ $ $ $ $ $ $ $ #</L>
      <L>## ###############################</L>
      <L># * * * * * .$.$.$.$. . .  #     #</L>
      <L>#           @          $ $ #.$ # #</L>
      <L>#########################$## $# .#</L>
      <L>#  . . . . . . . . . . .$. #. #$ #</L>
      <L># $ $ $ $ $ $ $ $ $ $      #$ # .#</L>
      <L>##$#########################. #$ #</L>
      <L># .$. . . . . . . . . . .  #$ # .#</L>
      <L>#      $ $ $ $ $ $ $ $ $ $ #. #$ #</L>
      <L>#########################$##$ # .#</L>
      <L>#  . . . . . . . . . . .$. #. #$ #</L>
      <L># $ $ $ $ $ $ $ $ $ $      #$ # .#</L>
      <L>##$#########################. # $#</L>
      <L>#  * * * * * * * * * * * * *.$# .#</L>
      <L>#                              $ #</L>
      <L>#############################  *.#</L>
      <L>                            ######</L>
    </Level>
    <Level Id="tammy rock 06" Width="24" Height="22">
      <L>  ####          ########</L>
      <L>  #  ############      #</L>
      <L>  #*......*.$ #   $ $$ #</L>
      <L>  #..*#.#...$ # # $ $  #</L>
      <L>  #...#...#.$ #   $ #$ #</L>
      <L>  ##.*#.*.#.$ # # #  $ #</L>
      <L>   #..*.*.#*$ # # $$ $ #</L>
      <L>   ##.***...#   # $  ###</L>
      <L>    #.*....*##$ # $$ $ #</L>
      <L>    #.#*#...    # #  $ #</L>
      <L> #### $     #$$ # $$ # #</L>
      <L> #..#     $ @   # $  $ #</L>
      <L> #..       $      #$$$ #</L>
      <L>##..            ##     #</L>
      <L>#.* # $ $      ###   $ #</L>
      <L>##############  ##$$$$ #</L>
      <L>             #       # #</L>
      <L>             #####$$$$ #</L>
      <L>                 #     #</L>
      <L>                 #$$#$ #</L>
      <L>                 #     #</L>
      <L>                 #######</L>
    </Level>
    <Level Id="tammy rock 07 - ode to my friend Vipul" Width="46" Height="29">
      <L>           ###</L>
      <L>          ##.##</L>
      <L>         ## . ##</L>
      <L>        ##  $  ##</L>
      <L>       ##  $.*  ##</L>
      <L>      ##  $*$ *  ##</L>
      <L>     ##  #  .* $  #</L>
      <L>    ##  .$.$$ $.#.#</L>
      <L>   ##  *$ $# $$$$ ####</L>
      <L>  ##  *.*..*$. ...   #########################</L>
      <L> ##  $$ $$$$. .$ $ *    $ $    # $ . . . .   #</L>
      <L>##.$*#.*.*.$.$.$ $+$*$.**...#*$$  . *$.$* *$ #</L>
      <L>#.        .#.#.# $. * $* * $$    *$*$. .$*   #</L>
      <L>############ # ## # #  $*     * *$. *$. # ** #</L>
      <L>           # # .$* .$*  $$$. * *$. *$  ###   #</L>
      <L>           #.$* .$* .$* .$. * *$. *$. ## #####</L>
      <L>           # .$* .$* .$*$. * *$. *$. ##</L>
      <L>           ## .$* .$* .$. * *$. *$. ##</L>
      <L>            ## .$* .$* . * *$. *$. ##</L>
      <L>             ## .$* .$* * *$. *$. ##</L>
      <L>              ## .$* .$* *$. *$. ##</L>
      <L>               ## .$* .$*$. *$. ##</L>
      <L>                ## .$* .$. *$. ##</L>
      <L>                 ## .$* * .$. ##</L>
      <L>                  ## .$*$. * ##</L>
      <L>                   ## . . ####  #</L>
      <L>                    ###.#.#    ##</L>
      <L>                  #   #####   ##</L>
      <L>                  #####   ######</L>
    </Level>
    <Level Id="tammy rock 08" Width="21" Height="22">
      <L>#################</L>
      <L>#               ###</L>
      <L># $$  # $###$ $$  #</L>
      <L># $ $ # $   $ $ $ ##</L>
      <L># $  $  $   $ $  $ ##</L>
      <L># $   $ $   $ $   $ #</L>
      <L># $   $#$   $#$   $ #</L>
      <L># $  $  $   $ $  $  #</L>
      <L># $ $    $$$  $ $   #</L>
      <L># $$ ## $     $$ ## #</L>
      <L>#       @           #</L>
      <L>########## ###### ###</L>
      <L> ####             #</L>
      <L> #..  # .###. ..  ##</L>
      <L> #. .   .   . . .  #</L>
      <L> #.  .  .   . .  . #</L>
      <L> #.   . .   . .   .#</L>
      <L> #. ##.#.  #.#.   .#</L>
      <L> #.  .  .   . .  . #</L>
      <L> #. .    ...  . .  #</L>
      <L> #..######.###..####</L>
      <L> ####    ### ####</L>
    </Level>
    <Level Id="tammy rock 09" Width="21" Height="24">
      <L>                  ###</L>
      <L>           ########.#</L>
      <L>           #......#.#</L>
      <L>           #. ###.#.#</L>
      <L>           #. ..#.#.#</L>
      <L>           #. .##.#.#</L>
      <L>           #. ....#.#</L>
      <L>           #. ##   .#</L>
      <L>          ##........#</L>
      <L>###########    ######</L>
      <L>#    $         #</L>
      <L># ### ######## #</L>
      <L># #        $ # #</L>
      <L># # $ $$$$ $ # #</L>
      <L># # $    $ $ # #</L>
      <L># # $ $$ $ $ # #</L>
      <L># # $ $  $ $ # #</L>
      <L># # $ $$$$ $ # #</L>
      <L># # $      $ # #</L>
      <L># # $$$$$$$$ # #</L>
      <L># #            #</L>
      <L># ############ #</L>
      <L>#@             #</L>
      <L>################</L>
    </Level>
    <Level Id="tammy rock 10" Width="12" Height="6">
      <L>####</L>
      <L>#  ########</L>
      <L># $$ # $ .#</L>
      <L>#        @##</L>
      <L>########.*.#</L>
      <L>       #####</L>
    </Level>
    <Level Id="tammy rock 11" Width="31" Height="28">
      <L>             #####</L>
      <L>  ### #####  #...#  ##### ###</L>
      <L> ##.###.  ####   ####  .###.##</L>
      <L>##..#.... $         $ ....#..##</L>
      <L>#...#..#.   $ $ $ $   .#..#...#</L>
      <L># .... #.$.$###.###$.$.# .... #</L>
      <L>#  ... # ...# #.# #... # ...  #</L>
      <L>###$  . $$ .###.###. $$ .@ $###</L>
      <L># $ $ .  $ $.. $ ..$    .$$ $ #</L>
      <L># $..$.. ..  .$$$.  .. .*$..$ #</L>
      <L># .  .##. ..$. $ .$.. .##.  . #</L>
      <L># ...#  ###.. $$$ ..###  #... #</L>
      <L>###..# $##. #$ $ $# .##$ #..###</L>
      <L> #####  ##.  .$$$.  .##  #####</L>
      <L> #     $#. $  . .    .#$     #</L>
      <L> #$$$ $  #. .#. .#. .#  $ $$$#</L>
      <L> #   $  $##  $.$.$  # $  $   #</L>
      <L>##$ $  $  #.# . . #.#  $  $ $##</L>
      <L>#  $  $  $#. .$ $. .#$  $  $  #</L>
      <L># $  $  $  #.     .#  $  $  $ #</L>
      <L>#   $  $  $###$ $ ##$  $  $   #</L>
      <L>#  $  $  $   #   #   $  $  $  #</L>
      <L># $  $  $  $  # #  $  $  $  $ #</L>
      <L>#   $  $  $$$     $$$  $  $   #</L>
      <L># $$  $$ $   $$$$$   $ $$  $$ #</L>
      <L>#           $ $ $ $           #</L>
      <L>###########         ###########</L>
      <L>          ###########</L>
    </Level>
    <Level Id="tammy rock 12" Width="21" Height="21">
      <L>#####################</L>
      <L>#...*.....#.........#</L>
      <L>#...+..#######......#</L>
      <L>#..#..*...#...*..#..#</L>
      <L>#..#.*.#######.*.#..#</L>
      <L>#..# $#.......#$$#..#</L>
      <L>#..*   ***.***  $...#</L>
      <L>#..#$ $# $ $ #$ $#..#</L>
      <L>#...$ $ $   $ $ $...#</L>
      <L>#.##$  $  $  $  $##.#</L>
      <L>###  $    $    $  ###</L>
      <L># $$  $  $#$  $  $$ #</L>
      <L># $   $  $ $  $   $ #</L>
      <L># $$$ $$     $$ $$$ #</L>
      <L>#   ##$ $$$$$ $##   #</L>
      <L>#   $ $  # #  $ $   #</L>
      <L># $$   $ # # $   $$ #</L>
      <L># $  $  $$ $$  $  $ #</L>
      <L># $$$     $     $$$ #</L>
      <L>#                   #</L>
      <L>#####################</L>
    </Level>
    <Level Id="tammy rock 13" Width="19" Height="19">
      <L>       #####</L>
      <L>     ###   ###</L>
      <L>   ### $ #$$ ###</L>
      <L>  ##  * . .#   ##</L>
      <L>  #  #$# .$.$*  #</L>
      <L> ## * * .$# . # ##</L>
      <L> #  $.#.#.$.#*$* #</L>
      <L>##$#. .$*  $. # $##</L>
      <L># $.$#$    *#. .  #</L>
      <L># # .$.$# * .@.$# #</L>
      <L>#  . .#.    $#$.$ #</L>
      <L>##$ # .$ $.$. .#$##</L>
      <L> # *$*#.$.#.#.$  #</L>
      <L> ## # . #$. * * ##</L>
      <L>  #  *$.$. #$#  #</L>
      <L>  ##   #. . *  ##</L>
      <L>   ### $$# $ ###</L>
      <L>     ###   ###</L>
      <L>       #####</L>
    </Level>
    <Level Id="tammy rock 14" Width="26" Height="18">
      <L>         ################</L>
      <L> #########              #</L>
      <L>##         $.$*$.$*$*$* #</L>
      <L>#  * * * ### * . * . .$ #</L>
      <L># * # * #####$.$. .$.$$ #</L>
      <L>#@ * $ #### $. * * * .$ #</L>
      <L># * #####...$ ###########</L>
      <L>#  *#   ### .$############</L>
      <L># * ##    ## ..  . . .   #</L>
      <L>#  * ##    #* ##$. *$*$* #</L>
      <L># * * ##   #  ##.$. . .$ #</L>
      <L>#  * $ ##  # . . # *$*$* #</L>
      <L># * # * ## ##$*$.$. . .$ #</L>
      <L>#  * * * ### . . *$*$* * #</L>
      <L># * # * * * . # . . .$.$ #</L>
      <L>#  * * * *##$.$*$*$*$*$* #</L>
      <L>##                       #</L>
      <L> #########################</L>
    </Level>
    <Level Id="tammy rock 15" Width="19" Height="16">
      <L>            ####</L>
      <L>         ####  ####</L>
      <L>      ####  #     #</L>
      <L>      #  # $# # # #</L>
      <L>####  # $$ .#$$$# #</L>
      <L>#  ####  #.*# # # #</L>
      <L>#    ## $#..# # # #</L>
      <L># $# ## .#..    # #</L>
      <L>##.# ###.#*.### $ #</L>
      <L> # #    .*. $   # #</L>
      <L> # #######.#### $ #</L>
      <L> # # # $  .  @  # #</L>
      <L> # # #   #*####   #</L>
      <L> # ### $$$.#  #####</L>
      <L> #         #</L>
      <L> ###########</L>
    </Level>
    <Level Id="tammy rock 16" Width="33" Height="20">
      <L>##############    ###############</L>
      <L># $..........#    #             #</L>
      <L># #*## $.*#*.### ## ########### #</L>
      <L># $.*..*.*...*.# # $ .  ###   # #</L>
      <L># #   ###*.***#### . $ ** #   # #</L>
      <L># #$#$#    $ $.#.  $ * *  #   # #</L>
      <L># *  $ $$$##  ########   ###  # #</L>
      <L># $#        $ #..#  ####   #  # #</L>
      <L># .# ### ## . $* #  #.$.*# #  # #</L>
      <L># *$ $ #  ###  $$####.$*   #  # #</L>
      <L># .$$ $  $#..$ #      $ $ ##  # #</L>
      <L># ** .##* $*# ##.##$ .**  #   # #</L>
      <L># .  #         $  $  #$  ##   # #</L>
      <L># ## # ##$$.## $ #####. ##    # #</L>
      <L># .$ $    ##.  $ ##  #  #     # #</L>
      <L># ##$# ##$#.## #..# ##@##     # #</L>
      <L>#    #$## .*.# #$$# #  #      # #</L>
      <L># ####.##$ $ * $  ### ######### #</L>
      <L>#              ##               #</L>
      <L>#################################</L>
    </Level>
    <Level Id="tammy rock 17" Width="17" Height="12">
      <L>      #####</L>
      <L>   ####   ####</L>
      <L>   #    $    #</L>
      <L>   # $$$$$ $ #</L>
      <L>   # $  @$$$ #</L>
      <L>   #    $ $  #</L>
      <L>   #  $  $ $ #</L>
      <L>######## ########</L>
      <L>#... ##   # .*..#</L>
      <L>##   ..   ....  #</L>
      <L>#.  ..######  #.#</L>
      <L>#######    ######</L>
    </Level>
    <Level Id="tammy rock 18" Width="14" Height="13">
      <L>  ####   #####</L>
      <L>  #  #####   #</L>
      <L>  #..  @# $  #</L>
      <L>  #.## $# # ##</L>
      <L>###..#$   #  #</L>
      <L># ...#   $$$ #</L>
      <L># .. #$   #  #</L>
      <L>#  . # $$ # ##</L>
      <L># ##### ### #</L>
      <L>#        $ $#</L>
      <L>#######  #  #</L>
      <L>      ####  #</L>
      <L>         ####</L>
    </Level>
    <Level Id="tammy rock 19" Width="27" Height="19">
      <L>         ###########</L>
      <L>         #         #</L>
      <L>      #### $$$$$$$ ###</L>
      <L>     ##   #          #</L>
      <L>    ## $ $ # $$$$$$$ ###</L>
      <L>   ## $   $ #          ##</L>
      <L>   # $  $  $ # $$$$$$$$ #</L>
      <L>   #                    #</L>
      <L> ####### #################</L>
      <L> #         @   .   #     #</L>
      <L>## $ $ $ $ $ $ .$ $ $ $ $#</L>
      <L># $ $ $ $ $ $ $. $ $ $ $ ##</L>
      <L># ... .... ... . ...  ... #</L>
      <L>##.#. .##.$.#. . .#.$$.#. #</L>
      <L> #.#. .##. .#. . .#.  .#. #</L>
      <L> #... .##. ... . ...$ ... #</L>
      <L> #####.##.     . $$$$$$$$ #</L>
      <L>     #.##.#####.#         #</L>
      <L>     ######   #############</L>
    </Level>
    <Level Id="tammy rock 20" Width="17" Height="22">
      <L>#################</L>
      <L>#               #</L>
      <L># #  $ $.$ $ ## #</L>
      <L># # $ $$$ $ $   #</L>
      <L>#  $$    $ $ $  #</L>
      <L># $$   $  $ $ $ #</L>
      <L># $  $ $ $ $ $  #</L>
      <L>###     $ $ $ ###</L>
      <L>  ## $ $ $ $  #</L>
      <L>  ## #.### ####</L>
      <L> ##. . .$ $ #</L>
      <L> #. . . .   #</L>
      <L> ##. . .#####</L>
      <L> #. . +$.#</L>
      <L> ##...*.##</L>
      <L>  ##. . .#</L>
      <L>  #. . .##</L>
      <L>  ##. . .#</L>
      <L>  #.....##</L>
      <L>  ##. .##</L>
      <L>   ##.##</L>
      <L>    ###</L>
    </Level>
    <Level Id="tammy rock 21" Width="36" Height="40">
      <L>   ####</L>
      <L>  ##  ##</L>
      <L>  # $  ##</L>
      <L>  # $#  #</L>
      <L>  #  ## #</L>
      <L>  ## ## #</L>
      <L>   # ## #</L>
      <L>   # ## ##</L>
      <L>   # ##  #</L>
      <L>  ##  ## #                #######</L>
      <L>  # $    ##               #     #</L>
      <L>  # $###  #               # ### #</L>
      <L>  #  # ## #               # ### #</L>
      <L>  ## #  # #        ########   # #</L>
      <L>   # #  # #       ## $        $ #</L>
      <L>   # #  # #      ##  ######   # #</L>
      <L>  ## #  # #     ##  ##    ##### #</L>
      <L> ##  ## # #     #  ##         # ##</L>
      <L> #  $ # # #     # ##          #  #</L>
      <L> #  $ # # #     # #           #  #</L>
      <L> ##   # # #     # ###         #  #</L>
      <L>  ## ## # #######   ########### ##</L>
      <L>   # #  # # $        $        $ #</L>
      <L>   # #  #   #####  ### ######## #</L>
      <L>  ## # ##  ##   #  # # #      # #</L>
      <L> ##  ###  ##    #  ### #      # #</L>
      <L> #  $ ## ##     ##     #      # #</L>
      <L> #  $ ## #       # ### #      # #</L>
      <L> ##   ## #      ## ### #      # #</L>
      <L>  ## ### ########   ## ######## #</L>
      <L>   # # # ## $        $        $ #</L>
      <L>  ## # # #  ###### ############ ##</L>
      <L> ##  ### # #   ### ##.#.##   #   #</L>
      <L> #  $        # ##  #  #  #####   ###</L>
      <L> #  $   ##                ##   #  .#</L>
      <L> #$  $ ####.....####              ##</L>
      <L>## $  ##  ##...##  ##...#.##.# .  #</L>
      <L>#    ##    ##.##    ##.########.###</L>
      <L>#@  ##      #.#      ###      ###</L>
      <L>#####       ###</L>
    </Level>
    <Level Id="tammy rock 22 - ode to my friend Vipul" Width="50" Height="38">
      <L>##################################################</L>
      <L>#                                                #</L>
      <L># ######  $ $ $ $ $ ########################## # #</L>
      <L># #    #  $ $ $ $ $ # ###  $  $  $  $  $  $    # #</L>
      <L># #    #  ### # # #####                      $   #</L>
      <L># #    #  # #     ##  # ##################### ## #</L>
      <L># #    #  #### ## ##$ #   #                 # ## #</L>
      <L># #    #     # ## ##  # #                 * # ## #</L>
      <L># #    #  $$$# ## ##  # # ################ ## ## #</L>
      <L># #  $ #     # ## # $ # # #              # ##$## #</L>
      <L># # $  #  $$$# ## #   # # ############## # ## ## #</L>
      <L># #  $ #     # ## #   # # #............# # ## ## #</L>
      <L># #   $#  $$$# ## # $ # # #............# # ## ## #</L>
      <L># #  $ #     # ## #   # # #............# # ##    #</L>
      <L># # $  #  $$$# ## #   # # #............# # ##$## #</L>
      <L># #  $ #     # ## # $ # # #............# # ## ## #</L>
      <L># #   $#  $$$# ## #   # # #............# # ## ## #</L>
      <L># #  $ #     # ## #   # # #..          # # ## ## #</L>
      <L># # $  #  $$$# ## # $ #         . ...  # # ##    #</L>
      <L># #  $ #     # ## #   # # #     .   .  # # ##$####</L>
      <L># #   $#  $$$# ## #   # # ##    . ...  # # ## #</L>
      <L># #  $ #     # ## # $ # # ##    . .    # # ## #</L>
      <L># # $  #  $$$# ## #   # # ##    . ...  # # ## ###</L>
      <L># #  $ #     # ## #   # #@#............# # ##   #</L>
      <L># #   $#  $$$# ## # $ # # #............# # ##$# #</L>
      <L># #          # ## #   # # #............# # ## # #</L>
      <L># #### #  $$$# ## #   # # ############## # ## # #</L>
      <L>#    # #     # ## # # # # ################ ## # ##</L>
      <L># $$$###  $$$# ## # $                      ##    #</L>
      <L>#      #     # #  ## # ################### ##$#  #</L>
      <L># $$$$$#  #    #     #                   # ## #  #</L>
      <L>#      #  #### ##### #  $ $  $  $  $  $     # #  #</L>
      <L># $$$$$#           # # $$ $ $$ $$ $$ $$ $$$ # #  #</L>
      <L>#      ######  # # # # $  $  $  $  $  $  $  $ $  #</L>
      <L># $$$$$######### # # ######################## ## #</L>
      <L>#                #                               #</L>
      <L>###    #########      ############################</L>
      <L>  ######       ########</L>
    </Level>
    <Level Id="tammy rock 23" Width="17" Height="8">
      <L>        #########</L>
      <L>  #######       #</L>
      <L> ##   .## ##  $ #</L>
      <L> # .# ### $ $ ###</L>
      <L>## .. .## $#@$ #</L>
      <L>#   #      #   #</L>
      <L>#     #######  #</L>
      <L>#######     ####</L>
    </Level>
    <Level Id="tammy rock 24" Width="15" Height="13">
      <L> ####     ####</L>
      <L> #  #######  #</L>
      <L> #$ $ $ $ $ $#</L>
      <L> # ......... #</L>
      <L>##$.$#$#$#$.$##</L>
      <L># .. # # * .  #</L>
      <L># $ $#   #$$$ #</L>
      <L># $ .. # . .  #</L>
      <L>## .$#$#$#$.$##</L>
      <L> #$. ....... #</L>
      <L> #@ $ $.$ $ $#</L>
      <L> #  #######  #</L>
      <L> ####     ####</L>
    </Level>
    <Level Id="tammy rock 25" Width="18" Height="10">
      <L> #######</L>
      <L> #  #  ######</L>
      <L>##    $##   ###</L>
      <L># $ #...  #$  ##</L>
      <L># #$#.* #.#.$  #</L>
      <L>#    @# #$ *.# ###</L>
      <L>###$$#....*.$. . #</L>
      <L>  #    $ $ $ $ $ #</L>
      <L>  ##  ############</L>
      <L>   ####</L>
    </Level>
    <Level Id="tammy rock 26" Width="37" Height="34">
      <L>    #</L>
      <L>   #.#</L>
      <L>  #  .#</L>
      <L> #    .#</L>
      <L>#   $$ .#</L>
      <L> #  #   .#</L>
      <L>  # #$$  .#</L>
      <L>  # #     .#</L>
      <L>  # #$$$$$ .#</L>
      <L>  # #       .#</L>
      <L>  # #$$$$$#  .#</L>
      <L>  # #         .#</L>
      <L>  # #$$$$$#    .#</L>
      <L>  # #           .#</L>
      <L>  # #$$$$$$$$$#  .#</L>
      <L>  # #             .#</L>
      <L>  # #$$$$$$$$$#    .#</L>
      <L>  # #               .#</L>
      <L>  # #$$$$$$$$$#####  .#</L>
      <L>  # #                 .#</L>
      <L>  # #$$$$$$$$$#        .#</L>
      <L>  # #               . . .#</L>
      <L>  # #$$$$$$$$$#      .   .#</L>
      <L>  # #         #     . .   .#</L>
      <L>  # #$$#   . .#  . .  #    .#</L>
      <L>  # #       . #   .   #     .#</L>
      <L>  # #$$#   . .#  . .#####    .#</L>
      <L>  # #         . .             .#</L>
      <L>  # #$######   .             . .#</L>
      <L>  # #         . .           .   .#</L>
      <L>  # #$#    . .   . .#####. .     .#</L>
      <L>  # @       .     .       .       .#</L>
      <L>  # #      . .   . .     . .  .#   .#</L>
      <L>  ###################################</L>
    </Level>
    <Level Id="tammy rock 27" Width="45" Height="23">
      <L>                      #</L>
      <L>                     #.#</L>
      <L>                    #.@.#</L>
      <L>                   #. $ .#</L>
      <L>                  #. $$$ .#</L>
      <L>                 #.   #   .#</L>
      <L>                #.  $$#$$  .#</L>
      <L>               #.     #     .#</L>
      <L>              #. $$$$$#$$$$$ .#</L>
      <L>             #.       #       .#</L>
      <L>            #.  #$$$$$#$$$$$#  .#</L>
      <L>           #.         #         .#</L>
      <L>          #.    #$$$$$#$$$$$#    .#</L>
      <L>         #.           #           .#</L>
      <L>        #.  #$$$$$$$$$#$$$$$$$$$#  .#</L>
      <L>       #.             #             .#</L>
      <L>      #.    #$$$$$$$$$#$$$$$$$$$#    .#</L>
      <L>     #.               #               .#</L>
      <L>    #.      #$$$$$$$$$#$$$$$$$$$#      .#</L>
      <L>   #.                 #                 .#</L>
      <L>  #.            .............            .#</L>
      <L> #....................#....................#</L>
      <L>#############################################</L>
    </Level>
    <Level Id="tammy rock 28" Width="45" Height="23">
      <L>                      #</L>
      <L>                     #.#</L>
      <L>                    #.@.#</L>
      <L>                   #. $ .#</L>
      <L>                  #. $$$ .#</L>
      <L>                 #.   #   .#</L>
      <L>                #.  $$#$$  .#</L>
      <L>               #.     #     .#</L>
      <L>              #. $$$$$#$$$$$ .#</L>
      <L>             #.       #       .#</L>
      <L>            #.  $$$$$$#$$$$$$  .#</L>
      <L>           #.         #         .#</L>
      <L>          #.    $$$$$$#$$$$$$    .#</L>
      <L>         #.           #           .#</L>
      <L>        #. $$$$$$$$$$$#$$$$$$$$$$$ .#</L>
      <L>       #.             #             .#</L>
      <L>      #.   $$$$$$$$$$$#$$$$$$$$$$$   .#</L>
      <L>     #.               #               .#</L>
      <L>    #. $$$$$$$$$$$$$$$#$$$$$$$$$$$$$$$ .#</L>
      <L>   #.                 #                 .#</L>
      <L>  #.......................................#</L>
      <L> #....................#....................#</L>
      <L>#############################################</L>
    </Level>
    <Level Id="tammy rock 29" Width="24" Height="16">
      <L>   #######     ####</L>
      <L>   #     #######  #####</L>
      <L>   #$ $  #            #</L>
      <L>   #  $ $   ##### ### #</L>
      <L>####$$$$$$$ @   # ### ##</L>
      <L>#        $  #....$     #</L>
      <L># $$$$$$$$$ #...####   #</L>
      <L># $ $ $ $ $ #...#  # ###</L>
      <L>#           #...#  # #</L>
      <L>#################  # #</L>
      <L>      #....#       # #</L>
      <L>      #....######### ##</L>
      <L>      #.....          #</L>
      <L>      #   #.          #</L>
      <L>      ###   #######   #</L>
      <L>        #####     #####</L>
    </Level>
  </LevelCollection>
</SokobanLevels>
