<?xml version="1.0" encoding="utf-8"?>
<SokobanLevels xmlns:xsi="http://www.w3.org/2001/XMLSchema-instance" xsi:schemaLocation="SokobanLev.xsd">
  <Title>Unico</Title>
  <Description>
New collection with 19 levels by Eric F Tchong.
  </Description>
  <Email>serenata@setarnet.aw</Email>
  <LevelCollection Copyright="Eric F Tchong" MaxWidth="65" MaxHeight="36">
    <Level Id="claire" Width="40" Height="26">
      <L>         ###########################</L>
      <L>         #                         #</L>
      <L>    ######    $$$$$$$$$$$$$$$$$$   #</L>
      <L>#####      $$$$......          $$$ #####</L>
      <L>#    $$$$$$$   .####......       $     #</L>
      <L>#   $$    ......#  ######.       $$    #</L>
      <L>#  $$   ...######     . #.....    $$   #</L>
      <L>#  $    .###    # # ##  #####...   $$  #</L>
      <L>#  $    .#   ##     ## ###  ###.    $$ #</L>
      <L>#  $  ...# # ## ## ### ###    #.     $ #</L>
      <L># $$  .###     $ #  .#      # #..    $ #</L>
      <L># $   .#   # ###  # .  # ##   ##.    $ #</L>
      <L># $   .# #   ####    #   ## #  #.    $ #</L>
      <L># $   .#   $###   .# ##$###$@  #.    $ #</L>
      <L># $   .## # .    #   ## ### # ##.    $ #</L>
      <L>#  $  ..#   $# #   #  # #     #..    $ #</L>
      <L>#  $   .## #     .### # $  #  #.     $ #</L>
      <L>#  $$  ..#    #####.# .$ # ####.     $ #</L>
      <L>#   $$  .## . #.....# $#   #....     $ #</L>
      <L>#    $$   ## ##.   .#    ###.        $ #</L>
      <L>#     $$$$$   $.   .######... $$$$$$$$ #</L>
      <L>#####.... .    $$$ ........  $$        #</L>
      <L>    #.  .      . $$     $$$$$$  ########</L>
      <L>    #.  .      .  $$$$$$$       #</L>
      <L>    #...........         #      #</L>
      <L>    #############################</L>
    </Level>
    <Level Id="bloom" Width="37" Height="27">
      <L>         #####################</L>
      <L>   #######                   #</L>
      <L>   #         $$$$$$$$$       #####</L>
      <L>   #     $$$$$       $$$$$$$     #</L>
      <L> ###  $$$$    ......       $$$   #</L>
      <L> #   $$       .####..........$$$ ####</L>
      <L> #  $$   ......#  ######.......$    #</L>
      <L> #  $  ...######     . #.......$$   #</L>
      <L> # $$  .###        ##  #####....$$  #</L>
      <L> # $   .# $        ## ###  ###.. $  #</L>
      <L> # $  ..# $     # ### ###    #...$$ #</L>
      <L> # $  ### $     #  .#      # #... $ #</L>
      <L> # $  #.. $      # .  # ##   ##.. $ #</L>
      <L> # $  #.$$$         #   ## #  #.. $ #</L>
      <L> # $  #..$        # ##$###$@  #..$$ #</L>
      <L>## $  ##..$     #   ## ### # ##..$  #</L>
      <L>## $$  #..$       #  # #     #...$  #</L>
      <L> #  $  ##.$     .### # $  #  #..$$  #</L>
      <L> #  $   #.   ## ##.# .$ # ####..$   #</L>
      <L> #  $$  ##   #    .# $#   #....*$   #</L>
      <L> #   $$  #####  $ .#    ###.... $   #</L>
      <L> #    $       $ $ .######.....$$$   #</L>
      <L> ##   $$      $ $ ............$     #</L>
      <L>  ##   $$$$$$$$ $$..........$$$     #</L>
      <L>   ##            $$$$$$$$$$$$   #####</L>
      <L>    ######                      #</L>
      <L>         ########################</L>
    </Level>
    <Level Id="frank" Width="31" Height="23">
      <L>        ##############</L>
      <L>        #            ###</L>
      <L>    #####   $ $ $      #####</L>
      <L>  ###       ####..$.$      ####</L>
      <L>  #   $ $ $ #..######.$       #</L>
      <L> ## $  ######     . #.$.$ $   #</L>
      <L> #    ##.....   ##  #####..   #</L>
      <L>## $ # $$$      ## ###  ###$$ #</L>
      <L>#    #   $   # ### ###    #.  #</L>
      <L># $###   $   #  .#      # #.  #</L>
      <L>#  #..$$$$    # .  # ##   ##$ #</L>
      <L># $#..$          #   ## #  #. #</L>
      <L>#  #..$$$      # ##$###$   #$ #</L>
      <L># $##.  $$$  #   ## ### # ##. #</L>
      <L>#   #..   $    #  # #     #.$ #</L>
      <L>#  $##.$$$   .### # $  #  #.  #</L>
      <L>#    #.$ @##### # .$ # ####.$ #</L>
      <L>#  $$##...#     # $#   #.  .  #</L>
      <L>##    #####     #    ###$.$.$.#</L>
      <L> #  $ $ $ $ $ $ ## ###. .     #</L>
      <L> #  . . . .    $ $  $ $ $ . . #</L>
      <L> #  . . . . . .. . .. . .     #</L>
      <L> ##############################</L>
    </Level>
    <Level Id="rich" Width="28" Height="18">
      <L>           ############</L>
      <L>   #########          ######</L>
      <L>####         $$$$$$$$      #</L>
      <L>#            $......$$$$$$ #</L>
      <L># $ ..# #$$$$$.####......$ #</L>
      <L># $...#.#......#  ######.$ #</L>
      <L># $.###.###....#    $  #.$ #</L>
      <L># $.#     ######  #    #.$ #</L>
      <L># $.# #.#         ###$##.$ #</L>
      <L># $.# #.######## ##  $ #.$ #</L>
      <L># $.# #*.    @   ##  $ #.$ #</L>
      <L># $.# # ####### $ # #  #.$ #</L>
      <L># $.#   #.....#       ##.$ #</L>
      <L># $.#####.$$$ #########..$ #</L>
      <L># $.......$ $........... $ #</L>
      <L># $$$$$$$$$ $$$$$$$$$$$$$$ #</L>
      <L>#                          #</L>
      <L>############################</L>
    </Level>
    <Level Id="stay" Width="38" Height="19">
      <L>     #################################</L>
      <L>     # .                             #</L>
      <L>   ### $ . .                   . .   #</L>
      <L>   #     $ $ . . . . . . . . . $ $   #</L>
      <L>   #  .$ ### $     $ $ $ $ $ $ ####$.#</L>
      <L>   # .   #.### $ $ #############  #  #</L>
      <L>#### $ $ #   ####  #              #$.#</L>
      <L>#    . ### $* #  # # # # # ###### #  #</L>
      <L># .$ $ #   . *$* # #   $ # #    #.#$.#</L>
      <L>#    ###  $ *$.  ###@# # # # $ $# #  #</L>
      <L># .$ # .  ..$. *     $             ..#</L>
      <L>#   ## *$* $. ##############$. .$  $.#</L>
      <L>##.$#  $ $ . *#  $ $ $ $ $ $         #</L>
      <L>#   #  *.*.$* #$ . . . . . . #########</L>
      <L># .$##       ##              #</L>
      <L>##   ######### $     #########</L>
      <L> # . $ $ $ $ $   #####</L>
      <L> #.  . . . . . . #</L>
      <L> #################</L>
    </Level>
    <Level Id="with" Width="27" Height="27">
      <L>      ###############</L>
      <L>      #             #</L>
      <L>      # $$$$$$$$$   #</L>
      <L>     ##         $$  #</L>
      <L>     #           $$ #######</L>
      <L>     #  $$$$$$$$..$$......#</L>
      <L>     #  $ . .  $   $$    .#</L>
      <L>     #  $ . .  $    $$   .#</L>
      <L>######  $ . .  $     $   .#</L>
      <L>#    #  $ . .  $$$$  $$  .#</L>
      <L># $ $#### . .     $   $  .#</L>
      <L># $     # . .     $   $  .#</L>
      <L># # $## # ### . $$$   $  .#</L>
      <L># $  ##$$ $ #   $    $$  .#</L>
      <L>###$ #. $   #   $   $$   .#</L>
      <L>###. #+.   ##  $$  $$   ..#</L>
      <L>#.$.##.# ###   $   $    .##</L>
      <L>#.....*. # .   $   $   ..#</L>
      <L>##.#$ $$ # .   $   $  ..##</L>
      <L> ###    ## .  $$   $  . #</L>
      <L>   ####### .  $    $  . #</L>
      <L>         #....$    $  . #</L>
      <L>         #....$$  $$  ..#</L>
      <L>         #..... $$$   ..#</L>
      <L>         #.....      ..##</L>
      <L>         ##...........##</L>
      <L>          #############</L>
    </Level>
    <Level Id="me" Width="41" Height="26">
      <L>                          ###############</L>
      <L>                          #          ...#</L>
      <L>                          # $ $ $ $ $.$.#</L>
      <L>                          #  $   $   $..#</L>
      <L>                          # $ $ $ $ $.$.#</L>
      <L>                        ####         ...#</L>
      <L>#########################  #$ $      ...#</L>
      <L>#      .            $      # $       ...#</L>
      <L>#   $###$$$# ###### ###### #$ $  $ $ ####</L>
      <L># $$ # #     #    # #    # #      $  #</L>
      <L>#   $# #####.#    # #    # ##### $ $ #</L>
      <L># $$ #     # #    # #   ## ##  ##    #</L>
      <L># $ $####### ###### #####  ##   #$ $ #</L>
      <L>#    #                       $  # $  #</L>
      <L>###### ###################### ###$ $ #</L>
      <L>     # ###################### ##     ####</L>
      <L>     #$                   @  .    .. ...#</L>
      <L>    ## ###### ###.########## # #$ $ $ $.#</L>
      <L>    #  ###  # # #.# ####   # # # $...$ .#</L>
      <L>    #       # ### ###..##### # #$ $.$ $.#</L>
      <L>    ####### #  $  #.  $        #   .   .#</L>
      <L>         #  #        ...######$#$ $.$ $.#</L>
      <L>         #   .  ####  #.#    #.# $...$ .#</L>
      <L>         ####   #  #..###    #.#$.$.$.$.#</L>
      <L>            #####  ####      ###........#</L>
      <L>                               ##########</L>
    </Level>
    <Level Id="till" Width="65" Height="34">
      <L>        ########################################</L>
      <L>        #     ##                               #</L>
      <L> ########                      $$$$$$$$        #</L>
      <L> #        $$$$$$$$$$$$     $$$$$       $       #</L>
      <L> #  $$$$$$$           $$$$$$           $$$$    ####</L>
      <L> # $$                                     $     ..###</L>
      <L> # $                          . .         $$     ...#</L>
      <L> # $    ####                   .           $       .#</L>
      <L> # $$   #  #                  . .  ####    $       .#</L>
      <L> #  $   # $#########################  #    $$$$    .#</L>
      <L> #  $   #  #      .            $      #       $    .#</L>
      <L> # $$   # $#   $###$$$# ###### ###### #       $$   .#########</L>
      <L> # $    #  # $$ # #     #    # #    # #       $    .#.......##</L>
      <L>## $    # $#   $# #####.#    # #    # #####   $    ...     ..#</L>
      <L>#  $    #  # $$ #     # #    # #   ## ##  ## $$             .##</L>
      <L># $$    # $# $ $####### ###### #####  ##   #$$          $ $ ..#</L>
      <L># $     #       #                       $                $   .##</L>
      <L>#  $    # $###### ###################### ###........... $ $   .##</L>
      <L>## $    #   $ $ # ###################### ##           .  $    ..#</L>
      <L> # $$   #...    #$                   @  . #          ..  $     .#</L>
      <L> #  $   ##..  $## ###### ###.########## # #  .........        ..#</L>
      <L> ## $    #...  #  ###  # # #.# ####   # # # .                 .##</L>
      <L>  # $    #... $#       # ### ###..##### # # ..        ...... ..#</L>
      <L>  # $    #...  ####### #  $  #.  $        #  ..........    . .##</L>
      <L>  # $    ###.. $ $  #  #        ...######$#############   .  .#</L>
      <L>  # $      ##..    $#   .  ####  #.#    #.#           #   . .##</L>
      <L>  # $$      ##.      ###   #  #..### $  #.#           # ..  .#</L>
      <L>  #  $       #....   $ #####  ####  $ $ #####     #####..   .#</L>
      <L>  #  $$      ######    $ $ $  $ $       $ $ #     #....     .#</L>
      <L>  #   $$          ##                        #     #####.    .#</L>
      <L>  #     $$        ###########################         #.    .#</L>
      <L>  ###### $$$$$$$$ #                                   #.   ..#</L>
      <L>       #          #                                   #....###</L>
      <L>       ############                                   ######</L>
    </Level>
    <Level Id="the" Width="42" Height="23">
      <L>         ######################</L>
      <L>   #######                    #</L>
      <L> ###.....# $$$$$$$$$$$$$$$$$  #</L>
      <L>##..    .# $               $  #</L>
      <L>#.      .# $ ############  $  ####</L>
      <L>#..      # $ #          #  $$    #########</L>
      <L>##.....  # $ #   $      #   $            #</L>
      <L> #####.. # $ # $$$$$  # #   $$  $$$      #</L>
      <L>      #. # $ #   $    # #    $$$$  $$    #</L>
      <L>    ###. # $ # $ $    # #           $$   #</L>
      <L>  ###... # $ #  $$$$  # #            $ $ #</L>
      <L>  #...   # $ # $ $    # ############ # $ #</L>
      <L> ##.     # $ #  $$$   # $ $   *+.....# $ #</L>
      <L> #..     # $ #                .......# $ #</L>
      <L> #..   ..  $ #################.......# $ #</L>
      <L> ##......  $                 ######### $ #</L>
      <L>  #####..  $$$$$$$$$$$$$$$$$           $ #</L>
      <L>      #.                   $$$$$$$$$$$$$ #</L>
      <L>    ##.                               .  #</L>
      <L>    #..       ..  ......              .  #</L>
      <L>    #.     .#......#####...............  #</L>
      <L>    #.......########   ###################</L>
      <L>    #########                        ###</L>
    </Level>
    <Level Id="morning" Width="34" Height="24">
      <L>              #######</L>
      <L>              #     ##</L>
      <L>              #  $$  ###</L>
      <L>              #   $$   #</L>
      <L>              #    $$  #</L>
      <L>  ###############.  $$ #</L>
      <L>  #          #  #.   $ #</L>
      <L>  #   $  $ $    #.   $ ###########</L>
      <L>  # $$$$$$   ...#.  $$           #</L>
      <L>  #   $  $ # #..#.   $$$$$$$$$$$ #</L>
      <L>  # $ $    # #..#.             $ #</L>
      <L>  #  $$$$$ # #..#...........   $ #</L>
      <L>  # $ $  $ #$##############. $ $ #</L>
      <L>  #  $$$ $ # $ $ $ *+.....#    $ #</L>
      <L>###                .......#. $ $ #</L>
      <L>#   ###############.......#.   $ #</L>
      <L># $ ..............#########.   $ #</L>
      <L># $ ........................$$$$ #</L>
      <L># $$$$$$$..................$$    #</L>
      <L>#       $$   $$$     $    $$ #####</L>
      <L>#######  $ $$$ $$$ $$$$$$$$  #</L>
      <L>      ## $$$     $$$    $    #</L>
      <L>       #     #####           #</L>
      <L>       #######   #############</L>
    </Level>
    <Level Id="sugar" Width="37" Height="26">
      <L>              #############</L>
      <L>              #           #</L>
      <L>        #######    $$$$$  #</L>
      <L>        #       $$$$      #####</L>
      <L>       ##  $$$$$$     #####   ##</L>
      <L>       #  $$      #####   # *  #</L>
      <L>      ##  $  #### # *   * . *# #</L>
      <L>      #  $$  #  ### # ######   #</L>
      <L>      #  $   # .  $   ####  $ #######</L>
      <L>    ### $$   # $#######     # #     #</L>
      <L>    #  $$   ### ###  ## #$### . ### #</L>
      <L>    # $$    #       $ # . *   *#### #</L>
      <L>    # $     #  ####      ## # $ .## #</L>
      <L>    # $     ## ##  # $*.### ####### #</L>
      <L>    # $      # ## $...#..   #  #### #</L>
      <L>    # $      # ##@.####*## $$$      #</L>
      <L>    # $      # ##  #  #  #  #. ######</L>
      <L>    # $   ## # ##$.##### ###  ##</L>
      <L>    # $    ###   $   #    ## ##</L>
      <L>    # $$       #####   ## ## #</L>
      <L>#####  $$$$# *$    ######    #</L>
      <L>#..........#  #### #    ######</L>
      <L>#..........# ##    #</L>
      <L>#..........#    ####</L>
      <L>#..........######</L>
      <L>############</L>
    </Level>
    <Level Id="plum" Width="41" Height="26">
      <L>   ####################################</L>
      <L>   #                                  #</L>
      <L>   #           $$$$$$$$$$$$$$$$$$$$$$ #</L>
      <L> ###  $$$$$$$$$$   .........          #</L>
      <L> #   $$         .....#####..        #####</L>
      <L>##  $$      .....#####   ##....###### ..#</L>
      <L>#  $$  ......#####   # *  #....#     $..#</L>
      <L># $$   .####.# *   * . *# #....# $$$ $..#</L>
      <L># $    .#  ### # ######   #....#   $ $..#</L>
      <L># $    .# .  $   ####  $ ####### $$$.$..#</L>
      <L># $$$$ .# $#######     # #     #   $.$..#</L>
      <L>#    $$### ###  ## #$### . ### # $$$.####</L>
      <L>#              $ # . *   *#### #   $.#</L>
      <L>########  ####      ## # $ .##   $$$.#</L>
      <L>       ## ##  # $*.### ####### #   $.#</L>
      <L>        # ## $...#..   #  #### # $$$.#</L>
      <L>        # ##@.####*## $$$      #.....#</L>
      <L>        # ##  #  #  #  #. ############</L>
      <L>        # ##$.##### ###  ##</L>
      <L>      ###   $   #    ## ##</L>
      <L>      #   #####   ## ## #</L>
      <L>      # *$    ######    #</L>
      <L>      #  #### #    ######</L>
      <L>      # ##    #</L>
      <L>      #    ####</L>
      <L>      ######</L>
    </Level>
    <Level Id="nasty" Width="53" Height="26">
      <L>           #######################################</L>
      <L>    ########..   .......#                        ####</L>
      <L> ####........    .             $$$$$$$$$$$$$$$$$    #</L>
      <L>##....           .     $$$$$$$$$               $$$$ #</L>
      <L>#..              .   $$$                          $ #</L>
      <L>#.             ...   $                            $ #</L>
      <L>#.            ..     $$$$$$$$        $$$$$$$$     $ #</L>
      <L>#..     .......      $      $$$$$$$$$       $    $$ #</L>
      <L>##..   ..                                   $   $$  #</L>
      <L> ##..  .                                    $  $$   #</L>
      <L>  #..  .  ###############################   $  $  ###</L>
      <L>  #### .  #      ##        $ .##        #   $  $$  #</L>
      <L>     # .  # $.$. ##$#.$.*$$.####$#.##.$ #   $   $  #</L>
      <L>     #..  ### # .$ .# # $...##  .  .$$. #   $    $ #</L>
      <L>     #.     # # .# ## ##$#$*##$$##$#  ###   $    $ #</L>
      <L>     #.    ##$#$..*.  *... * .  *  .  #     $    $ #</L>
      <L>     #..   #. * .$$#$ # $#$*.*$$*+*$$ #$$$$$$    $ #</L>
      <L>     ##.   ##                                   $$ #</L>
      <L>      #..   ###########################        $   #</L>
      <L>      ##.                          ...        $$   #</L>
      <L>       #..                         .         $$ ####</L>
      <L>       ##...   ......        ...   .     $$$$$  #</L>
      <L>        ###....#####..     ...#.....    $$      #</L>
      <L>          ######   ##.   ...########            #</L>
      <L>                    #.....###      ##############</L>
      <L>                    #######</L>
    </Level>
    <Level Id="road" Width="35" Height="24">
      <L> ###############################</L>
      <L> #                             #</L>
      <L> # $ $ $ $ $ $ $ $ $ $ $ $ $ $ #</L>
      <L> #  $   $   $   $   $   $   $  #</L>
      <L> # $ $ $ $ $.$.$.$.$.$.$.$.$ $ #</L>
      <L> #      .....##############.   #</L>
      <L> # $ $  .#####            #$ $ #</L>
      <L> #  $   .#     ********** #.$  #</L>
      <L>## $ $...# #*##*  @     * #$ $ #</L>
      <L>#    ..### *     ###### * #.   #</L>
      <L># $ $###   * #####    # * #$ $ #</L>
      <L>#  $.# ****# ###    # # * #.$  #</L>
      <L># $ $#       #  *#**  # * #$ $ #</L>
      <L>#   .## ###### *    * # * #.   #</L>
      <L># $ $.# #   $. * *  * # * #$ $ #</L>
      <L>#  $ .# #   ########  # * #.$  #</L>
      <L># $ $.# ##$##      ##   * #$ $ #</L>
      <L>#    .#       ****   ## * #.   ####</L>
      <L># $ $.#*##.****  ***$ # . #$ $....#</L>
      <L>#  $ .#               #   #.$ ....#</L>
      <L># $ $.################## ##$ $....#</L>
      <L>#    ..................# ........##</L>
      <L>########################      ####</L>
      <L>                       ########</L>
    </Level>
    <Level Id="evelyn" Width="51" Height="27">
      <L>                            ############</L>
      <L>#############################          ##</L>
      <L>#.                                   $  ##</L>
      <L># .                                   $  ##</L>
      <L>#. .                                 $ $  ##</L>
      <L># . .                                 $ $  ##</L>
      <L>#. . .               ##############  $ $ $  ##</L>
      <L># . . .          #####            #   $ $ $  ##</L>
      <L>#. . . .         #   . *.*.*.*.$. #  $ $ $ $  ##</L>
      <L># . . . .        # *$*$$$ $ $ #$* #   $ $ $ $  ##</L>
      <L>#. . . . .     ### *    ####### . #  $ $ $ $ $  ##</L>
      <L># . . . . .  ###   *.####     #$* #   $ $ $ $ $  ##</L>
      <L>#. . . . . . # *$**# #    ##### . #  $ $ $ $ $ $  #</L>
      <L># . . . . . .#       ######   #$* #   $ $ $ $ $ $ #</L>
      <L>#. . . . . . ## ######   #  # # .@   $ $ $ $ $ $  #</L>
      <L># . . . . .   # ###    #   ## #$. #   $ $ $ $ $  ##</L>
      <L>#. . . . .    # ##  #########   . #  $ $ $ $ $  ##</L>
      <L># . . . .     # ## ##      ########   $ $ $ $  ##</L>
      <L>#. . . .      #  .    ****   ##      $ $ $ $  ##</L>
      <L># . . .       #### ####  ##*$ #       $ $ $  ##</L>
      <L>#. . .           #            #      $ $ $  ##</L>
      <L># . .    ###########################  $ $  ##</L>
      <L>#. .     #                         # $ $  ##</L>
      <L># .      #                         #  $  ##</L>
      <L>#.       #                         # $  ##</L>
      <L>##########                         #   ##</L>
      <L>                                   #####</L>
    </Level>
    <Level Id="baila" Width="23" Height="26">
      <L>     ############</L>
      <L>######          #</L>
      <L>#     $$$$$$$$$ #</L>
      <L>#             $ #</L>
      <L>#   ..#####   $ #</L>
      <L>#  ..## . ##  $ #####</L>
      <L>#  .##  *  ## $     #</L>
      <L>#  .#  # *  # $$$$$ #</L>
      <L>#  .# ### # #     $ ###</L>
      <L>#  .#  * *  ####  $   #</L>
      <L># ..##  *  #   ## $$$ #</L>
      <L># .#### # #  #  #   $ #</L>
      <L># .#.@  $   *#* ##  $ #</L>
      <L># .#### #$#* # *.#  $ #</L>
      <L># ....# $   * * ##  $ #</L>
      <L>#  ..## ###  #  #.  $ #</L>
      <L>## .##  *  #   ##.  $ #</L>
      <L> # .#  *.*  ####..  $ #</L>
      <L> # .# #$#$# #...$$$$$ #</L>
      <L> # .#  * *  #.$       #</L>
      <L> # .##  *  ##$  #######</L>
      <L> # ..## . ##.   #</L>
      <L> #  ..# ###.    #</L>
      <L> ##  .. $ $ $   #</L>
      <L>  #             #</L>
      <L>  ###############</L>
    </Level>
    <Level Id="morena" Width="38" Height="36">
      <L>                ####</L>
      <L>                #  #</L>
      <L>              ### $###</L>
      <L>              # $ *  #</L>
      <L>            ###  *  $###</L>
      <L>            # $*   **  #</L>
      <L>          ###  ** **  $###</L>
      <L>          # $*  * *  **  #</L>
      <L>        ###  **  *  **  $###</L>
      <L>        # $*  ** . **  **  #</L>
      <L>      ###  **  ** **  **  $###</L>
      <L>      # $*  **  * *  **  **  #</L>
      <L>    ###  **  **  *  **  **  $###</L>
      <L>    # $*  **  **....*  **  **  #</L>
      <L>  ###  **  ** .**...#.**  **  $###</L>
      <L>  # $*  **  **..*  ##..  **  **  #</L>
      <L>###  **  **  *..#$ ###.$**  **  $###</L>
      <L># $*  **  ** *.     @...  .*   *   #</L>
      <L>#   *   *.  ...$  $ # # **  **  *$ #</L>
      <L>###$  **  ** .### $## #  **  **  ###</L>
      <L>  #  **  **  .# #  #. ##  **  *$ #</L>
      <L>  ###$  **  ..######.  ##  **  #######</L>
      <L>    #  **  **  ####..   ##  *$ #     #</L>
      <L>    ###$  **  ..  ##.$$  ##  ###  $$ #</L>
      <L>      #  **  **  . #..$$  ####    $  #</L>
      <L>      ###$  **  #*$##..$$         $  #</L>
      <L>        #  **  ** $ ##..$$       $$  #</L>
      <L>        ###$  .*  .  ##..$$     $$   #</L>
      <L>          #  *.  * *  ##. $$$ $$$  ###</L>
      <L>          ###$  ** **  #.   $$$    #</L>
      <L>            #  **   *$ #.       ####</L>
      <L>            ###$  *  ###.       #</L>
      <L>              #  * $ #.....######</L>
      <L>              ###$ ###.....#  ##</L>
      <L>                #  # #######</L>
      <L>                ####</L>
    </Level>
    <Level Id="paloma" Width="36" Height="36">
      <L>                ####</L>
      <L>                #  #</L>
      <L>              ### $###</L>
      <L>              # $ *  #</L>
      <L>            ###  *  $###</L>
      <L>            # $*   **  #</L>
      <L>          ###  ** **  $###</L>
      <L>          # $*  * *  **  #</L>
      <L>        ###  **  *  **  $###</L>
      <L>        # $*  ** . **  **  #</L>
      <L>      ###  **  ** **  **  $###</L>
      <L>      # $*  **  * *  **  **  #</L>
      <L>    ###  **  **  *  **  **  $###</L>
      <L>    # $*  **  **....*  **  **  #</L>
      <L>  ###  **  ** .**...#.**  **  $###</L>
      <L>  # $*  **  **..*  ##..  **  **  #</L>
      <L>###  **  **  *..#$ ###.$**  **  $###</L>
      <L># $*  **  ** *.     @...  .*   *   #</L>
      <L>#   *   *.  ...$  $ ### **  **  *$ #</L>
      <L>###$  **  ** .### $## #  **  **  ###</L>
      <L>  #  **  **  .# #  #  ##  **  *$ #</L>
      <L>  ###$  **  ..######   ##  **  ###</L>
      <L>    #  **  **  ####     ##  *$ #</L>
      <L>    ###$  **  ..  ##     ##  ###</L>
      <L>      #  **  **  . #      ####</L>
      <L>      ###$  **  #*$##</L>
      <L>        #  **  ** $ ##</L>
      <L>        ###$  .*  .  ##</L>
      <L>          #  *.  * *  ##</L>
      <L>          ###$  ** **  #</L>
      <L>            #  **   *$ #</L>
      <L>            ###$  *  ###</L>
      <L>              #  * $ #</L>
      <L>              ###$ ###</L>
      <L>                #  #</L>
      <L>                ####</L>
    </Level>
    <Level Id="blanca" Width="42" Height="28">
      <L>   #####################################</L>
      <L>   #                                   #</L>
      <L>   #    $$$$ $$$$$   $$$$$$$$$$$$      #</L>
      <L>   #   $$  $$$   $$$$           $$$$   #</L>
      <L>  ## $$$.                          $   #</L>
      <L>  #  $  ..........        ......   $   #</L>
      <L>  #  $  ....#####..........####.   $$  #</L>
      <L>  #  $  ....#   ############  #.    $$ #</L>
      <L>  #  $$ ....#                 #.    $  #</L>
      <L>  #   $ ....## ## ########### #...  $  #</L>
      <L>  #   $ ..###   #  #   ##   # ###.  $$ #</L>
      <L>  #  $$ ..# . $  # $$#. $ #$$   #.   $ ###</L>
      <L>  #  $  ..#$.*.$ #   #... #.$$* #.    $  #</L>
      <L>### $$  *.# .$$* #*.*#.$###. #. #.    $  #</L>
      <L>#    $  .##$.$ .#.$ . . $. .$$.##..  $$  #</L>
      <L># $  $$$.# $..* # .*.#.*.$# ...###.  $   #</L>
      <L># $$   $$# $$ $## $$$# $  #  #*  #.  $   #</L>
      <L>#  $$          @#  # # $#$##*.$  #.  $$  #</L>
      <L>#   $$   ###### ##   #    #  #####.   $  #</L>
      <L>#    $  ......# ########### ##.....   $  #</L>
      <L>#    $$ ......#             #......  $$  #</L>
      <L>#     $ ......###############...    $$   #</L>
      <L>##### $$$$$.................... $$$$$    #</L>
      <L>    #     $$      $........... $$     ####</L>
      <L>    #####  $$$$$$$$$$$$  $$$$ $$ ######</L>
      <L>        ##            $$$$  $$$  #</L>
      <L>         ############            #</L>
      <L>                    ##############</L>
    </Level>
  </LevelCollection>
</SokobanLevels>
