<?xml version="1.0" encoding="utf-8"?>
<SokobanLevels xmlns:xsi="http://www.w3.org/2001/XMLSchema-instance" xsi:schemaLocation="SokobanLev.xsd">
  <Title>Soundextensions and Circles</Title>
  <Description>
A sound has always an extension, like &quot;.WAV&quot; or &quot;.WMA&quot; or &quot;.MIDI&quot;.
Difficulty: From simple to mediate. Circles: Very easy.
  </Description>
  <Email>willemmaartendekker@hetnet.nl</Email>
  <LevelCollection Copyright="W. M. Dekker" MaxWidth="61" MaxHeight="61">
    <Level Id=".WAV" Width="46" Height="15">
      <L>##############################################</L>
      <L>#   #######  #  ### ###    ###    ############</L>
      <L>#   #.  ###  .  ###  .#  $ #.# $$ #.  ###  .##</L>
      <L>#   ##.  #  .#.  #  .## $ ##.## $ ##*  #  *###</L>
      <L>#   @#.$ # $.#.$ # $.#  $ #. .#    #.  #  .# #</L>
      <L>#    ##.   .###. $ .## $ ##.$.## $ ##* $ *## #</L>
      <L>#     #.   .# #.   .#    #. $ .# $  #.   .#  #</L>
      <L>#  $ $##. .## ##.$.## $ ##.#$ .##   ##. .##  #</L>
      <L>####   #. .#   #. .# $  #.......# $  #. .# $ #</L>
      <L>#**# $ ##.##   ##.##   ##.$ $ $.## $ ##.## $ #</L>
      <L>#.*# $$ #.# $ $ #.# $$ #.       .# $  #.#  $ #</L>
      <L># ## $  ### $ $ # # $  ##### ##### $  # #  $ #</L>
      <L>#    $ $ $ $ $ $ $ $ $ $ $ $ $ $ $ $ $ $ $ $ #</L>
      <L>#                                            #</L>
      <L>##############################################</L>
    </Level>
    <Level Id=".MIDI" Width="46" Height="26">
      <L>##############################################</L>
      <L>#     ##################### @#################</L>
      <L>#     #.  #  .#   #...#   #......####   #...##</L>
      <L>#     #.* $ *. #  # . #   #.$ $  .###   # . ##</L>
      <L>#     #.$. *#. #  # . #   #*###$ #.##   # . ##</L>
      <L>#     #.##. $.#   ##.##   #.# #  $ .#   ##.###</L>
      <L>#     #.#####.#   ##.##   #.# #  $ .#   ##.###</L>
      <L>####  #.#   #.#   # . #   #*###  #.##   # . ##</L>
      <L>#**#  #*#####.#   # . #   #.  $  .###   # . ##</L>
      <L>#.*#  #.#   #.#   #...#   #.*....####   #...##</L>
      <L># ##  ###   # #   ## ##   ## ########   ## ###</L>
      <L>#                                          # #</L>
      <L>#           #  #####  #### #  ########     # #</L>
      <L>########################## ########  #  #### #</L>
      <L>#  ##   #  #                         #  #    #</L>
      <L>#   *   #  #  ############ ##### ### ## #    #</L>
      <L># *### ##  ## #          # #   # ## $   #    #</L>
      <L>##  ## ###### # $$$ $$$$$# *   # ## ### ######</L>
      <L>### ##        # $ $ $ $  ####*## ## ### ##  ##</L>
      <L>##  ##### ##  # $ $ $ $ $ ###  #   $ ##     ##</L>
      <L>##$ ##### ####### $ $ $ $ #    # #   #####  ##</L>
      <L>##  # #  $  $ $ $ $ $ $ $ $ #  # ## ######*###</L>
      <L>##$ $     # $ $ $ $ $ $ $ $ ####         # ###</L>
      <L>#        ## $ $ $ $ $ $ $ $    # $ $ $ # *  ##</L>
      <L>#        #                     ##  ######   ##</L>
      <L>##############################################</L>
    </Level>
    <Level Id=".CDA" Width="46" Height="15">
      <L>##############################################</L>
      <L>##############################################</L>
      <L>#          #####   # @########        #.#    #</L>
      <L>#   $$####*.*..# $$#......####     $ ##*##$$ #</L>
      <L>#     ###.  ## #   #.$ $  .###     $  .$.    #</L>
      <L>#   # ##.$  ## # $$#*###$ #.##      ##.$.##  #</L>
      <L>#     #.$  ##  #   #.# #  $ .#      #.$  .#  #</L>
      <L>#    $#.$ ## $ # $$#.# #  $ .#     ##.$ $.## #</L>
      <L>####  ##.   $  #   #*###  #.##     #.......# #</L>
      <L>#**#  ## .#   ## $$#.  $  .###    ##.$$ $$.# #</L>
      <L>#.*#  ####..*..#   #.*....####    #*  # #  .##</L>
      <L># ##  #####  ###  $## ########     #### ######</L>
      <L>#    $ $ $ $ $ $  $ $  $ $ $ $   $ $ $ $ $ $ #</L>
      <L>#                                            #</L>
      <L>##############################################</L>
    </Level>
    <Level Id=".MP3" Width="46" Height="15">
      <L>##############################################</L>
      <L>##############################################</L>
      <L>#     #.  #  .#     #.....  #     #....  #   #</L>
      <L>#   $$#.* $ *. # $$$#.    .  #    #####*  #  #</L>
      <L>#     #.$. *#. #    #.##   . #    ##### . #  #</L>
      <L>#   $$#.##. $.#  $$$#.#####.#     #####* #   #</L>
      <L>#     #.#####.#     #.##  . #     #..*.  #$$ #</L>
      <L>#    $#.#   #.#  $$$#.....  #  @  #####. #   #</L>
      <L>####  #*# $$#.#$    #*###   #     ######*#$$ #</L>
      <L>#**#  #.#   #.#  $$$#.#   ###     #####. #   #</L>
      <L>#.*#  #.# $$#.#$    #.#   ###     #.*..  #$$ #</L>
      <L># ## $###   # #     #### ####     #####  #   #</L>
      <L>#    $ $ $ $ $ $ $ $ $ $ $ $ $ $ $ $ $ $ $ $ #</L>
      <L>#                                            #</L>
      <L>##############################################</L>
    </Level>
    <Level Id=".WMA" Width="46" Height="15">
      <L>##############################################</L>
      <L>###########  #################################</L>
      <L>#####.  ###  .  ###  .# #.  #  .#     #.#    #</L>
      <L>######.  #  .#.  #  .## #.* $ *. # $ ##*##$$ #</L>
      <L>#   @#.$ # $.#.$ # $.#  #.$. *#. # $  .$.    #</L>
      <L>#    ##. $ .###. $ .##  #.##. $.#   ##.$.##  #</L>
      <L>#  $  #. $ .# #. $ .# $ #.#####.# $ #.$  .#  #</L>
      <L>#  $ $##.$.## ##.$.## $ #.#   #.# $##.$ $.## #</L>
      <L>####   #. .#   #. .#  $ #*#$$ #.#  #.......# #</L>
      <L>#**# $ ##*##   ##.## $  #.#   #.# ##.$$ $$.# #</L>
      <L>#.*#  $ #.# $ $ #.#  $ $#.#$$ #.# #*  # #  .##</L>
      <L># ## $  ### $ $ # #  $  ###   # #  #### ######</L>
      <L>#    $ $ $ $ $ $ $ $ $ $ $ $ $ $ $ $ $ $ $ $ #</L>
      <L>#                                            #</L>
      <L>##############################################</L>
    </Level>
    <Level Id="Circel 1" Width="56" Height="53">
      <L>                 ##############################</L>
      <L>                #                              #</L>
      <L>               #  ############################  #</L>
      <L>              #  #                            #  #</L>
      <L>             #  #  ##########################  #  #</L>
      <L>            #  #  #                          #  #  #</L>
      <L>           #  #  #  ########################  #  #  #</L>
      <L>          #  #  #  #                        #  #  # #</L>
      <L>         #  #  #  #  ######################  #  # #  #</L>
      <L>        #  #  #  #  #                      #  # #  # #</L>
      <L>       #  #  #  #  #  ####################  # #  # #  #</L>
      <L>      #  #  #  #  #  #                    # #  # #  #  #</L>
      <L>     #  #  #  #  #  #  ################## #  # #  #  # #</L>
      <L>     # #  #  #  #  #  #                 #  # #  #  # # #</L>
      <L>    #  # #  #  #  #  #  ###############  # #  #  # # # #</L>
      <L>   #  #  # #  #  #  #  #               # #  #  # # # # #</L>
      <L>   # #  #  # #  #  #  #  ############# #  #  # # # # # #</L>
      <L>   # # #  #  # #  #  #  #            #  #  # # # # # # #</L>
      <L>   # # # #  #  # #  #  #  ##########  #  # # # # # # # #</L>
      <L>   # # # # #  #  # #  #  #          #  # # # # # # # # #</L>
      <L>   # # # # # #  #  # #  #  ########  # # # # # # # # # #</L>
      <L>   # # # # # # #  #  # #  ##       # # # # # # # # # # #</L>
      <L>   # # # # # # # #  #  # #   ##### # # # # # # # # # # #</L>
      <L>   # # # # # # # # #  #  # ###   # # # # # # # # # # # #</L>
      <L>   # # # # # # # # # #  #  #@$ # # # # # # # # # # # # #</L>
      <L>   # # # # # # # # # # #  #  #.# # # # # # # # # # # # #</L>
      <L>   # # # # # # # # # # # #  #### # # # # # # # # # # # #</L>
      <L>   # # # # # # # # # # #   #  #  # # # # # # # # # # # #</L>
      <L>   # # # # # # # # # #  ###     #  # # # # # # # # # # #</L>
      <L>   # # # # # # # # #  #     ####  ## # # # # # # # # # #</L>
      <L>   # # # # # # # #  #  #####     #   # # # # # # # # # #</L>
      <L>   # # # # # # #  #  #       ####  ##  # # # # # # # # #</L>
      <L>   # # # # # #  #  #  #######     #   #  # # # # # # # #</L>
      <L>   # # # # #  #  #  #         ####  ##  #  # # # # # # #</L>
      <L>   # # # #  #  #  #  #########     #   #  #  # # # # # #</L>
      <L>   # # #  #  #  #  #           ####  ##  #  #  # # # # #</L>
      <L>   # #  #  #  #  # ############     #   #  #  #  # # # #</L>
      <L>####  #  #  #  # #              ####  ##  #  #  #  # # #</L>
      <L>#   #  #  #  # #  ##############     #   #  #  #  #  # #</L>
      <L># #  #  #  # #  #                ####  ##  #  #  #  #  #</L>
      <L>#  #  #  # #  #  ################     #   #  #  #  #  #</L>
      <L> #  #  # #  #  #                  ####  ##  #  #  #  #</L>
      <L>  #  # #  #  #  ##################     #   #  #  #  #</L>
      <L>   # #  #  #  #                    ####  ##  #  #  #</L>
      <L>   #  #  #  #  ####################     #   #  #  #</L>
      <L>    #  #  #  #                      ####  ##  #  #</L>
      <L>     #  #  #  ######################     #   #  #</L>
      <L>      #  #  #                        ####  ##  #</L>
      <L>       #  #  ########################     #   #</L>
      <L>        #  #                          ####  ##</L>
      <L>         #  ##########################     #</L>
      <L>          #                            ####</L>
      <L>           ############################</L>
    </Level>
    <Level Id="Circel 2" Width="61" Height="61">
      <L>                          #########</L>
      <L>                     #####    #    #####</L>
      <L>                 ####      ## #         ####</L>
      <L>                #     ######  # #######     #</L>
      <L>             #### ####       ## #      #### ####</L>
      <L>            #     #    ######   # ####    #     #</L>
      <L>          ### ####  ###       ##  #   ###  #### ###</L>
      <L>         #    #    #    ######   #  #    #    #    #</L>
      <L>         # ###  ###  ###       ##  # ###  ###  ### #</L>
      <L>       ### #   #    #    ######   #     #    #   # ###</L>
      <L>      #    # ##  ###  ###        #  ###  ###  ## #    #</L>
      <L>      # ###  #  #    #    #######  #   #    #  #  ### #</L>
      <L>     ## #   #  #  ###  ###        #  #  ###  #  #   # ##</L>
      <L>    #   # ##  #  #    #    #######  # #    #  #  ## #   #</L>
      <L>    # ##  #  #  #  ###  ###        #   ###  #  #  #  ## #</L>
      <L>    # #  #  #  #  #    #    #######  #    #  #  #  #  # #</L>
      <L>   ## # #  #  #  #  ###  ###        # ###  #  #  #  # # ##</L>
      <L>  #   # # #  #  #  #    #    #######     #  #  #  # # #   #</L>
      <L>  # ##  # # #  #  #  ###  ###        ###  #  #  # # #  ## #</L>
      <L>  # #  #  # # #  #  #    #    #######   #  #  # # #  #  # #</L>
      <L>  # # #  #  # # #  #  ###  ###        #  #  # # #  #  # # #</L>
      <L> #  # # #  #  # # #  #    #    ####### #  # # #  #  # # #  #</L>
      <L> # #  # # #  #  # # #  ###  ###         # # #  #  # # #  # #</L>
      <L> # # #  # # #  #  # # #    #    ####### # #  #  # # #  # # #</L>
      <L> # # # #  # # #  #  # # ###  ##     # # #  #  # # #  # # # #</L>
      <L> # # # # #  # # #  #  # #   #     ### #  #  # # #  # # # # #</L>
      <L>#  # # # # #  # # #  #  # ##      #    #  # # #  # # # # #  #</L>
      <L># #  # # # # #  # # #  #  ###  ####  #  # # #  # # # # #  # #</L>
      <L># # #  # # # # #  # # #  # ###   #*#  # # #  # # # # #  # # #</L>
      <L># # # #  # # # # #  # # #  # $ # #**# # #  # # # # #  # # # #</L>
      <L># # # # #  # # # # #  #  ##  #.###**# #  # # # # #  # # # # #</L>
      <L># # # # #  # # # #  #  #@#  #### #**# # #  # # # # #  # # # #</L>
      <L># # # #  # # # #  #  # #  #   #  #. $ # # #  # # # # #  # # #</L>
      <L># # #  # # # #  #  # # ####     # #  #  # # #  # # # # #  # #</L>
      <L># #  # # # #  #  # # #  #   ####### #  #  # # #  # # # # #  #</L>
      <L>#  # # # #  #  # # #  #  #  #  #    # #  #  # # #  # # # # #</L>
      <L> # # # #  #  # # #  #  # ##  ##  ###  # #  #  # # #  # # # #</L>
      <L> # # #  #  # # #  #  # #   #    ##   #  # #  #  # # #  # # #</L>
      <L> # #  #  # # #  #  # # ###  ####   ##   # # #  #  # # #  # #</L>
      <L> #  #  # # #  #  # # #    #      ##   ##  # # #  #  # # #  #</L>
      <L> ##  # # #  #  # # #  ###  ### ##   ##   #  # # #  #  # # #</L>
      <L>   # # #  #  # # #  #    #    #   ##   ##  #  # # #  #  # #</L>
      <L>   # #  #  # # #  #  ###  ###   ##   ##   #  #  # # #  ## #</L>
      <L>   #  #  # # #  #  #    #    ###   ##   ##  #  #  # # #   #</L>
      <L>   ##  # # #  #  #  ###  ###     ##   ##   #  #  #  # # ##</L>
      <L>     # # #  #  #  #    #    #####   ##   ##  #  #  #  # #</L>
      <L>     # #  #  #  #  ###  ###       ##   ###  #  #  #  ## #</L>
      <L>     #  #  #  #  #    #    #######   ##    #  #  ## #   #</L>
      <L>     ##  #  #  #  ###  ###         ###  ###  #  #   # ##</L>
      <L>       # ##  #  #    #    #########    #    #  #  ### #</L>
      <L>       #   #  #  ###  ###           ###  ###  ## #    #</L>
      <L>       ###  #  #    #    ##### #####    #    #   # ###</L>
      <L>          # ##  ###  ###      #      ###  ###  ### #</L>
      <L>          #   #    #    #####   #####    #    #    #</L>
      <L>          ###  ###  ###      ###      ###  ###  ###</L>
      <L>             #    #    #####     #####    #    #</L>
      <L>             ####  ###      #####      ###  ####</L>
      <L>                 #    #####       #####    #</L>
      <L>                 ####      #######      ####</L>
      <L>                     #####         #####</L>
      <L>                          #########</L>
    </Level>
  </LevelCollection>
</SokobanLevels>
