<?xml version="1.0" encoding="utf-8"?>
<SokobanLevels xmlns:xsi="http://www.w3.org/2001/XMLSchema-instance" xsi:schemaLocation="SokobanLev.xsd">
  <Title>Zbigniew Kornas</Title>
  <Description>
This Sokoban level set is published here with the author's permission.
The level set is distributed in a text format, that can be imported by
most of the major Sokoban programs. For Microsoft Windows we recommend
using Sokoban YASC, which can be downloaded from:
http://sourceforge.net/projects/sokobanyasc/ Enjoy!
  </Description>
  <Email>zkornas@tlen.pl</Email>
  <Url>http://www.sokoban.republika.pl/</Url>
  <LevelCollection Copyright="Zbigniew Kornas" MaxWidth="19" MaxHeight="16">
    <Level Id="The house (#001)" Width="19" Height="15">
      <L>      #######</L>
      <L>     ##     ##</L>
      <L>    ##  $ $$ ##</L>
      <L>   ## $  $$ $ ##</L>
      <L>  ##    #$   $ ##</L>
      <L> ##    ##  #  $ ##</L>
      <L>##    ##  ###    ##</L>
      <L>####$##  ##########</L>
      <L>  #             #</L>
      <L>  # ### ### ### #</L>
      <L>  # # # #@# # # #</L>
      <L>  # ### # # ### #</L>
      <L>  #     # #     #</L>
      <L>  #...  ........#</L>
      <L>  ###############</L>
    </Level>
    <Level Id="My fiancee (Beata) (#002)" Width="17" Height="16">
      <L>###############</L>
      <L>#             #</L>
      <L>####  ### ###$#</L>
      <L># # #$#   # # ##</L>
      <L># ##  ##  ###  #</L>
      <L># # # #   #@#$ ##</L>
      <L># ##  ###$# #   #</L>
      <L>#   $    $    # #</L>
      <L>#.....###$### $ #</L>
      <L>#.#.#. #  # # ###</L>
      <L>#..... #$ ###$##</L>
      <L>#.#.## #  # #  #</L>
      <L>#.$  $ #$ # #$ #</L>
      <L>##  #$    $    #</L>
      <L> ####   ##   ###</L>
      <L>    ##########</L>
    </Level>
    <Level Id="The horn (#003)" Width="13" Height="12">
      <L>   ######</L>
      <L>   #    ##</L>
      <L>####  $  #</L>
      <L># $  $ $ #</L>
      <L># $ $  ###</L>
      <L># $## #######</L>
      <L>#   # ..... #</L>
      <L># $  #####. #</L>
      <L>## $   ###.##</L>
      <L> ## $ $....#</L>
      <L>  ##   ##@ #</L>
      <L>   #########</L>
    </Level>
    <Level Id="Tulip (#004)" Width="14" Height="12">
      <L> ############</L>
      <L> #  ##..##  #</L>
      <L> #  #....#  #</L>
      <L> #  ......  #</L>
      <L> ##  #..   ##</L>
      <L>####### ######</L>
      <L>#   $  $     #</L>
      <L># $ ##$ $#$$ #</L>
      <L>### #     $  #</L>
      <L> #@$ $$$$$# ##</L>
      <L> #          #</L>
      <L> ############</L>
    </Level>
    <Level Id="Stage #005" Width="12" Height="12">
      <L>#######</L>
      <L>#     #####</L>
      <L># ###$#   ##</L>
      <L>#@# # $  $ #</L>
      <L># ###  ##  #</L>
      <L>#...# $## ##</L>
      <L>#...#     #</L>
      <L>##.$$$ ####</L>
      <L> #.  $ #</L>
      <L> ####  #</L>
      <L>    #  #</L>
      <L>    ####</L>
    </Level>
    <Level Id="Stage #006" Width="15" Height="12">
      <L>           ####</L>
      <L>############  #</L>
      <L>#.... ##      #</L>
      <L>#.*..    $ $  #</L>
      <L>#..* ####$$####</L>
      <L>##.#       $ #</L>
      <L>#..# ####$## #</L>
      <L># $$ $   @#  #</L>
      <L>#  # # $$##$ #</L>
      <L>######       #</L>
      <L>     ###  ####</L>
      <L>       ####</L>
    </Level>
    <Level Id="7 and 8 points (#007)" Width="19" Height="15">
      <L> #################</L>
      <L>## ............$ #</L>
      <L>#  .###########  #</L>
      <L>#  .#    $    $  #</L>
      <L>## .# $ $ $ $ #$ #</L>
      <L> # .#  $ $ $  #  #</L>
      <L> # .# $ $$$ $ #  #</L>
      <L> # .#$ $ $ $ $#. #</L>
      <L> # .# $ $$$ $ #. #</L>
      <L> #  #  $ $ $  #. #</L>
      <L> # $# $ $@$ $ #. ##</L>
      <L> #  $    $    #.  #</L>
      <L> #  ###########.  #</L>
      <L> # $............ ##</L>
      <L> #################</L>
    </Level>
    <Level Id="My wife (Beata arranged) (#008)" Width="16" Height="16">
      <L> ##############</L>
      <L> #            #</L>
      <L>####  ### ### #</L>
      <L># # # #   # #$##</L>
      <L># ##  ##  ###  #</L>
      <L># # # #   # #  #</L>
      <L># ##  ###$# #  #</L>
      <L>#  $$$   $   $##</L>
      <L>#.*...###$### #</L>
      <L>#.#.#. #  # #@#</L>
      <L>#....* #$ ### ##</L>
      <L>#.#.## #  # #$ #</L>
      <L>#.*    #$ # #  #</L>
      <L>##  #$ $     $ #</L>
      <L> ####   ##   ###</L>
      <L>    ##########</L>
    </Level>
    <Level Id="Stage #009" Width="13" Height="13">
      <L>         ####</L>
      <L>  ########  #</L>
      <L>### ........#</L>
      <L># $$.######.#</L>
      <L># #  #  ###.#</L>
      <L>#   #####  .#</L>
      <L>###     $ #.#</L>
      <L>  # $ $# ## #</L>
      <L>  #$@$ $  # #</L>
      <L>  # $#  $ $ #</L>
      <L>  #  $ $#####</L>
      <L>  #     #</L>
      <L>  #######</L>
    </Level>
    <Level Id="Stage #010" Width="15" Height="12">
      <L>          #####</L>
      <L>############  #</L>
      <L>#...........  #</L>
      <L># ###.####..  #</L>
      <L># $ $  $ ##. ##</L>
      <L>##   $ $   # ##</L>
      <L> #$$   # $$ $ #</L>
      <L> # ######@$   #</L>
      <L> #   $ # $ ####</L>
      <L> # $  $    #</L>
      <L> #   #######</L>
      <L> #####</L>
    </Level>
    <Level Id="The first twin (#011)" Width="15" Height="14">
      <L>   ############</L>
      <L>   #..*.... . #</L>
      <L> ###  ###..$. #</L>
      <L> #  $ #  #.#.##</L>
      <L>##  $ #  $$#.#</L>
      <L>#   # ## @ #.#</L>
      <L># $$$ $ # ##.#</L>
      <L># $  $  # ##.#</L>
      <L>#  #$# ##$##.#</L>
      <L># $    $  $  #</L>
      <L>## ######  ###</L>
      <L>#        $ #</L>
      <L>#   ####  ##</L>
      <L>#####  ####</L>
    </Level>
    <Level Id="The second twin (#012)" Width="15" Height="14">
      <L>   ############</L>
      <L>   #..*...... #</L>
      <L> ###  ###..$. #</L>
      <L> #  $ #  #.#.##</L>
      <L>##  $ #  $$#.#</L>
      <L>#   # ## @ #.#</L>
      <L># $$$ $ # ##.#</L>
      <L># $  $  # ##.#</L>
      <L>#  #$$ ##$##.#</L>
      <L># $    $  $  #</L>
      <L>## ######  ###</L>
      <L>#        $ #</L>
      <L>#   ####  ##</L>
      <L>#####  ####</L>
    </Level>
    <Level Id="Twins - yet one stage (#013)" Width="15" Height="14">
      <L>   ############</L>
      <L>   #......... #</L>
      <L> ###$.###..$. #</L>
      <L> #    #  # #.##</L>
      <L>##$ $ #   $#.#</L>
      <L>#  $#$## $ #.#</L>
      <L># $     #@##.#</L>
      <L>#  $ $  # # .#</L>
      <L>#  #$#$##$#$.#</L>
      <L># $    $  $  #</L>
      <L>## ######  ###</L>
      <L>#        $ #</L>
      <L>#   ####  ##</L>
      <L>#####  ####</L>
    </Level>
    <Level Id="Stage #014" Width="16" Height="12">
      <L> #######</L>
      <L> #  #  ########</L>
      <L> #  $  *...*..#</L>
      <L> # $# .*..*.. #</L>
      <L>##$  ######## ##</L>
      <L># $   #   ###  #</L>
      <L>#  $  #  $     #</L>
      <L># # ### $ ######</L>
      <L># #    # $ #@ #</L>
      <L># $ # $       #</L>
      <L>#   #  ########</L>
      <L>########</L>
    </Level>
    <Level Id="Ending crown deed (#015)" Width="13" Height="12">
      <L>############</L>
      <L>#    ##   @##</L>
      <L># #  .*$**..#</L>
      <L># $  #...**.#</L>
      <L>##   # ### ##</L>
      <L>#####  ### ##</L>
      <L>#   #$   #  #</L>
      <L># # # $  #  #</L>
      <L>#  $  ####$ #</L>
      <L>## #$       #</L>
      <L> #   #   #  #</L>
      <L> ############</L>
    </Level>
    <Level Id="Robin (#016)" Width="16" Height="15">
      <L>########</L>
      <L>#   #  # ######</L>
      <L># $ #  ###    #</L>
      <L>#   #... $$## ##</L>
      <L># $ #..#   $@$ #</L>
      <L>###.#..##$$#$  #</L>
      <L>#  .*..#   $ $##</L>
      <L># #*#*## $    #</L>
      <L># #.#..#   #$$#</L>
      <L>#  .*..# $$   #</L>
      <L># $.#..# $    #</L>
      <L>#  ###.####$###</L>
      <L>#  # $     $ #</L>
      <L>####    ##   #</L>
      <L>   ###########</L>
    </Level>
    <Level Id="Stage #017" Width="11" Height="10">
      <L> ######</L>
      <L> #    ###</L>
      <L> # #    #</L>
      <L> #  *** ###</L>
      <L>#####@* . #</L>
      <L>#   *** # #</L>
      <L>#       # #</L>
      <L>#####$### #</L>
      <L>    #     #</L>
      <L>    #######</L>
    </Level>
    <Level Id="Three Points (#018)" Width="15" Height="13">
      <L>     ######</L>
      <L>######    ####</L>
      <L>#  # $$ $    #</L>
      <L>#        ##  #</L>
      <L>#  ######## ###</L>
      <L>## #      $$$ #</L>
      <L> # #  $  #..  #</L>
      <L> # ## $###.#  #</L>
      <L>##$###.# ..####</L>
      <L>#...#..# $$  #</L>
      <L>#.. $..$$@#$ #</L>
      <L>##     #     #</L>
      <L> #############</L>
    </Level>
    <Level Id=":-) For you !!! (#019)" Width="17" Height="11">
      <L>##### ##### #####</L>
      <L>#   ###   ###   #</L>
      <L># # $  .$.  $ # #</L>
      <L>#  *.* # # *.*  #</L>
      <L>###$@* # # * $#.#</L>
      <L>#  *.* # # *.*  #</L>
      <L>#   $  # #  $   #</L>
      <L>## #*### ###*# ##</L>
      <L> ##           ##</L>
      <L>  ###  ###  ###</L>
      <L>    #### ####</L>
    </Level>
    <Level Id="Stage #020" Width="8" Height="8">
      <L> #######</L>
      <L> #  .  #</L>
      <L> #$#*# #</L>
      <L>## $@$ #</L>
      <L>#  *.* #</L>
      <L># # #  #</L>
      <L>#   .  #</L>
      <L>########</L>
    </Level>
    <Level Id="Stage #021" Width="11" Height="11">
      <L> ########</L>
      <L> #   #  #</L>
      <L> # #$#$ #</L>
      <L> #  .*. ###</L>
      <L> ##.*@* $ #</L>
      <L>  # .*. # #</L>
      <L>### $ $ # #</L>
      <L>#   ##### #</L>
      <L># #       #</L>
      <L>#   #######</L>
      <L>#####</L>
    </Level>
    <Level Id="The Hard Nut (#022)" Width="13" Height="13">
      <L>      ####</L>
      <L> ######  #</L>
      <L> #       ###</L>
      <L>## #####.  ##</L>
      <L>#.$....*.#$ #</L>
      <L>#.*.. ## #  #</L>
      <L>#...##   $  #</L>
      <L># #$ $$ ##$ #</L>
      <L># $ @#   # ##</L>
      <L># $#$# $$$  #</L>
      <L>#    #    # #</L>
      <L>#   ####    #</L>
      <L>#####  ######</L>
    </Level>
    <Level Id="Stage #023" Width="13" Height="11">
      <L>#############</L>
      <L>#  ##   #   #</L>
      <L>#  ## # $$$ #</L>
      <L>#   $$  $ # #</L>
      <L>#  #    # $ #</L>
      <L>##$##$#$# $@#</L>
      <L>#.......# ###</L>
      <L># $...... #</L>
      <L># #####$###</L>
      <L>#       #</L>
      <L>#########</L>
    </Level>
    <Level Id="Stage #024" Width="16" Height="12">
      <L>   ##########</L>
      <L>   #    #   #</L>
      <L> ###$# $ @$ #</L>
      <L> #     $ #$####</L>
      <L> # # ##  #  $ #</L>
      <L> # #  $$##    #</L>
      <L>## ####..## # ##</L>
      <L>#  #.....# $$  #</L>
      <L># $$*.##.# $   #</L>
      <L>#  #.....  $# ##</L>
      <L>####  #  #    #</L>
      <L>   ############</L>
    </Level>
    <Level Id="Stage #025" Width="16" Height="13">
      <L> ###########</L>
      <L> #  ##...$.#</L>
      <L> #  *....*.#####</L>
      <L> #  $..#....   #</L>
      <L> ##  ### #.### #</L>
      <L>### ###  #$  # #</L>
      <L># $ #   $  $ # #</L>
      <L># # $$$  ##  # #</L>
      <L>#   # $$####$# #</L>
      <L>##### $ $ $  $ #</L>
      <L>    #   #   ####</L>
      <L>    ###@  ###</L>
      <L>      #####</L>
    </Level>
    <Level Id="The uggy duckling (#026)" Width="16" Height="14">
      <L>         ######</L>
      <L>  #####  #   .#</L>
      <L>  #   ####$$#.#</L>
      <L> ##....$     .#</L>
      <L> #  $$#$ ####.#</L>
      <L>## $#   $  $  ##</L>
      <L>#   $$# $#.$...#</L>
      <L># $ #     .#.$.#</L>
      <L>## $#$####.#.###</L>
      <L>#   # $ ##.#.#</L>
      <L># # #   $ ...#</L>
      <L>#   # $## $$ #</L>
      <L>##### @##  ###</L>
      <L>    ########</L>
    </Level>
    <Level Id="Stage #027" Width="16" Height="14">
      <L>         #####</L>
      <L>##########@  #</L>
      <L>#    #    $# #</L>
      <L># ## # $$  $ #</L>
      <L># #     # $# #</L>
      <L># $$ ####  $ ###</L>
      <L>###  #   $ $   #</L>
      <L>###*$#  $ # $$ #</L>
      <L>#... ### #### ##</L>
      <L>#.....    #   #</L>
      <L>#.*####   # ###</L>
      <L>#.....##### #</L>
      <L>#####       #</L>
      <L>    #########</L>
    </Level>
    <Level Id="Stage #028" Width="15" Height="13">
      <L>#########</L>
      <L>#  ##   ######</L>
      <L>#     $ ##   #</L>
      <L># $#$# ##  $ #</L>
      <L>##  $@$   $# ##</L>
      <L> #$ #$$$$$    #</L>
      <L> #  ..#. $  $ #</L>
      <L> # $..#.### ###</L>
      <L> ###..*..$ $#</L>
      <L>  ##.###.#  #</L>
      <L>  # .* *.  $#</L>
      <L>  # .....#  #</L>
      <L>  ###########</L>
    </Level>
    <Level Id="Stage #029" Width="15" Height="16">
      <L>        ####</L>
      <L>  #######..##</L>
      <L>  #     $...##</L>
      <L>  #   ###....#</L>
      <L>#### #   ##*.#</L>
      <L>#  # #$# .*..#</L>
      <L># $$ # $ ....#</L>
      <L>#  # #@$# #####</L>
      <L>## # #  # #   #</L>
      <L> # # $$$$$    #</L>
      <L> # #    $   $ #</L>
      <L> # ####### ####</L>
      <L> #         #</L>
      <L> # $$$  #$##</L>
      <L> #   #    #</L>
      <L> ##########</L>
    </Level>
    <Level Id="Stage #030" Width="14" Height="13">
      <L>######  ######</L>
      <L>#  ..####    #</L>
      <L># #.....  $# #</L>
      <L># $..##$# $  #</L>
      <L># #.....# #  #</L>
      <L># ####$ # $$ #</L>
      <L>#  $  @## #  #</L>
      <L>###$##  # ####</L>
      <L>  #   $ # ##</L>
      <L>  #$$ $  $ #</L>
      <L>  #    # # #</L>
      <L>  ######   #</L>
      <L>       #####</L>
    </Level>
    <Level Id="Stage #031" Width="15" Height="15">
      <L>         #####</L>
      <L>   #######.  #</L>
      <L>   # ..*.*.# #</L>
      <L>   # .*.*.*# #</L>
      <L> ####.#    # #</L>
      <L>##  #.###@ # ##</L>
      <L>#  $ ..###$#  #</L>
      <L># $ #..    $  #</L>
      <L># #$##.#####$ #</L>
      <L># $ #   #    ##</L>
      <L>#     $ $ $# #</L>
      <L>##$##$ $#$ # #</L>
      <L>#   $        #</L>
      <L>#   ##########</L>
      <L>#####</L>
    </Level>
    <Level Id="Big G (#032)" Width="17" Height="15">
      <L>          ######</L>
      <L>       ####    #</L>
      <L>       #    $  #</L>
      <L>   ##### # ##$$#</L>
      <L>####  #  $ $   #</L>
      <L>#     $$@$ #  $##</L>
      <L># ##.*#  $ # $  #</L>
      <L># #.*.#$######  #</L>
      <L># #.. # #### $ ##</L>
      <L># #.*#..   #   ##</L>
      <L># #..#..$ $  $$ #</L>
      <L># #.* #.##  $   #</L>
      <L>#  *....####  ###</L>
      <L>##   ####  ####</L>
      <L> #####</L>
    </Level>
    <Level Id="Stage #033" Width="15" Height="16">
      <L>    ###########</L>
      <L> ####  #      #</L>
      <L> #   $ ..*### #</L>
      <L>## #$  #....# #</L>
      <L>#  $  ##.*..$ #</L>
      <L># $#####..#.###</L>
      <L>#     $..*# #</L>
      <L>### #   #  $##</L>
      <L>  # ######   #</L>
      <L>  #   $    $@#</L>
      <L>  # $ ### ####</L>
      <L>  # # #    ##</L>
      <L>  # $ $ #   #</L>
      <L>  ####$ $ # #</L>
      <L>     #  #   #</L>
      <L>     ########</L>
    </Level>
    <Level Id="Stage #034" Width="15" Height="14">
      <L> ####</L>
      <L> #  ##########</L>
      <L> #..  $   $  #</L>
      <L>##.*#  $    $#</L>
      <L>#....###$##  #</L>
      <L>#....##   ##$##</L>
      <L>##.#.##$# ##  #</L>
      <L> #.#.#  $   $ #</L>
      <L> #*#*$$ $ $#  #</L>
      <L> #     # # @ ##</L>
      <L> # # #$#  ####</L>
      <L> #     $  #</L>
      <L> #######  #</L>
      <L>       ####</L>
    </Level>
    <Level Id="Stage #035" Width="15" Height="14">
      <L>   ######</L>
      <L>   #    ######</L>
      <L>####$ # ##   #</L>
      <L># $  $  $  # #</L>
      <L># # ## ##$ # #</L>
      <L>#   $  $...# #</L>
      <L>## # $#$.#.# ##</L>
      <L> #  $  $*#.#  #</L>
      <L> # $  $$.#.## #</L>
      <L> #  $ # ....# #</L>
      <L> ####$###...@ #</L>
      <L>   # $   ..####</L>
      <L>   #   #####</L>
      <L>   #####</L>
    </Level>
    <Level Id="Stage #036" Width="14" Height="12">
      <L>      ########</L>
      <L>  #####..#   #</L>
      <L>  #..##.. $  #</L>
      <L> ##......##$##</L>
      <L> #...## #   #</L>
      <L> #.*. $ #@#$#</L>
      <L> #$ #$#$# $ ##</L>
      <L> #    # $ #  #</L>
      <L>##$#$  $  #$ #</L>
      <L>#  $  $ $ $  #</L>
      <L>#   ######   #</L>
      <L>#####    #####</L>
    </Level>
    <Level Id="Stage #037" Width="14" Height="16">
      <L>       ####</L>
      <L>   #####  ###</L>
      <L>  ## $  $ $ ##</L>
      <L>###    #   $ #</L>
      <L>#   #$#  $   #</L>
      <L># $   # ###$ #</L>
      <L>## # $  #.$.##</L>
      <L> # #  # #.*..#</L>
      <L> # # $$  .##.#</L>
      <L> # $  #$$.*..#</L>
      <L> #$ #$  $$#$ #</L>
      <L> #    ###.#..#</L>
      <L> ####### .#..#</L>
      <L>       # ....#</L>
      <L>       #### @#</L>
      <L>          ####</L>
    </Level>
    <Level Id="Stage #038" Width="13" Height="12">
      <L>#####   #####</L>
      <L>#.  #####   #</L>
      <L>#.#.$ $     #</L>
      <L>#.*..$  ## ##</L>
      <L>#...##$# $ #</L>
      <L>##.*#  $ $ #</L>
      <L> #... # $  #</L>
      <L>##*#$#  $$ #</L>
      <L># .$ @ $   #</L>
      <L>#   ####$# #</L>
      <L>#####  #   #</L>
      <L>       #####</L>
    </Level>
    <Level Id="Stage #039" Width="13" Height="12">
      <L>##########</L>
      <L># ..##   #</L>
      <L># ..$  # ##</L>
      <L>##..##@#  ###</L>
      <L> #..$   # $ #</L>
      <L> #.####     #</L>
      <L> #    ####$##</L>
      <L> # $ $$ ## ##</L>
      <L> ###$  $    #</L>
      <L>   # # ##   #</L>
      <L>   #   ######</L>
      <L>   #####</L>
    </Level>
    <Level Id="Crazy Twist (#040)" Width="17" Height="15">
      <L> #######</L>
      <L> #     #</L>
      <L>##$ $$ #######</L>
      <L># $  # ###   ####</L>
      <L>#  # #   $$ $  ##</L>
      <L>## $$# #  $ $ $ #</L>
      <L> #    .####  #$ #</L>
      <L> ## ##.##.  $ $ #</L>
      <L> # $....*.##$ # #</L>
      <L> # $.##*#*##   @#</L>
      <L> # $....*.###$ ##</L>
      <L> #   ##......$ #</L>
      <L> ######.##### ##</L>
      <L>      #       #</L>
      <L>      #########</L>
    </Level>
    <Level Id="Crazy Twist - revenge (#041)" Width="17" Height="15">
      <L> #######</L>
      <L> #     #</L>
      <L>##$ $$ #######</L>
      <L># $  # ###   ####</L>
      <L>#  # #   $$ $  ##</L>
      <L>## $$# #  $ $ $ #</L>
      <L> #    .####  #$ #</L>
      <L> ## ##.###  $ $ #</L>
      <L> # $..*.*..#$ # #</L>
      <L> # $.#.##*##   @#</L>
      <L> # $..*.*..##$ ##</L>
      <L> #   #.......$ #</L>
      <L> ###### ##### ##</L>
      <L>      #       #</L>
      <L>      #########</L>
    </Level>
    <Level Id="Interrogation Mark (#042a)" Width="17" Height="15">
      <L>      #########</L>
      <L>   ####.......###</L>
      <L>   #  ..$ #..*. #</L>
      <L> ### $##$###... #</L>
      <L> #    #   ##*#*##</L>
      <L>## $#$# $ #..#. #</L>
      <L>#    $ #$ #..*$ #</L>
      <L># #$$# #   ..#  #</L>
      <L># # $   ###.##$@#</L>
      <L># #   $    . #  #</L>
      <L># $ #$ ### $ #$ #</L>
      <L># # $ $ $ #.$$  #</L>
      <L># $ $      .$  ##</L>
      <L>##  ############</L>
      <L> ####</L>
    </Level>
    <Level Id="Real Interrogation Mark (#042)" Width="17" Height="15">
      <L>      #########</L>
      <L>   ####.......###</L>
      <L>   #  ..$ #.**. #</L>
      <L> ### $##$###... #</L>
      <L> #    #   ##.#.##</L>
      <L>## $#$# $ #..#. #</L>
      <L>#    $ #$ #.**$ #</L>
      <L># #$$# #   ..#  #</L>
      <L># # $   ###.##$@#</L>
      <L># #   $    . #  #</L>
      <L># $ #$ ### $ #$ #</L>
      <L># # $ $ $ #.$$  #</L>
      <L># $ $      .$  ##</L>
      <L>##  ############</L>
      <L> ####</L>
    </Level>
    <Level Id="Comeback (#043a)" Width="19" Height="16">
      <L> ####</L>
      <L>##  ######</L>
      <L>#        #   #####</L>
      <L>#  ### $$#####   #</L>
      <L>## # $ $   $.$ # ##</L>
      <L># @$  ###  .*. #  #</L>
      <L>#  # $ $ #$.#.  # #</L>
      <L># #  $  $  ...#.# #</L>
      <L># # # # $$#.#...# #</L>
      <L># #  $  # #*****$ #</L>
      <L>#  #  $ $ #.....###</L>
      <L>##  #####  # ##  #</L>
      <L> ##      #   ### #</L>
      <L>  ######  ###    #</L>
      <L>       ##     ####</L>
      <L>        #######</L>
    </Level>
    <Level Id="Comeback - Second Edition (#043)" Width="19" Height="16">
      <L>#####</L>
      <L>#   #####</L>
      <L>#       #    ######</L>
      <L>## ### $######    #</L>
      <L>## # $ $   $ $ ## #</L>
      <L># @$  ###  .*. ## #</L>
      <L>#  # $ $ #$.#.  # #</L>
      <L># #  $  $  ...#.# #</L>
      <L># # # # $$#.#...# #</L>
      <L># #  $  # #*****$ #</L>
      <L># ##  $ $ #.....###</L>
      <L># #######  # ##  #</L>
      <L>#     ####   ### #</L>
      <L>#####    ####    #</L>
      <L>    ####      ####</L>
      <L>       ########</L>
    </Level>
    <Level Id="April Challenge (#044)" Width="18" Height="14">
      <L>          ########</L>
      <L> #######  #   #  #</L>
      <L>##     # ##.#$$  #</L>
      <L># $$ $ ###....#  #</L>
      <L>#   # $   .*..# ##</L>
      <L>### $  $ #*#*$  #</L>
      <L>  ## $ ###...# $#</L>
      <L>   # #$$ #*.*#  #</L>
      <L> ### # ......# $#</L>
      <L> #@$ ##.### #   #</L>
      <L> #  $   ## $# $ #</L>
      <L> ## # ####  $  ##</L>
      <L>  #   ## #  #  #</L>
      <L>  #####  #######</L>
    </Level>
    <Level Id="Stage 045" Width="12" Height="12">
      <L>    ####</L>
      <L>    #  ##</L>
      <L>  ###$  #</L>
      <L>###...$ ##</L>
      <L># ..#*   ##</L>
      <L>#  ...$#  #</L>
      <L>##$##* . $#</L>
      <L> #  #  #  #</L>
      <L> # $ ####$##</L>
      <L> #  $  @ $ #</L>
      <L> ##  ###   #</L>
      <L>  #### #####</L>
    </Level>
    <Level Id="Night Patrol (046)" Width="16" Height="16">
      <L>    ########</L>
      <L>    #      #</L>
      <L>##### #### #####</L>
      <L>#     #  #$##  #</L>
      <L>#  #### $    $ #</L>
      <L># ##     $###  #</L>
      <L>#    $ #  $ #  #</L>
      <L>### $ $##   #..#</L>
      <L>### #  $ #$##*##</L>
      <L>#    # $..*..*.#</L>
      <L># $$  #$#.*..#.#</L>
      <L>#  #$ #@..*....#</L>
      <L>##  $ ###.#### #</L>
      <L>#  #  $    # $ #</L>
      <L>#  #  ##   #   #</L>
      <L>################</L>
    </Level>
    <Level Id="City Spleen (047)" Width="15" Height="15">
      <L>   #########</L>
      <L>####   #   ####</L>
      <L>#  $ #$#$#    #</L>
      <L># #$.#....### #</L>
      <L># # .......## #</L>
      <L># #####*#*. # #</L>
      <L># ###  .... # #</L>
      <L># # $ $###  # #</L>
      <L># # # $    ## #</L>
      <L>#   ##$$#$$   #</L>
      <L>##$ $     # $##</L>
      <L> #  $###@##  #</L>
      <L> #  $     $  #</L>
      <L> #  #######  #</L>
      <L> ####     ####</L>
    </Level>
  </LevelCollection>
</SokobanLevels>
