<?xml version="1.0" encoding="utf-8"?>
<SokobanLevels xmlns:xsi="http://www.w3.org/2001/XMLSchema-instance" xsi:schemaLocation="SokobanLev.xsd">
  <Title>Zelja 1</Title>
  <Description>
Zelja 1 by Zeljko Negovanovic
  </Description>
  <Email>zeljko.negovanovic31@gmail.com</Email>
  <LevelCollection Copyright="Zeljko Negovanovic" MaxWidth="31" MaxHeight="31">
    <Level Id="1" Width="25" Height="17">
      <L>     #####</L>
      <L>    ##   #</L>
      <L>   ##  . ##########</L>
      <L>  ##  .  ##      ###</L>
      <L> ##  .  ## $  $  @ ##</L>
      <L>##  .  ## $  # #  $ ##</L>
      <L>#  .  ## $  ## ##  $ ##</L>
      <L># .  ## $  ##   ##  $ ##</L>
      <L>### ## $  ##  *  ##  $.##</L>
      <L>#     $  ##  * *  ##  $.#</L>
      <L>##      ##  * * *  ##...#</L>
      <L> ########  * *.* *  #####</L>
      <L>        ##  * * *  ##</L>
      <L>         ##  * *  ##</L>
      <L>          ##  *  ##</L>
      <L>           ##   ##</L>
      <L>            #####</L>
    </Level>
    <Level Id="2" Width="26" Height="18">
      <L>       ########</L>
      <L>       #      #</L>
      <L>       # #  # #</L>
      <L>       # #### #</L>
      <L>######## ###  ##</L>
      <L>#....... ###   ##</L>
      <L>####    #### $  ##</L>
      <L>#####  #####  $  ##</L>
      <L>#  @#  # ####  $  ##</L>
      <L># #$## #    ##  $  ##</L>
      <L># $  # #     ##  $  #####</L>
      <L># # $# ##     ##  $  #####</L>
      <L># #  $  #      ##  $ #...#</L>
      <L># $  $  #       ##  $$...#</L>
      <L># $# # ##        ##   ...#</L>
      <L>#  # # #          ########</L>
      <L>#      #</L>
      <L>########</L>
    </Level>
    <Level Id="3" Width="13" Height="13">
      <L>     ###</L>
      <L>    ## ##</L>
      <L>   #######</L>
      <L>  ##     ##</L>
      <L> ## .@$ . ##</L>
      <L>### #$.$# ###</L>
      <L># # $.*.$ # #</L>
      <L>### #$.$# ###</L>
      <L> ## . $ . ##</L>
      <L>  ##     ##</L>
      <L>   #######</L>
      <L>    ## ##</L>
      <L>     ###</L>
    </Level>
    <Level Id="4" Width="23" Height="23">
      <L>          ###</L>
      <L>         ##.##</L>
      <L>        ##   ##</L>
      <L>       ##     ##</L>
      <L>      ## . $ . ##</L>
      <L>     ##   $.$@  ##</L>
      <L>    ##   $.$.$   ##</L>
      <L>   ##   $.$.$.$   ##</L>
      <L>  ##   $.$.$.$.$   ##</L>
      <L> ## . $.$.$.$.$.$ . ##</L>
      <L>##   $.$.$.$.$.$.$   ##</L>
      <L>#. .$.$.$.$.$.$.$.$. .#</L>
      <L>##   $.$.$.$.$.$.$   ##</L>
      <L> ## . $.$.$.$.$.$ . ##</L>
      <L>  ##   $.$.$.$.$   ##</L>
      <L>   ##   $.$.$.$   ##</L>
      <L>    ##   $.$.$   ##</L>
      <L>     ##   $.$   ##</L>
      <L>      ## . $ . ##</L>
      <L>       ##  .  ##</L>
      <L>        ##   ##</L>
      <L>         ##.##</L>
      <L>          ###</L>
    </Level>
    <Level Id="5" Width="17" Height="20">
      <L>    #########</L>
      <L>    #########</L>
      <L>  ### # @ # ###</L>
      <L>  ##    *    ##</L>
      <L>###    * *    ###</L>
      <L>##    * $ *    ##</L>
      <L>###  * $ $ *  ###</L>
      <L>##  * $ $ $ *  ##</L>
      <L>#  * $  *  $ *  #</L>
      <L># * $ $*.*$ $ * #</L>
      <L>#  * $  *  $ *  #</L>
      <L>##  * $ $ $ *  ##</L>
      <L>###  * $ $ *  ###</L>
      <L>####  * $ *  ####</L>
      <L>  #####. .#####</L>
      <L>  ###   .   ###</L>
      <L>  ##.... ....##</L>
      <L>  ###...#...###</L>
      <L>  ####.###.####</L>
      <L>  #############</L>
    </Level>
    <Level Id="6" Width="28" Height="24">
      <L>    ########################</L>
      <L>   ##        #             #</L>
      <L>  ##  $ $ $   $ $ $ $ $ $  #</L>
      <L> ##  $ $ $ $ # $ $ $ $ $ $ #</L>
      <L>##  $ $ $   ### $ $ $ $ $  #</L>
      <L>#  $ $ $ $ ##.## $ $ $ $ $ #</L>
      <L># $ $ $   ##...## $ $ $ $  #</L>
      <L>## $ $ $ ##.**..## $ $ $ $ #</L>
      <L>#       # ##..**.## $ $ $  #</L>
      <L>#      ### ##.....## $ $ $ #</L>
      <L>#  $  ##.## #......## $ $  #</L>
      <L># $  ##...##......*.## $   #</L>
      <L>#   ##.**.... ....*..##    #</L>
      <L># $  ##..**....##..*..#    #</L>
      <L>#  $  ##......# ##.*.##    #</L>
      <L># $ $  ##.....## ##.##     #</L>
      <L>#  $ $   ....*.## ###      #</L>
      <L>#   $     ...*..## # $     #</L>
      <L># $  $  #  ...*..##  ##    #</L>
      <L>#  $   #   ##.*.##  $##   ##</L>
      <L>#    $   $  ##.##  $   $ ##</L>
      <L># $ $ $ $ $  ### $ $$   ##</L>
      <L>#             #   @    ##</L>
      <L>########################</L>
    </Level>
    <Level Id="7" Width="22" Height="11">
      <L>######################</L>
      <L>#    .  $.  $.  $    #</L>
      <L>#    #.$  .$  .$#    #</L>
      <L>#   # $.  $.  $. #   #</L>
      <L>#  # $  .$  .$  . #  #</L>
      <L>###@$   $.  $.   . ###</L>
      <L>#  # $  .$  .$  . #  #</L>
      <L>#   # $.  $.  $. #   #</L>
      <L>#    #.$  .$  .$#    #</L>
      <L>#    .  $.  $.  $    #</L>
      <L>######################</L>
    </Level>
    <Level Id="8" Width="17" Height="17">
      <L>      ###########</L>
      <L>      ###########</L>
      <L>      ##       ##</L>
      <L>      ## ***** ##</L>
      <L>######## *   * ##</L>
      <L>######## * + * ##</L>
      <L>##       *   * ##</L>
      <L>## *********** ##</L>
      <L>## *     *     ##</L>
      <L>## *     * ######</L>
      <L>## *  $  * ######</L>
      <L>## *     * ##</L>
      <L>## *     * ##</L>
      <L>## ******* ##</L>
      <L>##         ##</L>
      <L>#############</L>
      <L>#############</L>
    </Level>
    <Level Id="9" Width="14" Height="14">
      <L>    ######</L>
      <L>   #      #</L>
      <L>   #      #</L>
      <L> ###......###</L>
      <L>#  .$$$$$$.  #</L>
      <L>#  .$    $.  #</L>
      <L>#  .$ $ $$.  #</L>
      <L>#  .$$@$ $.  #</L>
      <L>#  .$    $.  #</L>
      <L>#  .$$$$$$.  #</L>
      <L> ###......###</L>
      <L>   #      #</L>
      <L>   #      #</L>
      <L>    ######</L>
    </Level>
    <Level Id="10" Width="14" Height="14">
      <L>    ######</L>
      <L>   ########</L>
      <L>   #      #</L>
      <L> ###......###</L>
      <L>## .$$$$$$. ##</L>
      <L>## .$  @ $. ##</L>
      <L>## .$ $ $$. ##</L>
      <L>## .$$ $ $. ##</L>
      <L>## .$    $. ##</L>
      <L>## .$$$$$$. ##</L>
      <L> ###......###</L>
      <L>   #      #</L>
      <L>   ########</L>
      <L>    ######</L>
    </Level>
    <Level Id="11" Width="13" Height="13">
      <L>  #########</L>
      <L>  #       #</L>
      <L>###.*.*.*.###</L>
      <L># .$ $ $ $. #</L>
      <L># * * *.$ * #</L>
      <L># .$ $ $ $. #</L>
      <L>#@* * * * * #</L>
      <L># .$ $ $ $. #</L>
      <L># * * * * * #</L>
      <L># .$ $ $ $. #</L>
      <L>###.*.*.*.###</L>
      <L>  #       #</L>
      <L>  #########</L>
    </Level>
    <Level Id="12" Width="19" Height="9">
      <L>###############</L>
      <L>#             #</L>
      <L># $ $.*.* $ $ ##</L>
      <L>## $ *.*.$ *.* ##</L>
      <L> ## $.*.*@*.*.$ ##</L>
      <L>  ## *.*.$.*.* $ ##</L>
      <L>   ## $ $ *.* $ $ #</L>
      <L>    ##            #</L>
      <L>     ##############</L>
    </Level>
    <Level Id="13" Width="30" Height="15">
      <L>      ###        ###</L>
      <L>     #   #      #   #</L>
      <L>    #  $  #    #  .  #</L>
      <L>   #  $.$  #  #  .$.  #</L>
      <L>  #  $.$.$  ##  .$ $.  #  #</L>
      <L> #  $.$.$.$    .$   $.  ##.#</L>
      <L>#  $.$.$.$.$  .$     $.  . .#</L>
      <L># $.$.$.$.$.$.$   $   $.. @ .#</L>
      <L>#  $.$.$.$.$  .$     $.  . .#</L>
      <L> #  $.$.$.$    .$   $.  ##.#</L>
      <L>  #  $.$.$  ##  .$ $.  #  #</L>
      <L>   #  $.$  #  #  .$.  #</L>
      <L>    #  $  #    #  .  #</L>
      <L>     #   #      #   #</L>
      <L>      ###        ###</L>
    </Level>
    <Level Id="14" Width="31" Height="31">
      <L>                     ########</L>
      <L>                    #        #</L>
      <L>                    # ******+ #</L>
      <L>                    # *     * #</L>
      <L>                    # * ### * #</L>
      <L>                    # * ### * #</L>
      <L>                ##### * ### * #</L>
      <L>               #      *     * #</L>
      <L>               # ***** ****** #</L>
      <L>               # *    *       #</L>
      <L>               # * ## * ######</L>
      <L>            #### * ## * #</L>
      <L>           #     *    * #</L>
      <L>           # **** ***** #</L>
      <L>           # *   *      #</L>
      <L>       ##### * # * #####</L>
      <L>      #      *   * #</L>
      <L>      # ***** **** #</L>
      <L>      # *    *     #</L>
      <L>      # * ## * ####</L>
      <L> ###### * ## * #</L>
      <L>#       *    * #</L>
      <L># ****** ***** #</L>
      <L># *     *      #</L>
      <L># * ### * #####</L>
      <L># * ### * #</L>
      <L># * ### * #</L>
      <L># *     * #</L>
      <L># $****** #</L>
      <L>#         #</L>
      <L>###########</L>
    </Level>
    <Level Id="15" Width="13" Height="16">
      <L>   #######</L>
      <L>  #   @   #</L>
      <L>  # $ $ $ #</L>
      <L>   # $ $ #</L>
      <L>    # *  #</L>
      <L>   # .$. #</L>
      <L>  # .$.$. #</L>
      <L> # .$.$.$. #</L>
      <L># .$.$.$.$. #</L>
      <L>#.$.$.$.$.$.#</L>
      <L>#  $.$.$.$  #</L>
      <L> #  $.$.$  #</L>
      <L>  #  $.$  #</L>
      <L>   # .$. #</L>
      <L>    #. .#</L>
      <L>     ###</L>
    </Level>
    <Level Id="16" Width="18" Height="17">
      <L>           ####</L>
      <L>   ###    ##  ##</L>
      <L>  ##+##  ##    ##</L>
      <L> ##...#### $ $  ##</L>
      <L>##.....   $ $ $  #</L>
      <L>#.. . .. $ $ $ $ #</L>
      <L>##..... # $ $ $  #</L>
      <L> ##...#### $ $  ##</L>
      <L>  ##.######    ##</L>
      <L>  ## ######   ##</L>
      <L> ## $ ####   ##</L>
      <L>## $ $ ##   ##</L>
      <L># $ $ $     #</L>
      <L>#  $ $  #####</L>
      <L>##  $  ##</L>
      <L> ##   ##</L>
      <L>  #####</L>
    </Level>
    <Level Id="17" Width="18" Height="17">
      <L>           #####</L>
      <L>   ###    ##   ##</L>
      <L>  ##+##  ##     ##</L>
      <L> ##...####  $ $  #</L>
      <L>##.....  # $ $ $ #</L>
      <L>#.. . ..  $ $ $  #</L>
      <L>##.....  # $ $ $ #</L>
      <L> ##...####  $ $  #</L>
      <L>  ##.######  $  ##</L>
      <L>  ## ######    ##</L>
      <L> ## $ ####    ##</L>
      <L>## $ $ ##    ##</L>
      <L># $ $ $      #</L>
      <L>#  $ $  ######</L>
      <L>##  $  ##</L>
      <L> ##   ##</L>
      <L>  #####</L>
    </Level>
    <Level Id="18" Width="15" Height="18">
      <L>##########</L>
      <L>####   ###</L>
      <L>#   $ $  #</L>
      <L>#@ $   $$#    #</L>
      <L>#######  #   ##</L>
      <L>  #####$  # # #</L>
      <L> ######    #  #</L>
      <L>#######       #</L>
      <L>####. .#      #</L>
      <L> ###. ..#  #  #</L>
      <L> #  . .#   #  #</L>
      <L> #    #    #  #</L>
      <L> #   #    ##  #</L>
      <L> #  #    # #  #</L>
      <L> #      #     #</L>
      <L>  #   # $     #</L>
      <L>   #    #     #</L>
      <L>    ###########</L>
    </Level>
  </LevelCollection>
</SokobanLevels>
