<?xml version="1.0" encoding="utf-8"?>
<SokobanLevels xmlns:xsi="http://www.w3.org/2001/XMLSchema-instance" xsi:schemaLocation="SokobanLev.xsd">
  <Title>Zika 1</Title>
  <Description>
I keep adding new levels. Greetings.
  </Description>
  <Email>zivojintrifunovic21@gmail.com</Email>
  <LevelCollection Copyright="Zivojin Trifunovic" MaxWidth="35" MaxHeight="23">
    <Level Id="1" Width="11" Height="11">
      <L>      #####</L>
      <L>   ####   #</L>
      <L>  ##  # $ #</L>
      <L>  # * #*  #</L>
      <L>### *  *  #</L>
      <L># . *  * ##</L>
      <L>#  @**** #</L>
      <L>##$ *    #</L>
      <L> #  .#####</L>
      <L> ##  #</L>
      <L>  ####</L>
    </Level>
    <Level Id="2" Width="18" Height="17">
      <L>        ##</L>
      <L>       #  #</L>
      <L>      #    #</L>
      <L>     # .$$. #</L>
      <L>    # .$  $. #</L>
      <L>   # .$ #  $. #</L>
      <L>  # .$      $. #</L>
      <L> # .$ #$$$$# $. #</L>
      <L>#@# # #    # # # #</L>
      <L>#     #    #     #</L>
      <L>#######$$$$#######</L>
      <L># ..#        #.. #</L>
      <L># $            $ #</L>
      <L>## . ######## . ##</L>
      <L># .. $ $  $ $ .. #</L>
      <L># ..    #     .. #</L>
      <L>##################</L>
    </Level>
    <Level Id="3" Width="15" Height="12">
      <L>        #######</L>
      <L>        #   ###</L>
      <L>######### $ ###</L>
      <L>#      #  $ ###</L>
      <L># $ $     $  ##</L>
      <L>##$********$ ##</L>
      <L># $........ ###</L>
      <L>#   #  #    @##</L>
      <L>############ ##</L>
      <L>           # ##</L>
      <L>           # ##</L>
      <L>           ####</L>
    </Level>
    <Level Id="4" Width="12" Height="8">
      <L>############</L>
      <L>#####   . .#</L>
      <L># ....#$$* #</L>
      <L># $$$$$ .$.#</L>
      <L># . $..@ $ #</L>
      <L># #.$$$$$$ #</L>
      <L># . . .. # #</L>
      <L>############</L>
    </Level>
    <Level Id="5" Width="11" Height="10">
      <L>  #####</L>
      <L>  #   #####</L>
      <L> ###$ ##  #</L>
      <L> #  *  #  #</L>
      <L>##  * # # #</L>
      <L>#  .$.@ ###</L>
      <L># #$*$# #</L>
      <L>#  .$.# #</L>
      <L>#   .   #</L>
      <L>#########</L>
    </Level>
    <Level Id="6" Width="9" Height="8">
      <L>#########</L>
      <L>## $.  ##</L>
      <L># $ .$  #</L>
      <L># $$.$$ #</L>
      <L>#.*+*...#</L>
      <L>#  $.$$ #</L>
      <L>##  .  ##</L>
      <L>#########</L>
    </Level>
    <Level Id="7" Width="9" Height="13">
      <L> #####</L>
      <L> # . #</L>
      <L> # * #</L>
      <L> # * #</L>
      <L> # * #</L>
      <L> # * #</L>
      <L> # * #</L>
      <L>## * #</L>
      <L>#  * ###</L>
      <L>#  *@$ ##</L>
      <L># ****  #</L>
      <L>#       #</L>
      <L>#########</L>
    </Level>
    <Level Id="8" Width="16" Height="16">
      <L>      ####</L>
      <L> # ########## #</L>
      <L>################</L>
      <L>#.     $      .#</L>
      <L># $ $ $$$$ $ $ #</L>
      <L># $####  ####  #</L>
      <L>#  .. #  #..   #</L>
      <L>#$##.## ##.##$##</L>
      <L># $ . #  #.    #</L>
      <L>#  .. #  #.. $ #</L>
      <L>#  ####  ####  #</L>
      <L>#.. $@$$$$ $ ..#</L>
      <L>##.   #      .##</L>
      <L>################</L>
      <L> # ########## #</L>
      <L>###   ####   ###</L>
    </Level>
    <Level Id="9" Width="14" Height="19">
      <L>  ##########</L>
      <L> #          #</L>
      <L># $$# # #$#$ #</L>
      <L>#     $$  $  #</L>
      <L>#  ###..###  #</L>
      <L># $$.#..#.$$ #</L>
      <L># $..#..#..$ #</L>
      <L>#  ###..###$ #</L>
      <L># $...*+...$ #</L>
      <L>#  ###..###$ #</L>
      <L># $$.#..#.$  #</L>
      <L>#  ..#..#..$ #</L>
      <L># $###..###$ #</L>
      <L># $   $$     #</L>
      <L>#  # # # #$  #</L>
      <L> # $$$ $$$  #</L>
      <L>  #  $ $   #</L>
      <L>   #      #</L>
      <L>    ######</L>
    </Level>
    <Level Id="10" Width="35" Height="23">
      <L>                 #### #####</L>
      <L>          ####   #  # #  ##</L>
      <L>###########  ## ##  ###   ##</L>
      <L>#   $  $  $   # #          #    ###</L>
      <L># $           ###   ###   ##   ## #</L>
      <L>#  $# ##   #  $  $ ## #   #   ##  #</L>
      <L>#   ########       # ## # #   #.  #</L>
      <L># $ #      # ####### ##   #####.  #</L>
      <L>##$ #  #####. # . . . #  #...... ##</L>
      <L> #  # ####  #.# . . . . . ......##</L>
      <L> # $# #   $   ####.####  #.   ###</L>
      <L> #@ # # #$$$  #      #    .####</L>
      <L> # $# #   $  #         #####</L>
      <L> #  # ##   #  #### #####</L>
      <L> # $#  ##           #</L>
      <L> #  #   ###### $$$$ ##</L>
      <L> # $#        ##   $  #</L>
      <L> #  ##        ##  $  #</L>
      <L> # $ ##        # #$  #</L>
      <L> #  $ #        #    ##</L>
      <L> #    ##       ######</L>
      <L> ##   ##</L>
      <L>  #####</L>
    </Level>
    <Level Id="11" Width="18" Height="21">
      <L>##############</L>
      <L>#            #</L>
      <L>#    # $$$$  #</L>
      <L>## #  $    $ #</L>
      <L>#....##$  $###</L>
      <L>#.  .  $  $  #</L>
      <L>#.  .#  $$#  #</L>
      <L>#....#       #</L>
      <L>#### ####    #</L>
      <L>   #     #####</L>
      <L>   #   #    ##</L>
      <L>   ######    #</L>
      <L>        #    #</L>
      <L>   ######    #</L>
      <L>   ##     #  #####</L>
      <L>   # $$$$ # .... #</L>
      <L>   # $@ $ # .# . #</L>
      <L>   # $  $ # . #. #</L>
      <L>   # $$$$   .... #</L>
      <L>   #      #####  #</L>
      <L>   ###############</L>
    </Level>
    <Level Id="12" Width="13" Height="13">
      <L>   #######</L>
      <L>   #     #</L>
      <L>   # ...$#</L>
      <L>  ## $.$ #</L>
      <L>#### *.$.####</L>
      <L>#    $ $    #</L>
      <L># *. * * *  #</L>
      <L>#  **.*.* $##</L>
      <L>#  *    *   #</L>
      <L>###****** # #</L>
      <L>#    $ $ ####</L>
      <L>###   @  ###</L>
      <L>  ########</L>
    </Level>
    <Level Id="13" Width="13" Height="14">
      <L>    #####</L>
      <L>    #   #</L>
      <L>    #.$.#</L>
      <L>    #.$.#</L>
      <L>##### $ #####</L>
      <L>#  ...*...  #</L>
      <L># $$$$$$$$$ #</L>
      <L>#  .$.$.$.  #</L>
      <L>## .$.$.$. ##</L>
      <L> # .$.$.$. #</L>
      <L> #  $...$  #</L>
      <L> ##. $$$  ##</L>
      <L>  ##  @  ##</L>
      <L>   #######</L>
    </Level>
    <Level Id="14" Width="9" Height="12">
      <L>  #####</L>
      <L>  #   ##</L>
      <L>  # *  #</L>
      <L> ## *  #</L>
      <L>## *** ##</L>
      <L>#   *   #</L>
      <L># ***** #</L>
      <L>#   *   #</L>
      <L>## ***  #</L>
      <L> #  $  ##</L>
      <L> ## + ##</L>
      <L>  #####</L>
    </Level>
    <Level Id="15" Width="24" Height="16">
      <L>########################</L>
      <L>#            @         #</L>
      <L># $$$$$$$$$$$$$$$$$$$$ #</L>
      <L># $                  $ #</L>
      <L>###############  #######</L>
      <L>              #  #</L>
      <L>              # ##</L>
      <L>              #  #</L>
      <L>              #  #######</L>
      <L>###############  #     #</L>
      <L># $..................$ #</L>
      <L># *$$$$$$$$$$$$$$$$$$$ #</L>
      <L># . .................. #</L>
      <L>#  . . . . . . .     $ #</L>
      <L>#####################  #</L>
      <L>                    ####</L>
    </Level>
    <Level Id="16" Width="18" Height="17">
      <L>########</L>
      <L>#      ##</L>
      <L># $$$$$ ##</L>
      <L>#  @   $ ##</L>
      <L>#### $  $ ##</L>
      <L>#...  $  $ ##</L>
      <L>#..* # $  $ ##</L>
      <L>#...$ # $  $ ##</L>
      <L>##   $ # $  *.##</L>
      <L> ##   $ # $$.*.###</L>
      <L>  ## $ $ #  ..*. #</L>
      <L>   ##   $ ##... ##</L>
      <L>    ##   $ #...##</L>
      <L>     ###  $ ..##</L>
      <L>      ##   $..#</L>
      <L>       #### ..#</L>
      <L>          #####</L>
    </Level>
    <Level Id="17" Width="10" Height="10">
      <L> #####</L>
      <L>##.  ###</L>
      <L>#  *   ##</L>
      <L># *$*$  #</L>
      <L>#  * #  ##</L>
      <L>####  *. #</L>
      <L>   #.**$ #</L>
      <L>   #  *@ #</L>
      <L>   ###  ##</L>
      <L>     ####</L>
    </Level>
    <Level Id="18" Width="14" Height="10">
      <L>#####   ######</L>
      <L>#   #####    #</L>
      <L># *.......*. #</L>
      <L># *$$$$$$$$$ #</L>
      <L># *   #    .##</L>
      <L># $ ######$.#</L>
      <L>#  @#    # .#</L>
      <L>#####    #  #</L>
      <L>         #  #</L>
      <L>         ####</L>
    </Level>
    <Level Id="19" Width="31" Height="10">
      <L>####</L>
      <L># @#             ########  ####</L>
      <L># $###############   #  ## #  #</L>
      <L># $     #    #    # $ $  ###. #</L>
      <L># $.$.$.$.$.$.$.$.$.$.$.$.$.$ #</L>
      <L># $$.$.$.$.$.$.$.$.$.$.$.$.$. #</L>
      <L># $         #.$. . . . . . .  #</L>
      <L># $#########    ############* #</L>
      <L>#  #       ######          #  #</L>
      <L>####                       ####</L>
    </Level>
    <Level Id="20" Width="24" Height="12">
      <L>   #     #</L>
      <L>  #+#   #.#  ##########</L>
      <L> # . # # . ##    # $ .##</L>
      <L># .*. # .*. # $. $ $.# #</L>
      <L># $*$ $ $*$  $**.  **. #</L>
      <L>#  $     $    $.#   . #</L>
      <L>#############   $$ $ #</L>
      <L>            #  $.$$ #</L>
      <L>             # .*. #</L>
      <L>              # . #</L>
      <L>               # #</L>
      <L>                #</L>
    </Level>
    <Level Id="21" Width="10" Height="9">
      <L>  ########</L>
      <L>  #   #. #</L>
      <L> ##  $...#</L>
      <L> #  $ #*.#</L>
      <L>##$##$#.##</L>
      <L># $    $@#</L>
      <L>#   #    #</L>
      <L>#######  #</L>
      <L>     #####</L>
    </Level>
    <Level Id="22" Width="9" Height="7">
      <L>#########</L>
      <L>#   * . #</L>
      <L># $.$.$@#</L>
      <L># .$.$. #</L>
      <L># $.$.$ #</L>
      <L>#   *   #</L>
      <L>#########</L>
    </Level>
    <Level Id="23" Width="9" Height="7">
      <L>#########</L>
      <L>#.  $. @#</L>
      <L># .$.$  #</L>
      <L>##$.$ $##</L>
      <L># .$.$  #</L>
      <L>#.  $.  #</L>
      <L>#########</L>
    </Level>
    <Level Id="24" Width="9" Height="9">
      <L> #######</L>
      <L>##  *  ##</L>
      <L># . . . #</L>
      <L># $ *   #</L>
      <L># $$*$$ #</L>
      <L>#*  *@$*#</L>
      <L># . . . #</L>
      <L>##  *  ##</L>
      <L> #######</L>
    </Level>
    <Level Id="25" Width="13" Height="11">
      <L>#############</L>
      <L>#   . . .   #</L>
      <L># $$$$*$$$$ #</L>
      <L># ..*...*.. #</L>
      <L>### $. .$ ###</L>
      <L>  # $. .$ #</L>
      <L>  # $. .$ #</L>
      <L>  # $...$ #</L>
      <L>  # $$*$$ #</L>
      <L>  #   +   #</L>
      <L>  #########</L>
    </Level>
    <Level Id="26" Width="11" Height="10">
      <L>##########</L>
      <L>#  ...   #</L>
      <L># $ .$$* #</L>
      <L>###$. $. #</L>
      <L># .*.#*.###</L>
      <L># $ . $.  #</L>
      <L># $$*$$.$ #</L>
      <L>#   .@$*  #</L>
      <L>######   ##</L>
      <L>     #####</L>
    </Level>
    <Level Id="27" Width="9" Height="10">
      <L> #######</L>
      <L>## .$. ##</L>
      <L>#  .$.  #</L>
      <L># $$*$$ #</L>
      <L># ..$.. #</L>
      <L>#  $$$  #</L>
      <L>## .$. ##</L>
      <L> #  * ##</L>
      <L> ## + #</L>
      <L>  #####</L>
    </Level>
    <Level Id="28" Width="14" Height="10">
      <L>##############</L>
      <L>#  #    #    #</L>
      <L># $.$ $....$ #</L>
      <L># ..$.$.$#*$ #</L>
      <L># $.$ $. $.$##</L>
      <L># $.$.#.# .$ #</L>
      <L># $.$ $+$$.# #</L>
      <L># $.$ #....$ #</L>
      <L>#  #  #  #   #</L>
      <L>##############</L>
    </Level>
    <Level Id="29" Width="13" Height="12">
      <L>#############</L>
      <L>##  #   #  ##</L>
      <L># $  .$.  $ #</L>
      <L>#  $ .$. $  #</L>
      <L>##  $.$.$  ##</L>
      <L>#  . $$$  . #</L>
      <L>#.**..*..**.#</L>
      <L>#    $$$    #</L>
      <L>## .$.$.$. ##</L>
      <L>#  $ .$.@$ #</L>
      <L>##  # . #  #</L>
      <L> ###########</L>
    </Level>
    <Level Id="30" Width="10" Height="10">
      <L>   ####</L>
      <L> ###  ###</L>
      <L>## . .  #</L>
      <L>#  *$* .#</L>
      <L># $ $ $ ##</L>
      <L>#. .$. * #</L>
      <L>## $ $$  #</L>
      <L> # .$. .##</L>
      <L> ###  @##</L>
      <L>   #####</L>
    </Level>
    <Level Id="31" Width="10" Height="10">
      <L>   ####</L>
      <L> ###  ###</L>
      <L>## * .  #</L>
      <L># $.$* .#</L>
      <L># .$  $ ##</L>
      <L>#.$.$. * #</L>
      <L>##  $ $  #</L>
      <L> # *@* .##</L>
      <L> ###   ##</L>
      <L>   #####</L>
    </Level>
    <Level Id="32" Width="13" Height="10">
      <L>      ###</L>
      <L> ######@#</L>
      <L>## ## . #</L>
      <L># $. *  #</L>
      <L>#  $ #$$#####</L>
      <L>##.$* .$..  #</L>
      <L> # $ $   $  #</L>
      <L> # . .###.###</L>
      <L> #### # ###</L>
      <L>    ###</L>
    </Level>
    <Level Id="33" Width="13" Height="10">
      <L>      ###</L>
      <L>####### #</L>
      <L>#. ## . #</L>
      <L># $.  $ #</L>
      <L>#  $* $$#####</L>
      <L>##.$ #.$..  #</L>
      <L> # $ $   $  #</L>
      <L> # .@.###.###</L>
      <L> #### # ###</L>
      <L>    ###</L>
    </Level>
    <Level Id="34" Width="18" Height="12">
      <L>################</L>
      <L>#         #    ###</L>
      <L>#.$.$$.$$.$ .$   #</L>
      <L># .$ .$$ .  ######</L>
      <L>#.$.$.$. *$.#</L>
      <L>####  ####  #</L>
      <L>   # $## ####</L>
      <L>   #. .##</L>
      <L>   #$ $ ##</L>
      <L>   #.$*..#</L>
      <L>   ##  @ ##</L>
      <L>    #######</L>
    </Level>
    <Level Id="35" Width="15" Height="11">
      <L>        #######</L>
      <L>     ####     #</L>
      <L>    ## .# $ $ #</L>
      <L>   ## .$$ .$ ##</L>
      <L>  ## .$  .$.##</L>
      <L> ## .$# .$.##</L>
      <L>## .$  .$.##</L>
      <L># .$ $$$.##</L>
      <L>#.$ $..###</L>
      <L>##@$.###</L>
      <L> #####</L>
    </Level>
    <Level Id="36" Width="19" Height="7">
      <L>########   ######</L>
      <L>#     ######.#..###</L>
      <L># $@$ $ ## #    . #</L>
      <L># $$$$$     . .   #</L>
      <L># $ $ $##### .#.. #</L>
      <L>#      #   #. . ###</L>
      <L>########   ######</L>
    </Level>
    <Level Id="37" Width="18" Height="11">
      <L>    #####  #######</L>
      <L>    #   ####  .  #</L>
      <L>    # $ # # $$** #</L>
      <L>##### #$  # $. * #</L>
      <L># . . . * # .  * #</L>
      <L>#@$$$$$*$*. .#$. #</L>
      <L># . . . * # .$ .##</L>
      <L>##### #$  ## .. #</L>
      <L>    # $  ### $ ##</L>
      <L>    ##   ###  ##</L>
      <L>     ##########</L>
    </Level>
    <Level Id="38" Width="12" Height="9">
      <L>  ##########</L>
      <L>### . $    #</L>
      <L># .$ $.$. ##</L>
      <L>#@$   $. ##</L>
      <L># .$*$####</L>
      <L>####  #</L>
      <L>   #..#</L>
      <L>   #  #</L>
      <L>   ####</L>
    </Level>
    <Level Id="39" Width="12" Height="10">
      <L>##########</L>
      <L>#       @#</L>
      <L># $ *##$$##</L>
      <L># ##...*  ##</L>
      <L>#  #.###   #</L>
      <L>#  #.   $$ #</L>
      <L># .*.##   ##</L>
      <L># #$.$ $ ##</L>
      <L>#  $.    #</L>
      <L>##########</L>
    </Level>
    <Level Id="40" Width="13" Height="10">
      <L>###########</L>
      <L># @$    ..#</L>
      <L>## $# $$$.##</L>
      <L>#  $... #. ##</L>
      <L>#  # .###   #</L>
      <L>##$#..*   $ #</L>
      <L>#  ##.$ ##$ #</L>
      <L>#   $*$$#   #</L>
      <L>#   ... $ ###</L>
      <L>###########</L>
    </Level>
    <Level Id="41" Width="12" Height="13">
      <L>     #######</L>
      <L>     #     #</L>
      <L>######$$$# #</L>
      <L>#..     $+ #</L>
      <L>#..#### $# #</L>
      <L>#..#    $. #</L>
      <L>#$$$$$$ ## #</L>
      <L>#    #  #..#</L>
      <L>## # $$##..#</L>
      <L> ###  $ #..#</L>
      <L>   ##    *.#</L>
      <L>    ####   #</L>
      <L>       #####</L>
    </Level>
    <Level Id="42" Width="14" Height="11">
      <L>########</L>
      <L>#      #</L>
      <L># $.# $#######</L>
      <L># .##$    .. #</L>
      <L>#   $   #  $ #</L>
      <L>#.$.$.$.$.####</L>
      <L>#  #### #$##</L>
      <L># $ $ ###  ##</L>
      <L># . . .$.$.##</L>
      <L>######### @#</L>
      <L>        ####</L>
    </Level>
    <Level Id="43" Width="13" Height="13">
      <L>       #####</L>
      <L>##### ##   ##</L>
      <L>#.. ###  $. #</L>
      <L>#..$$    #.@#</L>
      <L>##.$. #$$$..#</L>
      <L>#..##$$  ####</L>
      <L>#..#  #$ #</L>
      <L>#.*#$    #</L>
      <L>#..$  ## ###</L>
      <L>#..$$  $   #</L>
      <L>#### $ $$$ #</L>
      <L>   #       #</L>
      <L>   #########</L>
    </Level>
  </LevelCollection>
</SokobanLevels>
